郑=Trịnh
蕾=Lôi
爱小=tham món lợi nhỏ/thích chiếm lợi thế
酥=xốp giòn/bánh

丘,=khâu,
屄=bi/lồn
,就是=, chính là
一般,=Bình thường,

//vietphrase
生地=sinh địa/đất hoang

肆虐=tứ ngược/tàn phá bừa bãi/tàn sát bừa bãi/bừa bãi tàn phá
瞎扯=nói mò/mò mẫm/nói lung tung/tán gẫu/tán ma tán mãnh/nói bậy/mò mẫm
地=địa
弄=làm/làm cho/kiếm/lộng/chuẩn bị/chơi
滚!=cút!
光!=ánh sáng!
光,=ánh sáng,/hết,
光.=ánh sáng./quang.
光:=ánh sáng:/quang:
光!=ánh sáng!
光,=ánh sáng,/hết,
光?=ánh sáng?
光?=ánh sáng?
当天.=cùng ngày.
nàng môn=các nàng
Nhân ni.=Người đâu.
núi động=sơn động
Rất làm!=Rất khô!
Rất làm.=Rất khô.
VOCALOID=Vocaloid

腰,=eo,
腰.=eo.
Đối với!=Đúng!
Đối với,=Đúng,
Đối với.=Đúng.
chi địa!=chi địa  !
chi địa,=chi địa  ,
chi địa.=chi địa  .
chi địa?=chi địa  ?
chu xian=xuất hiện/出现
đại địa!=đại địa  !
đại địa,=đại địa  ,
đại địa.=đại địa  .
đại địa?=đại địa  ?
đến gia!=đến nhà!
đến gia,=đến nhà,
đến gia.=đến nhà.
Đều lên!=Đều đứng lên!
Đều lên,=Đều đứng lên.
Đều lên.=Đều đứng lên.
biển mây=vân hải
Ta đẳng!=ta đợi!
Ta đẳng,=ta đợi,
Ta đẳng.=ta đợi.
thổ địa!=thổ địa  !
thổ địa,=thổ địa  ,
thổ địa.=thổ địa  .
thổ địa?=thổ địa  ?
Tìm đến!=Tìm được rồi!
trúc mây=Trúc Vân

Vừa đến,=Một là,

上,=bên trên,/lên,/ở trên/trên,/thượng,
上.=bên trên./lên.


这么轻易放弃的,=dễ dàng buông tha như vậy,
这么英俊潇洒的,=anh tuấn tiêu sái như vậy,
这么看不起人的,=xem thường người như vậy,
这么抛上抛下的,=quăng lên quăng xuống như vậy,
这么容易发财的,=dễ phát tài như vậy,
这么容易满足的,=dễ thỏa mãn như vậy,
这样做是不对的,=làm như vậy là không đúng,
这样相夫教子的,=giúp chồng dạy con như vậy,
这样管教弟子的,=quản giáo đệ tử như vậy,
这般送上门来的,=đưa tới cửa như vậy,
那么容易修炼的,=dễ dàng tu luyện đích như vậy,
那么年轻漂亮的,=trẻ tuổi xinh đẹp như vậy,
那么恬不知耻的,=chẳng biết xấu hổ như vậy,
那么轻松拿下的,=dễ bắt như vậy,
都是这么认为的,=cũng cho là như vậy,
‘ 极真界域,="Cực Chân biên giới"
‘ 森罗魂力,="Sâm La hồn lực"
‘ 道灵宝鉴,="Đạo Linh Bảo Giám"
“想上来便上来=muốn lên thì cứ lên đi
一定是这样的,=nhất định là như vậy,
一抹凄艳的红,=một vệ đỏ chói buồn bã,
不能这么算的,=không thể tính như vậy được,
也是那么想的,=cũng nghĩ là như vậy,
儿子是母亲的,=nhi tử là của mẫu thân,
如此近距离的,=khoảng cách gần như vậy,
最为不合理的,=không hợp lý nhất,
最为不放心的,=không yên lòng nhất,
最为不要命的,=liều mạng nhất,
最为令人愁的,=làm người ta buồn nhất,
最为低等次的,=cấp thấp nhất,
最为想听到的,=muốn nghe nhất,
最为感兴趣的,=cảm thấy hứng thú nhất,
中后,=về sau,
后,=về sau,/hậu,
点,=điểm,/chút,/giờ,
负她=phụ nàng
会,=sẽ,/biết,/hội,/chút,
会.=hội./sẽ./biết.
数不多=số không nhiều/không nhiều
3D=3D
3p=3p
4k=4K
4G=4G
DM=DM
iT=IT
jj=jj
KO=KO

//Names
腿=chân

//từ file cword bị lặp

但那=nhưng này/thế nhưng
嗦嗦=run lẩy bẩy
就很=cũng rất
可这=nhưng này
躲了=né
直接说=nói thẳng
量大=số lượng nhiều/số lượng lớn
插在=cắm ở
把话=đem lời
说完就=nói xong cũng
后和=xong cùng
载着=chở/tái trứ/mang theo
对她=đối nàng/đối với nàng
可以吗=có thể chứ/có thể không
不及待
继续说=nói tiếp
回了家=trở về nhà
再让=lại để cho
来吧=tới đi/đến đây đi
把着=đem
随着抽=theo xả
就已=đã
轻蔑地=khinh miệt/khinh bỉ
在里=ở bên trong
是来=là tới
怎么又=tại sao lại
受得=nhận được/chịu đựng được/bị
一些话=một ít lời/mấy lời
你等=các ngươi/ngươi chờ
焉的=ở đó
为的=để


十一=mười một/ngày 1 tháng 10
十一个月=mười một tháng
十一二=mười một mười hai
十一二岁=mười một mười hai tuổi
十一分=mười một phần/11%
十一只=mười một con
十一号=số mười một
十一名=mười một tên/mười một gã
十一天=mười một ngày
十一层=mười một tầng/tầng mười một
十一年=mười một năm
十一张=mười một tấm
十一日=mười một ngày
十一月=tháng mười một/tháng 11
十一月份=tháng mười một/tháng Mười Một
十一楼=lầu mười một
十一次=mười một lần
十一点=mười một giờ
十一点半=11:30/mười một giờ rưỡi
十一点多=hơn mười một giờ
十一载=năm thứ mười một/mười một năm
十七=mười bảy/17/thập thất
十七世纪=thế kỷ mười bảy
十七个=mười bảy cái
十七八=mười bảy mười tám
十七八岁=mười bảy mười tám tuổi
十七号=số mười bảy/số 17
十七天=mười bảy ngày
十七层=mười bảy tầng/tầng mười bảy
十七日=mười bảy ngày
十七次=mười bảy lần
十七级=cấp 17
十七载=mười bảy năm
十七里=mười bảy dặm
十万=mười vạn/mười vạn
十万两=mười vạn lượng/mươi vạn lượng
十万人=mười vạn người
十万余=hơn mười vạn
十万八千=mười vạn tám ngàn
十万块=mười vạn khối/mười vạn đồng

一两万=một hai vạn/10, 20 ngàn
一两下=một hai cái/một hai lần
一两件=một hai kiện
一两倍=một hai lần
一两分=một hai phần/một hai phân
一两分钟=một hai phút
一两千=một hai ngàn
一两口=một hai ngụm
一两句=một đôi lời
一两句话=một hai câu/một đôi lời
一两只=một hai con
一两周=1-2 tuần
一两场=một hai trận
一两块=một hai khối
一两声=một hai tiếng
一两处=một hai nơi
一两天=một hai ngày
一两家=một hai nhà
一两尺=một hai xích
一两年=một hai năm
一两成=một hai thành
一两手=một bản lĩnh
一两招=một hai chiêu
一两日=một hai ngày
一两月=một hai tháng
一两本=một hai bản
一两枚=một hai cái/một hai quả
一两株=một hai gốc
一两样=một hai dạng
一两次=một hai lần
一两步=một hai bước
一两百=một hai trăm
一两百万=một hai trăm vạn/1,2 triệu
一两碗=một hai bát
一两秒=một hai giây
一两米=hơn hai thước/một hai mét
一两辆=một hai chiếc
一两重=một hai trọng
一两项=một hai hạng
一两颗=một hai khỏa
一百多两=hơn một trăm lượng
一百多只=hơn một trăm con
一百多名=hơn một trăm tên
一百多天=hơn một trăm ngày
一百多岁=hơn một trăm tuổi
一百多年=hơn một trăm năm
一百多张=hơn một trăm tấm/hơn 100 tấm
一百多米=hơn một trăm mét/hơn 100m
一百多道=hơn một trăm đạo
一百多里=hơn một trăm dặm
一百天=một trăm ngày
一百家=một trăm nhà
一百年=một trăm năm
一百张=một trăm tấm/100 tấm
一百条=một trăm đầu/100 điều
一百根=một trăm cây
一百次=một trăm lần/100 lần
一百米=một trăm mét/100m/100 mét
一百遍=một trăm lần
一百里=một trăm dặm/100 dặm
七十余岁=bảy mươi mấy tuổi
七十余年=hơn bảy mươi năm
七十余里=hơn bảy mươi dặm
七十年=bảy mươi năm
七十里=bảy mươi dặm
三十天=ba mươi ngày
三十岁=ba mươi tuổi
三十年=ba mươi năm
三十张=ba mươi tấm
三十日=ba mươi ngày
三十次=ba mươi lần
三十秒=ba mươi giây/30 giây
三十米=ba mươi mét/30m
十九层=mười chín tầng
十九岁=mười chín tuổi
七岁=bảy tuổi/bảy tuổi
三岁=ba tuổi
九岁=chín tuổi
三十余岁=ba mươi mấy tuổi
两岁=hai tuổi
两层=hai tầng
二十余岁=hai mươi mấy tuổi
二十岁=hai mươi tuổi
五岁=năm tuổi
八岁=tám tuổi
卅岁=ba mươi tuổi
十六岁=mười sáu tuổi
十八岁=mười tám tuổi
四十八岁=bốn mươi tám tuổi
十五岁=mười lăm tuổi
十三岁=mười ba tuổi/mười ba tuổi
四十岁=bốn mươi tuổi
十岁=mười tuổi

亲也=hôn cũng
相和=tương hòa
道我=đạo ngã
天也=trời cũng
细白=tế bạch
枫副主任=Phong phó chủ nhiệm
枫副主席=Phong phó chủ tịch
枫副乡长=Phong phó chủ tịch xã
枫副书记=Phong phó bí thư
枫副会长=Phong hội phó
枫副厂长=Phong xưởng phó
枫副厅长=Phong phó phòng
枫副县长=Phong phó chủ tịch huyện
枫副团长=Phong phó đoàn trưởng
枫副堂主=Phong phó đường chủ
枫副处长=Phong phó phòng
枫副局长=Phong cục phó
枫副市长=Phong phó thị trưởng
枫副帮主=Phong phó bang chủ
枫副总管=Phong phó tổng quản
枫副总裁=Phong phó tổng giám đốc
枫副所长=Phong đồn phó
枫副指挥=Phong chỉ huy phó
枫副掌教=Phong phó chưởng giáo
枫副掌门=Phong phó chưởng môn
枫副教主=Phong phó giáo chủ
枫副校长=Phong phó hiệu trưởng
枫副殿主=Phong phó điện chủ
枫副洞主=Phong phó động chủ
枫副班长=Phong lớp phó
枫副盟主=Phong phó minh chủ
枫副省长=Phong phó tỉnh trưởng
枫副科长=Phong phó khoa trưởng
枫副组长=Phong phó tổ trưởng
枫副经理=Phong phó quản lý
枫副舵主=Phong phó đà chủ
枫副部长=Phong phó bộ trưởng
枫副镇长=Phong phó trấn
枫副门主=Phong phó môn chủ
枫副队长=Phong đội phó
枫副院长=Phong viện phó
枫参谋长=Phong tham mưu trưởng
枫叶商团=Phong Diệp thương đoàn
枫大元帅=Phong đại nguyên soái
枫大公子=Phong đại công tử
枫大将军=Phong đại tướng quân
枫大小姐=Phong đại tiểu thư
枫大少爷=Phong đại thiếu gia
枫家上下=từ trên xuống dưới nhà họ Phong
枫家兄弟=anh em nhà họ Phong
枫家公子=công tử nhà họ Phong
枫家家主=Phong gia gia chủ
枫家族长=Phong gia tộc trưởng
枫家老祖=Phong gia lão tổ
枫家领地=lãnh địa nhà họ Phong
枫小兄弟=Phong tiểu huynh đệ
枫小王爷=Phong tiểu vương gia
枫少奶奶=mợ Phong
枫老先生=Phong lão tiên sinh
枫老前辈=Phong lão tiền bối
枫老夫人=Phong lão phu nhân
枫老将军=Phong lão tướng quân
枫老帮主=Phong lão bang chủ
枫老施主=Phong lão thí chủ
枫董事长=Phong chủ tịch
枯荣先生=Khô Vinh tiên sinh
柏之身上=trên người Bách Chi
柏之身下=dưới người Bách Chi
柏副主任=Bách phó chủ nhiệm
柏副主席=Bách phó chủ tịch
柏副乡长=Bách phó chủ tịch xã
柏副书记=Bách phó bí thư
柏副会长=Bách hội phó
柏副厂长=Bách xưởng phó
柏副厅长=Bách phó phòng
柏副县长=Bách phó chủ tịch huyện
柏副团长=Bách phó đoàn trưởng
柏副堂主=Bách phó đường chủ
柏副处长=Bách phó phòng
柏副局长=Bách cục phó
柏副市长=Bách phó thị trưởng
柏副帮主=Bách phó bang chủ
柏副总管=Bách phó tổng quản
柏副总裁=Bách phó tổng giám đốc
柏副所长=Bách đồn phó
柏副指挥=Bách chỉ huy phó
柏副掌教=Bách phó chưởng giáo
柏副掌门=Bách phó chưởng môn
柏副教主=Bách phó giáo chủ
柏副校长=Bách phó hiệu trưởng
柏副殿主=Bách phó điện chủ
柏副洞主=Bách phó động chủ
柏副班长=Bách lớp phó
柏副盟主=Bách phó minh chủ
柏副省长=Bách phó tỉnh trưởng
柏副科长=Bách phó khoa trưởng
柏副组长=Bách phó tổ trưởng
柏副经理=Bách phó quản lý
柏副舵主=Bách phó đà chủ
柏副部长=Bách phó bộ trưởng
柏副镇长=Bách phó trấn
柏副门主=Bách phó môn chủ
柏副队长=Bách đội phó
柏副院长=Bách viện phó
柏参谋长=Bách tham mưu trưởng
柏大元帅=Bách đại nguyên soái
柏大公子=Bách đại công tử
柏大将军=Bách đại tướng quân
柏大小姐=Bách đại tiểu thư
柏大少爷=Bách đại thiếu gia
柏家上下=từ trên xuống dưới nhà họ Bách
柏家兄弟=anh em nhà họ Bách
柏家公子=công tử nhà họ Bách
柏家家主=Bách gia gia chủ
柏家族长=Bách gia tộc trưởng
柏家老祖=Bách gia lão tổ
柏家领地=lãnh địa nhà họ Bách
柏小兄弟=Bách tiểu huynh đệ
柏小王爷=Bách tiểu vương gia
柏少奶奶=mợ Bách
柏老先生=Bách lão tiên sinh
柏老前辈=Bách lão tiền bối
柏老夫人=Bách lão phu nhân
柏老将军=Bách lão tướng quân
柏老帮主=Bách lão bang chủ
柏老施主=Bách lão thí chủ
柏董事长=Bách chủ tịch
柯二公子=Kha nhị công tử
柯二小姐=Kha nhị tiểu thư
柯侯世家=Kha thế gia
柯副主任=Kha phó chủ nhiệm
柯副主席=Kha phó chủ tịch
柯副乡长=Kha phó chủ tịch xã
柯副书记=Kha phó bí thư
柯副会长=Kha hội phó
柯副厂长=Kha xưởng phó
柯副厅长=Kha phó phòng
柯副县长=Kha phó chủ tịch huyện
柯副团长=Kha phó đoàn trưởng
柯副堂主=Kha phó đường chủ
柯副处长=Kha phó phòng
柯副局长=Kha cục phó
柯副市长=Kha phó thị trưởng
柯副帮主=Kha phó bang chủ
柯副总管=Kha phó tổng quản
柯副总裁=Kha phó tổng giám đốc
柯副所长=Kha đồn phó
柯副指挥=Kha chỉ huy phó
柯副掌教=Kha phó chưởng giáo
柯副掌门=Kha phó chưởng môn
柯副教主=Kha phó giáo chủ
柯副校长=Kha phó hiệu trưởng
柯副殿主=Kha phó điện chủ
柯副洞主=Kha phó động chủ
柯副班长=Kha lớp phó
柯副盟主=Kha phó minh chủ
柯副省长=Kha phó tỉnh trưởng
柯副科长=Kha phó khoa trưởng
柯副组长=Kha phó tổ trưởng
柯副经理=Kha phó quản lý
柯副舵主=Kha phó đà chủ
柯副部长=Kha phó bộ trưởng
柯副镇长=Kha phó trấn
柯副门主=Kha phó môn chủ
柯副队长=Kha đội phó
柯副院长=Kha viện phó
柯参谋长=Kha tham mưu trưởng
柯大元帅=Kha đại Nguyên soái/Kha đại nguyên soái
柯大公子=Kha đại công tử
柯大妹子=Kha đại muội tử
柯大学士=Kha đại học sĩ
柯大将军=Kha đại tướng quân
柯大小姐=Kha đại tiểu thư
柯大少爷=Kha đại thiếu gia
柯家上下=từ trên xuống dưới nhà họ Kha
柯家兄弟=anh em nhà họ Kha
柯家公子=công tử nhà họ Kha
柯家家主=Kha gia gia chủ
柯家族长=Kha gia tộc trưởng
柯家父子=Kha gia phụ tử
柯家老祖=Kha gia lão tổ
柯家领地=lãnh địa nhà họ Kha
柯小兄弟=Kha tiểu huynh đệ
柯小王爷=Kha tiểu Vương gia/Kha tiểu vương gia
柯少奶奶=Kha thiếu nãi nãi/mợ Kha
柯老先生=Kha lão tiên sinh
柯老前辈=Kha lão tiền bối
柯老太太=Kha lão thái thái
柯老太爷=Kha lão thái gia
柯老夫人=Kha lão phu nhân
柯老夫子=Kha lão phu tử
柯老妈子=Kha lão mụ tử
柯老将军=Kha lão tướng quân
柯老帮主=Kha lão bang chủ
柯老施主=Kha lão thí chủ
柯老爷子=Kha lão gia tử
柯老财主=Kha lão tài chủ
柯董事长=Kha chủ tịch
柳影等人=Liễu Ảnh đám người
柳月小姐=Liễu Nguyệt tiểu thư/Liễu Nguyệt  tiểu thư
柳巡察使=Liễu tuần sát sứ
柳二公子=Liễu nhị công tử
柳二小姐=Liễu nhị tiểu thư
柳侯世家=Liễu thế gia
柳副主任=Liễu phó chủ nhiệm
柳副主席=Liễu phó chủ tịch
柳副乡长=Liễu phó chủ tịch xã
柳副书记=Liễu phó bí thư
柳副会长=Liễu hội phó
柳副厂长=Liễu xưởng phó
柳副厅长=Liễu phó phòng
柳副县长=Liễu phó chủ tịch huyện
柳副团长=Liễu phó đoàn trưởng
柳副堂主=Liễu phó đường chủ
柳副处长=Liễu phó phòng
柳副局长=Liễu cục phó
柳副市长=Liễu phó thị trưởng
柳副帮主=Liễu phó bang chủ
柳副总管=Liễu phó tổng quản
柳副总裁=Liễu phó tổng giám đốc
柳副所长=Liễu đồn phó
柳副指挥=Liễu chỉ huy phó
柳副掌教=Liễu phó chưởng giáo
柳副掌门=Liễu phó chưởng môn
柳副教主=Liễu phó giáo chủ
柳副校长=Liễu phó hiệu trưởng
柳副殿主=Liễu phó điện chủ
柳副洞主=Liễu phó động chủ
柳副班长=Liễu lớp phó
柳副盟主=Liễu phó minh chủ
柳副省长=Liễu phó tỉnh trưởng
柳副科长=Liễu phó khoa trưởng
柳副组长=Liễu phó tổ trưởng
柳副经理=Liễu phó quản lý
柳副舵主=Liễu phó đà chủ
柳副部长=Liễu phó bộ trưởng
柳副镇长=Liễu phó trấn
柳副门主=Liễu phó môn chủ
柳副阁主=Liễu phó các chủ
柳副队长=Liễu đội phó
柳副院长=Liễu viện phó
柳参谋长=Liễu tham mưu trưởng
柳叶剑法=Liễu Diệp kiếm pháp/Liễu diệp kiếm pháp
柳叶飞刀=liễu diệp phi đao
柳大元帅=Liễu đại Nguyên soái/Liễu đại nguyên soái
柳大公子=Liễu đại công tử
柳大妹子=Liễu đại muội tử
柳大学士=Liễu đại học sĩ
柳大将军=Liễu đại tướng quân
柳大小姐=Liễu đại tiểu thư
柳大少爷=Liễu đại thiếu gia
柳家上下=từ trên xuống dưới nhà họ Liễu
柳家兄弟=anh em nhà họ Liễu
柳家公子=Liễu gia công tử/công tử nhà họ Liễu
柳家大少=Liễu gia đại thiếu
柳家家主=Liễu gia gia chủ
柳家当今=Liễu gia đương kim
柳家族长=Liễu gia tộc trưởng
柳家父子=Liễu gia phụ tử
柳家的事=chuyện của Liễu gia
柳家的人=người của Liễu gia
柳家老祖=Liễu gia lão tổ
柳家领地=lãnh địa nhà họ Liễu
柳小兄弟=Liễu tiểu huynh đệ
柳小垩姐=Liễu tiểu thư
柳小姐你=Liễu tiểu thư ngươi
柳小王爷=Liễu tiểu Vương gia/Liễu tiểu vương gia
柳少奶奶=Liễu thiếu nãi nãi/mợ Liễu
柳老先生=Liễu lão tiên sinh
柳老前辈=Liễu lão tiền bối
柳老太太=Liễu lão thái thái
柳老太爷=Liễu lão thái gia
柳老夫人=Liễu lão phu nhân
柳老夫子=Liễu lão phu tử
柳老妈子=Liễu lão mụ tử
柳老将军=Liễu lão tướng quân
柳老帮主=Liễu lão bang chủ
柳老施主=Liễu lão thí chủ
柳老爷子=Liễu lão gia tử
柳老财主=Liễu lão tài chủ
柳董事长=Liễu chủ tịch
柴副主任=Sài phó chủ nhiệm
柴副主席=Sài phó chủ tịch
柴副乡长=Sài phó chủ tịch xã
柴副书记=Sài phó bí thư
柴副会长=Sài hội phó
柴副厂长=Sài xưởng phó
柴副厅长=Sài phó phòng
柴副县长=Sài phó chủ tịch huyện
柴副团长=Sài phó đoàn trưởng
柴副堂主=Sài phó đường chủ
柴副处长=Sài phó phòng
柴副局长=Sài cục phó
柴副市长=Sài phó thị trưởng
柴副帮主=Sài phó bang chủ
柴副总管=Sài phó tổng quản
柴副总裁=Sài phó tổng giám đốc
柴副所长=Sài đồn phó
柴副指挥=Sài chỉ huy phó
柴副掌教=Sài phó chưởng giáo
柴副掌门=Sài phó chưởng môn
柴副教主=Sài phó giáo chủ
柴副校长=Sài phó hiệu trưởng
柴副殿主=Sài phó điện chủ
柴副洞主=Sài phó động chủ
柴副班长=Sài lớp phó
柴副盟主=Sài phó minh chủ
柴副省长=Sài phó tỉnh trưởng
柴副科长=Sài phó khoa trưởng
柴副组长=Sài phó tổ trưởng
柴副经理=Sài phó quản lý
柴副舵主=Sài phó đà chủ
柴副部长=Sài phó bộ trưởng
柴副镇长=Sài phó trấn
柴副门主=Sài phó môn chủ
柴副队长=Sài đội phó
柴副院长=Sài viện phó
柴参谋长=Sài tham mưu trưởng
柴大元帅=Sài đại nguyên soái
柴大公子=Sài đại công tử
柴大将军=Sài đại tướng quân
柴大小姐=Sài đại tiểu thư
柴大少爷=Sài đại thiếu gia
柴家上下=từ trên xuống dưới nhà họ Sài
柴家兄弟=anh em nhà họ Sài
柴家公子=công tử nhà họ Sài
柴家家主=Sài gia gia chủ
柴家族长=Sài gia tộc trưởng
柴家老祖=Sài gia lão tổ
柴家领地=lãnh địa nhà họ Sài
柴小兄弟=Sài tiểu huynh đệ
柴小王爷=Sài tiểu vương gia
柴少奶奶=mợ Sài
柴房里面=bên trong phòng chứa củi
柴老先生=Sài lão tiên sinh
柴老前辈=Sài lão tiền bối
柴老夫人=Sài lão phu nhân
柴老将军=Sài lão tướng quân
柴老帮主=Sài lão bang chủ
柴老施主=Sài lão thí chủ
柴董事长=Sài chủ tịch
桂董事长=Quế chủ tịch
桂家家主=Quế gia gia chủ
桂家族长=Quế gia tộc trưởng
桂家老祖=Quế gia lão tổ
桂小兄弟=Quế tiểu huynh đệ
桂小王爷=Quế tiểu vương gia
桂家领地=lãnh địa nhà họ Quế
桂老先生=Quế lão tiên sinh
桂老前辈=Quế lão tiền bối
桂老夫人=Quế lão phu nhân
桂老将军=Quế lão tướng quân
桂老帮主=Quế lão bang chủ
桂老施主=Quế lão thí chủ
桂少奶奶=mợ Quế
桂副主任=Quế phó chủ nhiệm
桂副主席=Quế phó chủ tịch
桂副乡长=Quế phó chủ tịch xã
桂副书记=Quế phó bí thư
桂副会长=Quế hội phó
桂副厂长=Quế xưởng phó
桂副厅长=Quế phó phòng
桂副县长=Quế phó chủ tịch huyện
桂副团长=Quế phó đoàn trưởng
桂副堂主=Quế phó đường chủ
桂副处长=Quế phó phòng
桂副局长=Quế cục phó
桂副市长=Quế phó thị trưởng
桂副帮主=Quế phó bang chủ
桂副总管=Quế phó tổng quản
桂副总裁=Quế phó tổng giám đốc
桂副所长=Quế đồn phó
桂副指挥=Quế chỉ huy phó
桂副掌教=Quế phó chưởng giáo
桂副掌门=Quế phó chưởng môn
桂副教主=Quế phó giáo chủ
桂副校长=Quế phó hiệu trưởng
桂副殿主=Quế phó điện chủ
桂副洞主=Quế phó động chủ
桂副班长=Quế lớp phó
桂副盟主=Quế phó minh chủ
桂副省长=Quế phó tỉnh trưởng
桂副科长=Quế phó khoa trưởng
桂副组长=Quế phó tổ trưởng
桂副经理=Quế phó quản lý
桂副舵主=Quế phó đà chủ
桂副部长=Quế phó bộ trưởng
桂副镇长=Quế phó trấn
桂副门主=Quế phó môn chủ
桂副队长=Quế đội phó
桂副院长=Quế viện phó
桂参谋长=Quế tham mưu trưởng
桂大元帅=Quế đại nguyên soái
桂大公子=Quế đại công tử
桂大将军=Quế đại tướng quân
桂大小姐=Quế đại tiểu thư
桂大少爷=Quế đại thiếu gia

得和=phải cùng
"不要啊="Đừng a
没有;=chưa,
和.=hòa.
耳"=tai"/mà thôi"
因,=nhân,
因.=nhân.
因?=nhân?
死了,=chết rồi,
死了.=chết rồi.
辈,=bối phận,

出息=tiền đồ/triển vọng/viễn cảnh/khả năng thành công/viễn tượng/tiến bộ/khá lên/tiến triển/thu nhập/thu hoạch/lợi/lợi lộc
一刹那=một sát na/trong tích tắc/trong nháy mắt/trong một sát na
你在=ngươi đang ở