几内亚比绍=Ghi-nê Bít-xao/Guinea Bissau
陶神医=Đào thần y
黄药真人=Hoàng Dược chân nhân
冷舵主=Lãnh Đà chủ
填小姐=Điền tiểu thư
齐姐=Tề tỷ
齐善行=Tề Thiện Hành
齐堂主=Tề đường chủ
齐帝=Tề đế
齐总=Tề tổng
齐悦=Tề Duyệt
齐伯=Tề bá
齐朝=Tề triều
齐老怪=Tề lão quái
齐阳=Tề Dương
齐三少=Tề tam thiếu
齐云观=Tề Vân Quan
齐元=Tề Nguyên
齐兄=Tề huynh
龙伯=Long bá
龙侍=Long thị
龙台=Long Đài
龙哥=Long ca
龙天=long thiên
龙头帮=Long Đầu Bang
龙姨=Long di
龙帅=Long soái
龙少=Long thiếu
龙少爷=Long thiếu gia
龙戬=Long Tiển
龙晗=Long Hàm
龙血变=Long Huyết biến
龟家=Quy gia
龟母=Quy mẫu
龟爷=Quy gia
龟王=Quy vương
龟老=Quy lão
边兄=Biên huynh
边卿=Biên khanh
边叔=Biên thúc
楚云阁=Sở vân các
楚兄=Sở huynh
楚儿=Sở nhi
楚叔=Sở thúc
楚南=Sở Nam
楚史=Sở sử
楚大郎=Sở đại lang
楚天=Sở Thiên
楚姨=Sở di
楚小=Sở tiểu tử
楚少=Sở thiếu
楚帝=Sở đế
楚平=Sở Bình
楚御=Sở Ngự
力家=Lực gia
天姐姐=Thiên tỷ tỷ
管姐姐=Quản tỷ tỷ
风大公子=Phong đại công tử
羊大师=Dương đại sư
桃花书吧=Đào Hoa thư ba
猫主教=Miêu giáo chủ
伊尼戈=Y Ni Qua
言前辈=Ngôn tiền bối
的路贤侄=Lộ hiền chất
农大小姐=Nông đại tiểu thư
越掌门=Việt chưởng môn
文副厅长=Văn phó phòng
安亲会=An Thân hội
秋大小姐=Thu đại tiểu thư
刘所长=Lưu đồn trưởng
田彩香=thôn Điền Thải
白二小姐=Bạch nhị tiểu thư
希大小姐=Hi đại tiểu thư
张大小姐=Trương đại tiểu thư
徐二公子=Từ nhị công tử
徐伯=Từ bá
徐六径=Từ Lục Kính
徐凤玉=Từ Phượng Ngọc
徐千总=Từ Thiên tổng/Từ thiên tổng
徐卫=Từ Vệ
徐叔=Từ thúc
徐哥=Từ ca
徐城主=Từ thành chủ
徐大兄=Từ đại huynh
徐大叔=Từ đại thúc
徐大夫=Từ đại phu
徐大郎=Từ đại lang
徐娘=Từ nương
徐嫂=Từ tẩu
徐宁=Từ Ninh
徐家的人=người của Từ gia
徐少主=Từ thiếu chủ
徐局=Từ cục
徐弟=Từ đệ
徐循=từ tuần
徐微=từ vi
徐悲鸿=Từ Bi Hồng/Xu Beihong
徐擎=Từ Kình
徐晶蕾=Từ Tinh Lôi
徐枫=Từ Phong
徐王=Từ vương
徐珠贤=Seo Ju-hyun
徐离=Từ Ly
徐秀才=Từ tú tài
徐老爷子=Từ lão gia tử
徐老鬼=Từ lão quỷ
徐诚=Từ Thành
徐达=Từ Đạt
徐院长=Từ viện trưởng
徐飞=Từ Phi
慕卿=Mộ khanh
慕哥=Mộ ca
慕大侠=Mộ đại hiệp
慕姨=Mộ di
慕嫂=Mộ tẩu
慕容公子=Mộ Dung công tử
慕容冲=Mộ Dung Trùng
慕容师兄=Mộ Dung sư huynh
慕容府=Mộ Dung phủ
慕容氏=Mộ Dung thị
慕总=Mộ tổng
慕杀=mộ sát
慕桑=Mộ Tang
慕氏=Mộ thị
慕老怪=Mộ lão quái
慕舅=Mộ cữu
慕艾=mộ ngải/Mộ Ngải
慕门主=Mộ môn chủ
慧姐=Tuệ tỷ
慧明=Tuệ Minh
慧芳=Tuệ Phương
慧觉=tuệ giác
憨哥=Hàm ca
戈门主=Qua môn chủ
成叔=Thành thúc
成哥=Thành ca
成妹=Thành muội
成姨太=Thành di thái
成嫂=Thành tẩu
成儿=Thành nhi
成师叔=Thành sư thúc
成师祖=Thành sư tổ
成阳=Thành Dương
成雄=Thành Hùng
欧葛=Augur
欧都桑=otoo-san
欧志=Âu Chí
欧拉=Euler
欧斯=Oars
欧阳公子=Âu Dương công tử
欧鲁克=O'Rourke
段公子=Đoàn công tử
段千总=Đoàn Thiên tổng/Đoàn thiên tổng
殷伯=Ân bá
段卿=Đoàn khanh
段武=Đoạn Vũ
段哥=Đoàn ca
段大哥=Đoàn đại ca
段姐=Đoàn tỷ
段小子=Đoàn tiểu tử
段府=Đoàn phủ
殷母=Ân mẫu
殷爷=Ân gia
殷老儿=Ân lão nhi
殷老六=Ân lão lục
殷莹=Ân Oánh
殷某=Ân mỗ
殷城主=Ân thành chủ
殷大哥=Ân đại ca
殷嫂=Ân tẩu
母辛=Mẫu Tân
毒岛=Busujima
毒源丹=Độc nguyên đan/{Độc nguyên đan}
毒门=Độc môn
比利=Billy
比安=Bian
比箭家=so Tiễn gia
比索=peso
比良坂=Hirasaka
毕师祖=Tất sư tổ
毕儿=Tất nhi
毕伯=Tất bá
毕卿=Tất khanh
毕玄=Tất Huyền
毕尔巴鄂=Bilbao
毕姓=họ Tất
毕家=Tất gia
毕竞=dù sao
毕老=Tất lão
毕老八=Tất lão bát
毕老六=Tất lão lục
毕老鬼=Tất lão quỷ
毛叔=Mao thúc
毛利家=nhà Mouri
毛细=mao tế
毛老六=Mao lão lục
毛老怪=Mao lão quái
毛肚=mao đỗ
