
前戏=màn dạo đầu
嗯=ừm
抽插=cắm rút
噼啪=pách pách
唔=ưm
呀呀呀=ah ah ah
滋=phốc
扑滋=phốc
扑滋-bạch bạch
呢=nha
喂=Uy


杨涛=Dương Đào
张昌=Trương Xương
杨月玲=Dương Nguyệt Linh
杨雪兰=Dương Tuyết Lan
刘伟男=Lưu Vĩ Nam
刘洪海=Lưu Hồng Hải
刘馨芸=Lưu Hinh Vân
刘淑柔=Lưu Thục Nhu
金洁=Kim Khiết
梦莹=Mộng Oánh
小莹=Tiểu Oánh
俊凯=Tuấn Khải
钟牛=Chung Ngưu
楚=Sở
雨航=Vũ Hàng
雨熙=Vũ Hi
小莹=Tiểu Oánh
赵安=Triệu An
楚雨瑛=Sở Vũ Anh
艳艳=Diễm Diễm
温婷=Ôn Đình
俊凯=Tuấn Khải
温岚=Ôn Lam
染染=Nhiễm Nhiễm
白律师=Bạch luật sư
金大器=Kim Đại Khí
白染=Bạch Nhiễm
白染染=Bạch Nhiễm Nhiễm
王丹=Vương Đan
张新达=Trương Tân Đạt
白沫=Bạch Mạt/bọt trắng
叶婵宫=Diệp Huyên Cung
赵襄儿=Triệu Tương Nhi
宁长久=Ninh Trường Cửu
赵馨蕾=Triệu Hinh Lôi
李巧华=Lý Xảo Hoa
张可秦=Trương Khả Tần
辛钘=Tân Hình
沈如玉=Thẩm Như Ngọc
南彦=Nam Ngạn
江与同=Giang Vũ Đồng
新辉=Tân Huy
陈沐语=Trần Mộc Ngữ
沐语=Mộc Ngữ
明烟=Minh Yên
李舟=Lý Chu
沈雯=Thẩm Văn
韩梦禾=Hàn Mộng Hòa
张寒=Trương Hàn
魏小冉=Ngụy Tiểu Nhiễm
萧怡婷=Tiêu Di Đình
林时云=Lâm Thời Vân
段恩泽=Đoạn Ân Trạch
段莹莹=Đoạn Oánh Oánh
莹莹=Oánh Oánh
张惟风=Trương Duy Phong
黄国新=Hoàng Quốc Tân
赵冉冉=Triệu Nhiễm Nhiễm
王锦程=Vương Cẩm Trình
刘雨=Lưu Vũ
裕树=Dụ Thụ/Yuki
王芊芊=Vương Thiên Thiên
韩易=Hàn Dịch
裴凌=Bùi Lăng
周梦莹=Chu Mộng Oánh
小冉=Tiểu Nhiễm
叶紫诺=Diệp Tử Nặc
邹贝=Châu Bối
邹丰=Châu Phong
白仙君=Bạch Tiên Quân
苏子悦=Tô Tử Duyệt
闵墨=Mẫn Mặc
顾婉馨=Cố Uyển Hinh
姚亮=Diêu Lượng
姜剑灵=Khương Kiếm Linh
林沐雪=Lâm Mộc Tuyết
齐贤之=Tề Hiền Chi
艾婉蕊=Ngải Uyển Nhuệ
王三毛=Vương Tam Mao
刘婉晴=Lưu Uyển Tình
张小姇=Trương Tiểu Hào
阿诺=Hàn Nặc江天逸=Giang Thiên Dật
舒兰=Thư Lan
舞衣=Vũ Y
祈玄虎=Kỳ Huyền Hổ
祈玄虎=Kỳ Huyền Hổ
祈玄虎=Kỳ Huyền Hổ
殿九=Điện Cửu
白雪=Bạch Tuyết
巧甯=Xảo Nịnh
巧甯=Xảo Nịnh
巧甯=Xảo Nịnh
