三巨头=Tam cự đầu/Tam bá chủ
阿花=a Hoa
阿芸=a Vân
阿苹=A Bình
阿茵=A Nhân
阿荃=A Thuyên
阿莉=A Lỵ
阿莫西林=Amoxicillin/amoxicillin
阿莫鲁索=Amoroso
阿莱娜=Alena
阿莱雅=Alaya
阿萝=A La
阿蛇=A Xà
阿玉=A Ngọc
阿玛迪斯=Amadeus
阿玲=A Linh
阿璇=a Tuyền
阿生=Jason
阿祥=A Tường/a Tường
阿福比=Afobe
阿离=A Ly
阿穆伦=Amren
阿空=A Không
阿童木=Atom
阿笠=Agasa
阿罗诃=Allah
阿翁=a ông/AEon
阿牛=A Ngưu
阿猛=A Mãnh
阿杜=A Đỗ
陆峰=Lục Phong
陆岸=Lục Ngạn
陆康=Lục Khang
阿林=A Lâm
阿枫=A Phong
阿柏怪=Arbok
阿标=A Tiêu/a tiêu
阿棠=A Đường
阿水=a Thủy/A Thủy
阿海=A Hải
阿涛=A Đào
阿滨=A Tân
阿豪=A Hào
阿豹=A Báo
阿辉=A Huy
阿边=a biên
阿进=A Tiến
阿里山=A Lí Sơn
阿银=A Ngân
阿阳=A Dương
阿陵=A Lăng
阿飘=Nguyễn Văn Ma
陆小兄=Lục tiểu huynh
陆卿=Lục khanh
陆秀夫=Lục Tú Phu
陆雪芊=Lục Tuyết Thiên
陆鸣=Lục Minh
陆鸦=Lục Nha
陆逊=Lục Tốn
陈北玄=Trần Bắc Huyền
陈卓=Trần Trác
陈和=Trần Hòa
陈大壮=Trần Đại Tráng
陇川=Lũng Xuyên
陈一=Trần Nhất
陈三=Trần Tam
陈冲=Trần Trùng
陈奇瑜=Trần Kỳ Du
陈二=Trần Nhị
陈仓=Trần Thương
陈侄=Trần điệt
陈元=Trần Nguyên
陈元达=Trần Nguyên Đạt
陈奕迅=Trần Dịch Tấn/Eason Chan
陈宇轩=Trần Vũ Hiên
陈德=Trần Đức
陈新宇=Trần Tân Vũ
陈明=Trần Minh
陈杨=Trần Dương
陈林=Trần Lâm
陈汉升=Trần Hán Thăng
陈玄奘=Trần Huyền Trang
陈研=Trần Nghiên
陈祎=Trần Y
陈祥=Trần Tường
陈淑芬=Trần Thục Phân
陈芜=Trần Vu
陈若=Trần Nhược
陈蕾=Trần Lôi
陈辉=Trần Huy
陈远=Trần Viễn
陈钰琪=Trần Ngọc Kỳ
陈长林=Trần Trường Lâm
陈雨=Trần Vũ
陈雨蓉=Trần Vũ Dong
陈鹰=Trần Ưng
陪戎=Bồi Nhung
陶恭祖=Đào Cung Tổ
隐娘=Ẩn Nương
雅柔=Nhã Nhu
雅玉=Nhã Ngọc
集宝斋=Tập Bảo Trai
雅玛=Nhã Mã
雅琴=Nhã Cầm
雁子=Nhạn Tử
雨清=Vũ Thanh
阿骁=A Kiêu
阿黄=A Hoàng
雨田=Vũ Điền
雷万鹤=Lôi Vạn Hạc
雷奥=Lôi Áo
雷媚=Lôi Mị
雷斩=Lôi Trảm
雨若=Vũ Nhược
雨蝶=Vũ Điệp
雨霜=Vũ Sương
雨诀=Vũ Quyết
雷蛙=Lôi Oa
霍仲孺=Hoắc Trọng Nhụ
霜华=Sương Hoa
霞照=Hà Chiếu
霸刀=Bá Đao
霸下=Bá Hạ
霸龙=Bá Long
霸钟=Bá Chung
青书=Thanh Thư
青玉案=Thanh Ngọc Án
霸天刀=Bá Thiên đao
霍烈=Hoắc Liệt
雷蛛=Lôi Chu