
直是=thực là
刻有=có khắc
边,=một bên,
为她=vì nàng
行人=người đi đường
一行人=một nhóm người/một đoàn người
心在=tâm tại
来是=tới là
但是=nhưng là
下吧=xuống đi
人说=người ta nói
了!=rồi!
喜欢吃=thích ăn
出丧=đưa ma
长的=lớn lên
对不起=thật xin lỗi
忙用=vội vàng dùng
活地=quả thực là
能听的=có thể nghe
不能听=không thể nghe
白了=trợn nhìn
慢地=chật đất
负了=phụ/thua/phụ bỏ/cha/bị
要给=muốn cho/cấp cho/phải cho
人之=nhân chi
教你=dạy ngươi
十二年=mười hai năm
死的=chết
定是=nhất định là
救了=cứu
死在=chết ở
坊里=trong phường
李嬷嬷=Lý má má/Lý ma ma
解渴=giải khát
小的=tiểu nhân
好气地=tức giận
做小=làm tiểu
人了=người
最有=nhất có
去跟=đi cùng
肉中=trong thịt
长.=dài.
说.=nói.
生在=sinh ở
见的=gặp
似被=giống bị
弃了=bỏ quên
全包=toàn bao
谷中=trong cốc
合着=thì ra
摸着=sờ lấy
起,=lên,
手小=tay nhỏ
头上=trên đầu
不成?=không thành?/hay sao?
带给=mang cho
好气地=tức giận
口中的=bên trong miệng
吻着=hôn
眼神中=ánh mắt bên trong/trong ánh mắt
穴中=trong huyệt
小舌=cái lưỡi
眼里=trong mắt
合着=thì ra
腹上=trên bụng
摆着=bày biện
日里=trong ngày
摆着=bày biện
上.=lên.

别人的=người khác
毛下=dưới lông
不得打=không nỡ đánh
玩着=chơi lấy
儿呢=chút đấy
受着=thụ lấy
数的=đếm được
进了=vào
秒后=giây sau
打不过=đánh không được
就跑=liền chạy
是当=là làm/là khi
天来=ngày qua
儿啊=con a
等会儿=đợi một chút/đợi lát nữa
长的=lớn lên
在被=tại bị
没?=không?
掉了=rớt
大了=lớn/lớn
发花=hoa mắt
游=du lịch
对不=đối không
娘胎=từ trong bụng mẹ|n
再去=lại đi
就走=bước đi
给家里=cho nhà
那圆=viên kia|nr
气道=cả giận/khí đạo|n