李珍妮=Lý Trân Ny
凝青=Ngưng Thanh
陈凝青=Trần Ngưng Thanh
庆亲王=Khánh thân vương/hoàng thân/thân thích của vua/hoàng tử
敬皇城=Kính Hoàng Thành
安盛=An Thịnh
安庆=An Khánh
通化=Thông Hóa
玄虎=Huyền Hổ
姬天恒=Cơ Thiên Hằng
大梵昊宗=Đại Phạm Hạo Tông
侏儒=Mập lùn
祈霸=Kỳ Bá
雪白=Bạch Tuyết
安轻柔=An Khinh Nhu
祈英=Kỳ Anh
高让=Cao Nhượng
欢喜和尚=Hoan Hỉ hòa thượng
盼大神女=Phán đại thần nữ
神殿=Thần Điện/điện thờ/thánh đường/đền thờ
林鹤=Lâm Hạc
焰云峰=Diễm Vân phong
盼神女=Phán thần nữ/nữ thần
祈帝=Kỳ đế
欢喜兄=Hoan Hỉ huynh
赵神韵=Triệu Thần Vận/say mê hấp dẫn/phong vận
神韵=Thần Vận/say mê hấp dẫn/phong vận
灵隐=Linh Ẩn
元月=Nguyên Nguyệt
安月=An Nguyệt/tháng/trăng
承君=Thừa Quân
语涵=Ngữ Hàm
耿照=Cảnh Chiếu/so sánh/noi theo/theo
药儿=Dược nhi
阿挛=A Luyên
婉儿=Uyển Nhi
雪白=tuyết trắng/Bạch Tuyết
柳如玉=Liễu Như Ngọc/Ruyu/như ngọc bích
若云=Nhược Vân
巴龙=Ba Long
若雨=Nhược Vũ/như mưa/Nếu trời mưa/Nếu mưa
小多=Tiểu Đa/nhỏ/tiểu nhìn nhiều/nhìn hơn/xem thêm/nhiều nhìn
方若雨=Phương Nhược Vũ/mới/vuông Nhược Vũ/như mưa/Nếu trời mưa/Nếu mưa
方若云=Phương Nhược Vân/mới/vuông Nhược Vân
林世宇=Lâm Thế Vũ
贾志远=Cổ Chí Viễn
方磨=Phương Ma
通云=Thông Vân
周晓云=Tuần Hiểu Vân/chu/xung quanh/vòng hiểu vân
穆磊=Mục Lỗi/chồng chất
林朔=Lâm Sóc/rừng sóc
古天=Cổ Thiên/ngày/thiên/bầu trời
林世昌=Lâm Thế Xương/rừng thế/đời xương/hưng thịnh/hưng
帝都=Đế Đô
魔都=Ma Đô/Thượng Hải/Modu, biệt danh của Thượng Hải
方宗南=Phương Tông Nam/mới/vuông tông nam/Minami
方永礼=Phương Vĩnh Lễ/mới/vuông vĩnh/vĩnh viễn/lâu dài lễ
方永谦=Phương Vĩnh Khiêm/mới/vuông vĩnh khiêm
古氏=Cổ thị
古氏=Cổ thị
冷月=Lãnh Nguyệt/trăng lạnh/mặt trăng lạnh
世宇=Thế Vũ
小月=tiểu Nguyệt/tháng thiếu/sinh non/sẩy thai
孙骁=Tôn Kiêu
柳薇=Liễu Vi
孟启航=Mạnh Khải Hàng
齐洪轩=Tề Hồng Hiên
张扬=Trương Dương/đường hoàng/nói toạc móng heo/nói toạc ra/khoa trương/khuếch đại/giương ra/lộ liễu/phô trương
马威=Mã Uy
凌然=Lăng Nhiên
李倾涵=Lý Khuynh Hàm
洛灵=Lạc Linh
磨哥=Ma ca
方欣=Phương Hân/mới/vuông hân/vui mừng
贾志远=Giả Chí Viễn
童蕊=Đồng Nhị
杨梦颖=Dương Mộng Dĩnh
高小林=Cao Tiểu Lâm/tiểu học cao đẳng/tiểu học bậc cao lâm/rừng
光达=Quang Đạt/chỉ riêng/ánh sáng/sạch/chỉ đạt
小童=tiểu Đồng
云雨双骄=Vân Vũ song kiêu/hoan lạc/ân ái/mây và mưa song kiêu/kiêu ngặc đôi
洛成勇=Lạc Thành Dũng
黄虎熊=Hoàng Hổ Hùng/hùng
萧门主=Tiêu môn chủ/chúa
林疏影=Lâm Sơ Ảnh
萧晴=Tiêu Tình
顾含烟=Cố Hàm Yên
疏影=Sơ Ảnh/Kage
洛尘勇=Lạc Trần Dũng
龙京=Long Kinh
在一根线上=cùng trên một sợi dây
嘴里沫沫太多了=trong miệng bọt trắng quá nhiều
宁秋婉=Ninh Thu Uyển
叶晓佳=diệp hiểu tốt
云雨会所=Vân Vũ câu lạc bộ
魔妃=Ma phi
左亨=Tả Hanh
闽传=Mân Truyền/truyện
苏以=Tô Dĩ
廖蓼=Liêu Liệu
闵传=Mẫn Truyền/truyện
边学道=Biên Học Đạo
李思静=Lý Tư Tĩnh/Shizuka
陆玄音=Lục Huyền Âm
苏清梦=Tô Thanh Mộng
安昭惠=An Chiêu Huệ
林檀曦=Lâm Đàn Hi
汉龙=Hán Long
林安桐=Lâm An Đồng
林妤=Lâm Dư
陶慧媛=Đào Tuệ Viện
林汉龙=Lâm Hán Long
慧媛=Tuệ Viện
安桐=An Đồng
檀曦=Đàn Hi
昭惠=Chiêu Huệ
穆朗=Mục Lãng
祝平=Chúc Bình/phẳng/hòa/mét vuông
赖小银=Lại Tiểu Ngân
何妤=Hà Dư
周美琳=Tuần Mỹ Lâm
孙雪=Tôn Tuyết
周美琳=Chu Mỹ Lâm
妤儿=Dư nhi/con
于春龙=Vu Xuân Long
幸媛=Hạnh Viện
陶幸媛=Đào Hạnh Viện
何式=Hà Thức/Shiki
高鹏=Trương Bằng
苏妍=Tô Nghiên
夕瑶=Tịch Dao/ngọc
花药=Hoa Dược
王紫菱=Vương Tử Lăng
夏婕曦=Hạ Tiệp Hi
嘉怡=Gia Di
罗嘉怡=La Gia Di
孟行雨=Mạnh Hành Vũ
叶流霜=Diệp Lưu Sương
天女门=Thiên Nữ môn/Eve/Tennyo/Tiannu cửa/môn/cánh cửa/们/khẩu
薛雨晴=Tiết Vũ Tình/trời trong xanh
麒麟门=Kỳ Lân môn/Kirin cửa/môn/cánh cửa/们/khẩu
杨天锦=Dương Thiên Cẩm/dương thiên gấm
谢雨荷=Tạ Vũ Hà
乌瑟曼=Ô Sắt Mạn/mạn
洛泱=Lạc Ương
金光=Kim Quang
达拉尼=Đạt Lạp Ni
米娜=Mỹ Na
金蚕=Kim Tàm
天兆=Thiên Triệu/điềm báo
兰婷=Lan Đình
兰俊杭=Lan Tuấn Hàng
吹喇叭=thổi kèn
湿泞=ẩm ướt lầy lội
张可盈=Trương Khả Doanh
芜=Diễm
江=Giang
小雨=tiểu Vũ/Tiểu Vũ
倾涵=Khuynh Hàm
孟启多=Mạnh Khải Đa/thêm/cỡ nào/đa
古耀华=Cổ Diệu Hoa
姜=Khương
姜觅=Khương Mịch
云上=Vân Thượng
安卓=An Thường
安卓=An Vũ Thường
摩柯兀=Ma Kha Ngạc
摩天焕=Cao Thiên Hoán
安卓=An Nghê Thường
雨婵=Nghê Thiền
然儿=Thường nhi
安雨婵=An Nghê Thiền
雨婵=Nhã Thiền
雨婵=Nhã Thiền
安雨婵=An Nhã Thiền
施=Mị
笑施=Vũ Mị
安笑施=An Vũ Mị
安如意=An Khuynh Nhược
笑施=Thiên Mị
安笑施=An Thiên Mị
安弋=An Lạc
弋=Lạc
聂松=Nhiếp Tùng
