//nsfw
小骚蹄子=tiểu tao hóa/con đ*ĩ nhỏ
末柄=lút cán
圣母婊=thánh mẫu đĩ/Đức Mẹ/chó cái thần thánh
好满足=thật thỏa mãn
好湿啊=thật ẩm ướt
好好闻=thật dễ ngửi
布滋=sụp soạt/sột soạt
泥泞蜜穴=lầy lội mật huyệt
大腿上=trên đùi
屁沟中=trong khe đít
屁眼上=trên lỗ đít
大眼睛=mắt to
缠缠绵绵=quấn quýt triền miên
蚌口=sò khẩu/bạng khẩu
拂弄=vuốt ve
自己的花蕊=chính mình nhị hoa
爱爱=ân ái
好胀=thật trướng
纤细盈盈=tinh tế mềm mại
作践我=chà đạp ta/sỉ nhục ta
大长腿=chân dài
浑圆=tròn đầy
挺翘=cao vểnh
浑圆挺翘=tròn trịa vểnh
隆硕=to lớn
翘臀=vểnh mông 
贴身丝袜=tất chân bó sát
作贱=làm tiện/làm nhục
臀缝中=trong khe mông
屄中央=trong lồn
阴缝下=dưới khe lồn
泄完精=xuất tinh xong
肥臀=mông bự/mông lớn
前戏=màn dạo đầu
嗯=ừm
抽插=cắm rút
噼啪=đôm đốp~/pách pách/pi pa
唔=ưm
啪啪啪=bạch bạch bạch~/ba ba ba/pa pa pa
扑扑=phạch phạch/phác phác/pu pu
呀呀呀=ah ah ah
滋=phốc
扑滋=phốc
扑滋=bạch bạch
淫词浪语=dâm từ lãng ngữ
好骚=thật tao/thật dâm
下嘴唇=miệng môi dưới/môi dưới/bờ môi/bờ môi
噗呲=nhóp nhép
水润=thủy nhuận
腟腔=hốc âm đạo
腟=âm đạo
腔=khoang/hốc
呢=nha
喂=uy
小逼=tiểu bức/lồn nhỏ
肉逼=thịt bức/thịt lồn
骚屄=tao bi/dâm lồn/lồn lẳng lơ
诱人极=cực độ mê người
骚逼=tao bức/little flirtatious cunt/little slutty whore
哼咛=hừ nhẹ
乳丘=nhũ khâu/quầng vú
浪屄=đãng bi/lãng bi/sóng bi
浪言=phóng túng nói
遭不住=không chịu nổi
雪乳上=trên vú trắng
雪乳下=dưới vú trắng
雪股=đùi trắng