就是了=là được rồi
转过去=quay đi/quay lại/chuyển qua/chuyển qua/xoay qua chỗ khác
正面=mặt trước/chính diện/mặt chính/mặt ngoài/mặt phải/mặt tốt/mặt tích cực/bên ngoài/bề ngoài/trực tiếp/ngay mặt
逃离似=như trốn chạy
被褥=chăn nệm/đệm chăn/đồ phủ giường/khăn trải giường/drap/chăn nệm
应着=đáp lại/ứng với/ứng với/đáp lời
凉衣架=giá phơi quần áo
小被褥=chăn nệm nhỏ
凉晒=phơi khô
厨房间=phòng bếp
里面=bên trong/bên trong/trong
不舍得=không nỡ/không bỏ được/không bỏ được/không nỡ lòng bỏ
上厨房=vào phòng bếp
瞎说=nói lung tung/nói bậy/nói mò/nói mò/càn/nói chừng/nói liều/nói càn
发展下去=tiếp tục phát triển/phát triển tiếp/tiếp tục phát triển
好喝=dễ uống/dễ uống/uống ngon
用得着你做呢=cần gì ngươi phải làm nha
给你做=làm cho ngươi/làm cho ngươi
给你们=cho các ngươi/cho các ngươi
毛巾=khăn lông/khăn mặt/khăn lông
抱下去=ôm tiếp
喜吃什么就点什么=thích ăn gì liền gọi món đó
体贴关心=chu đáo quan tâm
这么关心体贴=chu đáo như vậy quan tâm
小俩口=vợ chồng trẻ/tân phu thê/cô dâu mới
起飞文学网=mạng văn học cất cánh
丢死人=mất mặt chết/xấu hổ chết
走到=đi tới/di chuyển/đi đến/đi tới
房门边=bên cạnh cửa phòng/bên cửa phòng
房门=cửa phòng/cửa phòng
丑媳妇毕竟是要见公婆=nàng dâu xấu dù sao cũng phải ra mắt cha mẹ chồng
丰挻=đầy đặn/căng tràn
乳房=bầu ngực/nhũ phòng/nhũ phòng
身鲜艳的=trang phục tươi sáng
现在的=hiện tại
的缓步走着=chậm dãi đi tới.
将潮未潮=chưa đạt đến cực khoái
吊着=treo lên/treo
手掌=bàn tay/bàn tay/tay cầm
移开=rời ra/dời/dời đi
嘴巴=miệng/tát vào mồm/vả vào mồm/mồm
移开嘴巴=rời ra khỏi miệng
可=thực/nhưng/có thể/cũng/khả/đáng/thể
可怜兮兮=vô cùng đáng thương/vô cùng đáng thương/đáng thương
吓坏=doạ sợ/dọa sợ/dọa hỏng
她了=nàng rồi
不出=không ra/không ngoài/không ra/không xuất ra
蚊香=máy rung/nhang muỗi/hương chống muỗi
在家里=ở nhà/trong nhà/ở nhà
慢慢点=chậm rãi nha
随着=theo đó/theo
听见=nghe thấy/nghe thấy/nghe
紧跟着=ngay sau đó/theo sát lấy/theo sát mà/theo sát
正=đang/chính/đang/dương/thẳng
以最快的速度=bằng tốc độ nhanh nhất
蕾丝=ren hoa/viền ren/les/viền tơ/lôi ty/sợi hoa
是有道理=là có đạo lý
的心里想法=suy nghĩ trong lòng
一般=bình thường/Bình thường
老脸=mặt già/mặt mo/nét mặt già nua/cái mặt già này/mặt dày
俩=hai người/hai/lưỡng
屁沟=khe mông
过下=thỏa mãn chút
解少=giảm bớt
为了=chính vì
给我放下=buông xuống cho ta/để xuống cho ta
气乎乎=giận dỗi
不用=không cần/không dùng/khỏi cần/khỏi phải
横了=liếc nhìn
碰鼻子=tự gây rắc rối
不务正业=không làm việc đàng hoàng/không làm việc đàng hoàng
给你=cho ngươi/cho ngươi
脸都黑=mặt đều đen/mặt đều đen
有点=có chút/có điểm/chút/có ít/có chút/hơi/có phần
出息=tiền đồ/tiền đồ/triển vọng/viễn cảnh/khả năng thành công/viễn tượng/tiến bộ/khá lên/tiến triển/thu nhập/thu hoạch/lợi/lợi lộc
份工作=một công việc/một công việc
一声不吭=không nói một lời/không rên một tiếng/không nói tiếng nào
考虑了=đã cân nhắc
有些道理道=có chút đạo lý
道理=đạo lý/đạo lý/quy luật/nguyên tắc/lý lẽ/lý do/biện pháp/phương pháp/cách/dự định
道破=vạch trần/nói toạc ra/vạch trần/nói rõ/nói toạc móng heo
瞎说什么=nói lung tung cái gì/nói mò gì
收到了=đã thu được
发生了=đã phát sinh
说到了=đã nói đến
看了=vừa nhìn
信息过去=gửi tin tức qua
回信息=nhanh chóng hồi âm
信息=tin nhắn/tin tức/thông tin
就=liền/thì/tựu/ắt/thành/chính
还回味=dư vị
过了=trải qua
发信息过去=gửi tin tức qua
被罩杯=cúp áo vú
罩杯里面=trong áo vú/trong chén phủ
拧出水=vắt ra nước
道道=con đường/đạo/nói nói/tuyến đường/đạo đạo/từng đạo
晾乾=phơi khô/phơi càn
装法=trang pháp/cách lắp đặt
有一声无一声=tiếng có tiếng không
自笑了一下=từ từ nở nụ cười
就是=chính là/liền là/chính là/liền là/đúng thế
校花=giáo hoa/hiệu hoa/hoa hậu giảng đường/hoa khôi của trường
水蛇腰=thân hình như rắn nước/thân hình như thủy xà/thân hình như thủy xà/thân hình như rắn nước
但是=tuy nhiên/nhưng là/nhưng là/thế nhưng/nhưng/mà/nhưng mà
不为所动=không bị lay chuyển/bất vi sở động/bất vi sở động/không hề bị lay động
在办公室里=ở trong văn phòng/trong phòng làm việc/ở trong phòng làm việc
紧要关=thời khắc then chốt/khẩn yếu quan/thời điểm quan trọng
时侯=thời điểm/lúc/lúc/thời điểm
和自己=cùng mình
做爱情运动=quan hệ/làm chuyện ấy/làm tình yêu vận động
输入了=nhập vào/thâu nhập/thâu nhập
点了=nhấn vào/điểm vào
搜索=tìm kiếm/lục soát/lục soát/tìm tòi/sục sạo/lùng tìm
做了一次=làm một lần rồi
给给=gửi cho/gửi gửi/cho cho/cho cho/nhanh nhanh
一会后=sau đó/sau khi/sau khi/một lát sau
过去了=đi qua rồi/quá khứ rồi
拖着=trì hoãn/ kéo dài/kéo lấy/kéo lấy/kéo
回过来=phản hồi/trả lời
说明=nói rõ/nói rõ/thuyết minh/chứng minh
不叫她生气=không khiến nàng sinh khí
哄=dỗ/hống/hống/dỗ/lừa/dỗ dành
那好啊=vậy tốt rồi
多望她=nhìn nàng thêm
单位上=ở cơ quan
父亲的病根=căn nguyên bệnh của phụ thân
羞涩涩=ngại ngùng
一到了=vừa về đến
装着常=làm bộ như thường
娇嗔着道=hờn dỗi nói
娇嗔着=hờn dỗi/kiều sân
被子=chăn mền/chăn/mền/chăn,mền
妈妈=ma ma/mụ mụ/mẹ/má/me/u/bầm/mẫu thân/mợ
隐隐可见,=ẩn ẩn hiện hiện
壮着胆=lấy hết can đảm
有什活=có việc gì
转了过去=xoay lại
扶正=vuốt chỉnh/phù chính/phù chính (*)/đỡ thẳng
下嘴唇=miệng môi dưới/môi dưới/bờ môi/bờ môi/miệng môi dưới
噗呲=nhóp nhép
好骚=thật tao/thật dâm
睁着眼睛说瞎话=nói dối không chớp mắt
水润=thủy nhuận
滋味=mùi vị/tư vị/tư vị/mùi vị/tiếp thụ/cảm thụ/mùi
腟腔=hốc âm đạo
腟=âm đạo
腔=khoang/hốc
丢死人了=xấu hổ chết rồi
紧=chặt/khít/gấp/gấp/chặt/nhanh
紧张=khẩn trương/căng thằng/hồi hộp/căng thẳng/eo hẹp/túng thiếu
开阳台=mở ban công
生活过日子=sinh hoạt qua ngày/sống qua ngày
不出轨=không lạc đường/không ngoại tình/không trệch đường
无暇=không tì vết/không rảnh/hoàn mỹ/vô hạ/không rỗi/无瑕 (không tì vết)
股瓣=mông đùi
低呤=thì thầm/nhỏ giọng
食之无胃=ăn không vô/không muốn ăn/ăn chi không dạ dày
梳理好发=chải vuốt tóc xong
就象=tựa như/liền như
身体=cơ thể/thân thể/cơ thể
性征=tính giới
禽曽=gia súc
该女儿=nữ nhi này
可以=có thể/còn được/nhưng lấy
则缂=thêu
一般般=bình thường/bình thường thôi
换下来=thay đổi/thay ra/đổi lại/bị thay thế
池里面=trong bể/trong hồ/trong ao
朝着=hướng về/hướng phía/hướng/hướng về
可怜巴巴=biểu cảm đáng thương/tội nghiệp/đáng thương
最羞人=xấu hổ nhất
身体上=trên cơ thể/trên thân thể
眼鼻子底下=dưới mắt
隐隐可见=mờ ảo hiện lên/mờ ảo có thể thấy
缠缠绵绵=quấn quýt triền miên
整垮=hoàn toàn sụp đổ/cả đổ
点了头=gật đầu/gật đầu
狼一般的光=ánh sáng loài sói
三月某天晚上=một đêm nào đó tháng ba
老汉推车姿势=tư thế lão hán đẩy xe bò
国中读完=học xong trung học
在地上=trên mặt đất/Ngồi trên mặt đất
过去=đi qua/quá khứ/trôi qua/đi qua/đã qua/qua/đi/tới
说实话=thực lòng mà nói/nói lời nói thật/nói thật/nói thật đi
好了没有?=đã xong chưa?
湿漉漉=ướt sũng rồi/ướt đẫm rồi/ướt sũng/ướt dề/ướt đầm dề/ướt át/ướt rượt/ướt sườn sượt/ướt nhẹp
很紧很紧=vô cùng chặt khít
再忍住=lại nhịn xuống
紧紧=chặt chẽ/chăm chú/chú ý/tha thiết/chặt chẽ/sít sao/gắt gao/thân thiết/thật chặt
不再问她了=không hỏi nàng nữa rồi
脸侧在了一边=quay mặt sang một bên
丰膄=đầy đặn
用手掌=dùng bàn tay
秀露出=lộ ra
跟我打招呼=chào hỏi ta
我朝着=ta hướng về
作贱=làm tiện/làm nhục
拂弄=vuốt ve
一下子=ngay lập tức/lập tức/thoáng cái
下撸动=chà xát xuống/vuốt xuống
身体好嘛=cơ thể thật tốt a
可怜=đáng thương/thương cảm/thảm thương/đáng tiếc/thương/thương xót/tội nghiệp/thảm/quá ít/quá kém
蚌口=sò khẩu/bạng khẩu/bạng khẩu
自己的花蕊=chính mình nhị hoa
好胀=thật trướng/tốt trướng
不得滴=không được đâu/không thể được
卫生眼=nhìn khinh thường/khinh thường ánh mắt/vệ sinh mắt
也不断=cũng không ngừng/cũng không đoạn/cũng không ngừng/không hoàn toàn
调和折中=điều hòa và thỏa hiệp
我的岳父母=cha mẹ vợ của ta
吐气如兰=hơi thở tựa hoa lan/thổ khí như lan/thổ khí như lan/hơi thở như hoa lan
不都是=không phải đều là
爱爱=ân ái
你猜?=ngươi nói xem?/ngươi đoán xem?
止止=làm dịu/giảm bớt
是不是啊?=có phải không a?
细长柳眉=lông mày liễu dài nhỏ
高挺琼瑶鼻子=mũi ngọc cao thẳng
不太理=không để ý
真是活腻=thật là chán sống 

月容=nguyệt dung

妈妈=ma ma
不过时不等人=bất quá thời gian không đợi người
养=nuôi
养=nuôi
奚泉=hề suối
肛塞=buttplug/giang nhét
肛塞=buttplug/giang nhét
中年女子=trung niên nữ tử
中年女子=trung niên nữ tử
他=nàng
=
有些苦逼=có chút khổ sở
花到=chi tiêu đến/dành đến/hoa đến
