.-=//câu dài
.-=cho ta
给吾等着=chờ lấy cho ta
给她上药=bôi thuốc cho nàng
给她做饭=nấu cơm cho nàng
给她准备=chuẩn bị cho nàng
给她压阵=áp trận cho nàng
给她披上=phủ thêm cho nàng
给她按摩=xoa bóp cho nàng
给她松绑=mở trói cho nàng
给她治疗=chữa trị cho nàng
给她治病=trị bệnh cho nàng
给她疗伤=chữa thương cho nàng
给她看见=cho nàng xem
给她自己=cho chính nàng
给她花钱=tiêu tiền cho nàng
给她解围=giải vây cho nàng
给她说过=từng nói với nàng
给她送花=tặng hoa cho nàng
给她配药=chế thuốc cho nàng
给姐姐买=mua cho tỷ tỷ
给姑奶奶=cho cô nãi nãi
给它供电=cung cấp điện cho nó
给它倒上=rót cho nó
给它全收=lấy sạch nó
给它准备=chuẩn bị cho nó
给它让位=nhường ngôi cho nó
给它说过=từng nói với nó
给家里人=cho người trong nhà
给密封住=che kín lại
给小孩子=cho tiểu hài tử
给左右了=chi phối
给市政府=cho chính phủ thành phố
给引出来=dẫn ra ngoài
给您上香=dâng hương cho ngài
给您安排=an bài cho ngài
给您带上=mang tới cho ngài
给您带路=dẫn đường cho ngài
给您当机=làm tài xế cho ngài
给您报仇=báo thù cho ngài
给您拿去=đi lấy cho ngài
给您留着=giữ lại cho ngài
给您解释=giải thích cho ngài
给您道歉=nói xin lỗi ngài
给我上报=cho ta báo cáo
给我上来=đi lên cho ta
给我上街=ra đường cho ta
给我下去=đi xuống cho ta
给我下山=xuống núi cho ta
给我介绍=giới thiệu cho ta
给我们家=cho nhà chúng ta
给我住口=im miệng cho ta/ngậm miệng lại cho ta
给我住嘴=im miệng cho ta
给我住手=dừng tay cho ta
给我保密=giữ bí mật cho ta
给我做掉=giết cho ta
给我做饭=nấu cơm cho ta
给我停下=dừng lại cho ta
给我停手=ngừng tay cho ta/dừng tay cho ta
给我儿子=cho nhi tử ta
给我写信=viết thư cho ta
给我准备=chuẩn bị cho ta
给我出去=đi ra ngoài cho ta
给我出来=đi ra cho ta
给我出现=xuất hiện cho ta
给我办理=làm cho ta
给我加油=ủng hộ cho ta
给我动手=động thủ cho ta
给我压得=gây áp lực cho ta
给我去搜=đi lục soát cho ta
给我去死=đi chết đi/chết đi cho ta
给我发掉=phát hết cho ta
给我叫来=gọi tới cho ta
给我听吗=cho ta nghe không
给我听好=nghe kỹ cho ta
给我听着=nghe cho ta
给我回来=trở lại cho ta
给我坐下=ngồi xuống cho ta
给我坐好=ngồi đàng hoàng cho ta
给我奉茶=dâng trà cho ta
给我女儿=giao cho nữ nhi của ta
给我姐买=mua cho tỷ của ta
给我安排=an bài cho ta
给我射击=bắn cho ta
给我带来=mang đến cho ta
给我带话=báo cho ta
给我带路=dẫn đường cho ta
给我帮忙=giúp ta một tay/giúp ta
给我干掉=giết chết cho ta
给我干活=làm việc cho ta
给我开火=khai hỏa cho ta
给我开炮=bắn pháo cho ta
给我开车=lái xe cho ta
给我开道=mở đường cho ta
给我开门=mở cửa ra cho ta
给我待着=đợi cho ta
给我忍着=nhịn cho ta
给我戴上=đeo lên cho ta
给我打开=mở ra cho ta
给我打扇=quạt cho ta
给我打赏=thưởng cho ta
给我找事=tìm việc cho ta
给我抓鱼=bắt cá cho ta
给我报仇=báo thù cho ta
给我拉琴=kéo đàn cho ta
给我拿下=bắt lại cho ta
给我拿人=bắt người cho ta
给我指点=chỉ điểm cho ta
给我掌嘴=vả miệng cho ta
给我掠阵=lược trận cho ta
给我提高=đề cao cho ta
给我搜尽=cho ta tìm hết
给我搜查=lục soát cho ta
给我撤退=rút lui cho ta
给我攻击=công kích cho ta
给我放下=để xuống cho ta
给我放开=buông ra cho ta
给我放手=buông tay cho ta
给我敬酒=mời ta rượu
给我斩杀=cho ta chém giết
给我杀光=giết sạch cho ta
给我杀掉=giết chết cho ta
给我杀死=giết chết cho ta
给我梳头=chải đầu cho ta
给我检查=kiểm tra cho ta
给我死!=chết đi cho ta!
给我死去=chết đi cho ta
给我死吧=chết đi cho ta
给我死开=chết đi cho ta
给我死来=chết đi cho ta
给我汇报=hồi báo cho ta
给我治吧=chữa cho ta đi
给我治病=chữa bệnh cho ta
给我洗脚=rửa chân cho ta
给我消失=biến mất cho ta
给我滚吧=cút đi cho ta
给我滚开=cút ngay cho ta
给我滚粗=cho ta lăn thô
给我滚蛋=xéo ngay cho ta/cút cho ta
给我滚走=cút đi cho ta
给我炼制=luyện chế cho ta
给我炼化=luyện hóa cho ta
给我爆开=cho ta bạo khai
给我电话=điện thoại cho ta
给我留下=lưu lại cho ta/đứng lại cho ta/để lại cho ta/lưu đứng lại cho ta
给我留住=lưu lại cho ta
给我留信=để lại thư cho ta
给我留点=chừa chút cho ta
给我留着=giữ cho ta
给我的枪=cấp ngã thương
给我的话=đưa cho ta
给我看病=xem bệnh cho ta
给我看看=cho ta xem một chút/cho ta xem/nhìn một chút/cho ta nhìn một chút
给我破城=phá thành cho ta
给我破开=phá vỡ cho ta/phá ra cho ta
给我破灭=vỡ cho ta/phá diệt cho ta
给我破碎=phá nát cho ta
给我砸烂=đập nát cho ta
给我突击=đột kích cho ta
给我站住=đứng lại cho ta
给我等着=chờ đó cho ta/chờ cho ta
给我等等=chờ ta một chút
给我练刀=luyện đao cho ta
给我脱光=cởi sạch cho ta
给我脱掉=cởi ra cho ta
给我解释=giải thích cho ta
给我让开=tránh ra cho ta
给我记住=nhớ kỹ cho ta
给我记着=nhớ kỹ cho ta
给我讲经=giảng kinh cho ta
给我讲讲=nói cho ta một chút
给我说下=nói cho ta biết
给我说说=nói cho ta nghe một chút đi/nói cho ta nghe một chút
给我说过=từng nói với ta
给我贺寿=chúc thọ cho ta
给我走开=đi ra cho ta
给我起来=đứng lên cho ta
给我趴下=gục xuống cho ta
给我跪下=quỳ xuống cho ta
给我过来=tới đây cho ta
给我还来=trả lại cho ta
给我追击=truy kích cho ta
给我退下=lùi xuống cho ta
给我退场=rút lui cho ta
给我送信=đưa tin cho ta
给我送来=đưa tới cho ta
给我道歉=nói xin lỗi ta
给我醒来=tỉnh lại cho ta
给我针灸=châm cứu cho ta
给我闪开=mau tránh ra cho ta
给我闭嘴=câm miệng cho ta

.-=//câu khó