.-=//câu khó
很快有=rất nhanh có
我吓的=ta bị dọa/ta sợ
给她舔=liếm cho nàng
走了=đi rồi
爽了=thỏa mái rồi
要保密=phải giữ bí mật
要不要=có hay không
放过我=tha cho ta
再决定=sẽ quyết định
寸的=inch
给买=mua cho
一直也=suốt cả thời gian
交了=đã kết giao
撩骚=gạ gẫm/gạ tình/tán tỉnh
想射了=muốn bắn rồi
提她=nhắc đến nàng
对此=đối với điều này
性别的=giới tính
对我=đối ta
谈了男朋友=có bạn trai
长的=lớn lên
笑着=vừa cười
内卷=nội quyển/(thường được sử dụng để chỉ một tình trạng xã hội hoặc trong một tổ chức khi có sự cạnh tranh hoặc cố gắng đạt được thành tựu, nhưng kết quả là những nỗ lực đó không mang lại sự tiến bộ thực sự, mà chỉ tạo ra sự gia tăng cạnh tranh vô nghĩa)
合着=hợp lấy/thì ra như vậy/đóng lại/không ngờ như thế/thì ra
拥她=ôm nàng
父亲和=phụ thân cùng
应了=đáp lại
那也是=đó cũng là
的产生=sự xuất hiện/sự ra đời

.=//câu hiếm
看的极重=cực kỳ xem trọng
性格还行=tính cách vẫn tốt
片刻功夫=một khắc nỗ lực
吻她脖子时=hôn cổ nàng thời điểm
应不会=chắc chắn sẽ không
她想听的话=lời nàng muốn nghe