一万七千多=hơn một vạn bảy ngàn/hơn 17,000
一万二千余=hơn 12,000
一万五千余=hơn một vạn năm ngàn
一万五千多=hơn một vạn năm ngàn/hơn 15,000
一万六千多=hơn một vạn sáu ngàn/hơn 16,000
一个巴掌拍不响=một cây làm chẳng nên non/tại anh tại ả, tại cả hai bên
一九七一年=năm 1971
一九七七年=Năm 1977/năm 1977
一九七二年=năm 1972
一九九一年=năm 1991
一九九七年=năm 1997
一九九三年=năm 1993
一九九九年=năm 1999/năm một nghìn chín trăm chín mươi chín
一九九五年=năm 1995
一九九八年=năm 1998
一九九六年=năm 1996
一九九四年=năm 1994/năm một chín chín tư
一九五零年=năm 1905
一九八七年=năm 1987
一九八四年=1984
一九四八年=năm 1948
一亿一千多万=hơn 110 triệu
一亿七千万=170 triệu
一亿三千万=130 triệu
一亿两千万=một ức hai ngàn vạn/120 triệu
一亿二千万=120 triệu
一亿五千万=150 triệu
一亿零五百万=105 triệu
一动不如一静=một động không bằng một tĩnh
一千一万个=một ngàn một vạn
一千一百八十=1,180
一千三百多年=hơn 1,300 năm
一千二百两=một ngàn hai trăm lượng
一千二百多=hơn một ngàn hai trăm/hơn 1,200
一千二百多万=hơn 12 triệu
一千二百多年=hơn 1,200 năm
一千二百里=một ngàn hai trăm dặm/1,200 dặm
一千五百万=một ngàn năm trăm vạn/15 triệu
一千五百两=một ngàn năm trăm lượng
一千五百多=hơn một ngàn năm trăm/hơn 1,500
一千五百米=một ngàn năm trăm mét/1500m/1,500 mét
一千五百里=một ngàn năm trăm dặm/1500 dặm/1,500 dặm
一千八百多年=hơn 1,800 năm
一千六百五十=1650/1,650
一千四百多=hơn một ngàn bốn trăm/hơn 1,400
一千四百多年=hơn 1,400 năm
一千零一夜=Nghìn lẻ một đêm
一千零二十=1,020
一去不复返=một đi không trở lại/một đi không trở về
一夫一妻制=chế độ một vợ một chồng
一夫多妻制=chế độ đa thê/chế độ chồng chung/một chồng nhiều vợ/chồng chung
一失足成千古恨=nhất thất túc thành thiên cổ hận/một lần sảy chân để hận nghìn đời/một sai lầm để hận mãi mãi/lỡ một bước chân thành thiên cổ hận
一年之计在于春=một năm mới bắt đầu từ mùa xuân/kế hoạch một năm nằm trong mùa xuân/lập kế hoạch sớm là chìa khóa thành công
一时半会儿=một lát/một chốc
一朝天子一朝臣=một triều thiên tử một triều thần/vua nào triều thần nấy/một đời vua một đời thần
一棍子打死=giáng một gậy chết tươi/phủ định toàn bộ
一氧化二氮=thán khí
一浪高过一浪=sóng sau cao hơn sóng trước
一环扣一环=một vòng chụp một vòng
一百一十二=một trăm mười hai/112
一百一十二万=112 vạn
一百一十里=110 dặm
一百七十三=một trăm bảy mươi ba/173
一百七十亿=mười bảy tỷ
一百七十四=một trăm bảy mươi bốn/174
一百七十多=hơn một trăm bảy mươi/hơn 170
一百三十万两=một triệu ba trăm ngàn lượng
一百三十八=một trăm ba mươi tám/138
一百三十里=130 dặm
一百九十三=một trăm chín mươi ba/193
一百九十八=một trăm chín mươi tám/198
一百九十六=một trăm chín mươi sáu/196
一百二十七=một trăm hai mươi bảy/127
一百二十万=một trăm hai mươi vạn
一百二十万两=một trăm hai mươi vạn lượng/một triệu hai trăm ngàn lượng
一百二十五=một trăm hai mươi lăm/125
一百二十余=hơn một trăm hai mươi
一百二十八=một trăm hai mươi tám/128
一百二十八万=128 vạn
一百二十六=một trăm hai mươi sáu/126
一百二十分=một trăm hai mươi điểm/một trăm hai mươi phần trăm/120%
一百二十多=hơn một trăm hai mươi/hơn 120
一百二十多个=hơn một trăm hai mươi
一百二十年=một trăm hai mươi năm/120 năm
一百二十里=một trăm hai mươi dặm/120 dặm
一百五十三=một trăm năm mươi ba/153
一百五十两=một trăm năm mươi lượng
一百五十二=một trăm năm mươi hai/152
一百五十五=một trăm năm mươi lăm/155
一百五十余=hơn một trăm năm mươi
一百五十多年=hơn 150 năm
一百五十里=một trăm năm mươi dặm/150 dặm
一百八十七=một trăm tám mươi bảy/187
一百八十九=một trăm tám mươi chín/189
一百八十度=một trăm tám mươi độ/180°
一百八十里=180 dặm
一百六十两=một trăm sáu mươi lượng
一百六十五=165
一百六十六=166
一百六十四=một trăm sáu mươi bốn/164
一百六十多=hơn một trăm sáu mươi
一百六十多年=hơn 160 năm
一百四五十=140~150
一百四十两=một trăm bốn mươi lượng
一百四十九=149
一百四十四=144
一石激起千层浪=một viên đá dấy lên ngàn cơn sóng
一碗水端平=xử lý sự việc công bằng/nước trong một chén thẳng băng
一票否决权=một phiếu quyền phủ quyết
一言以蔽之=nói tóm lại/tóm lại
一锤子买卖=mua bán một lần/làm một cú
一问三不知=hỏi gì cũng không biết
一鼻孔出气=cùng một bè lũ/cùng một giuộc
七七四十九天=bảy bảy bốn mươi chín ngày
七七四十九日=bảy bảy bốn mươi chín ngày
七百五十四=bảy trăm năm mươi bốn/754
万事开头难=vạn sự khởi đầu nan
万变不离其宗=biến hóa bao nhiêu cũng không rời bản chất/trăm khoanh vẫn quanh một đốm/dù thay đổi đến muôn lần thì bản chất vẫn không thay đổi/con nhà tông không giống lông cũng giống cánh
丈二和尚摸不着头脑=như hòa thượng sờ mãi không thấy tóc/như tên Hòa thượng lùn 2 thước với tay sờ không đến đầu/bó tay cuốn chiếu(*)
三七二十一=mọi việc/sự/ba bảy hai mươi mốt
三下五除二=thuần thục/thành thạo/tam hạ ngũ trừ nhị
三亿七千万=370 triệu
三八妇女节=ngày quốc tế phụ nữ 8-3
三十多万两=hơn ba mươi vạn lượng
三千五百九十=3,590
三千八百米=3,800 mét
三千六百九十=3,690
三思而后行=nghĩ ba lần rồi mới làm/suy nghĩ hai lần/chó ba khoanh mới nằm/người ba năm mới nói
三步并作两步=ba chân bốn cẳng
三氧化二砷=arsenic trioxide/trioxide điôxít
三氧化二铁=sắt iii oxit/sắt trioxide
三百七十七万=377 vạn
三百七十六=ba trăm bảy mươi sáu/376
三百三十一=ba trăm ba mươi mốt/331
三百二十三=ba trăm hai mươi ba/323
三百二十四=ba trăm hai mươi bốn/324
三百五十六=ba trăm năm mươi sáu/356
三百五十里=350 dặm
三百八十万两=ba triệu tám trăm ngàn lượng
三百八十四=ba trăm tám mươi bốn/384
三百六十五=ba trăm sáu mươi lăm/365
三百六十五天=ba trăm sáu mươi lăm ngày/365 ngày
三百六十里=360 dặm
上有老下有小=trên có già dưới có trẻ
上梁不正下梁歪=thượng bất chính hạ tắc loạn
上气不接下气=thở không ra hơi/thở không được
不分青红皂白=không phân tốt xấu/vơ đũa cả nắm/không phân biệt trắng đen gì cả
不到长城非好汉=bất đáo Trường Thành phi hảo hán
不到黄河心不死=chưa tới phút cuối chưa thôi/quyết tâm cao/chưa đến Hoàng hà thì chưa cam lòng/dù có mất mát lớn, quyết tâm làm cho được ngoan cố/cà cuống chết, đít vẫn còn cay/chứng nào tật ấy
不可同日而语=không thể so sánh nổi/không thể so sánh với nhau/không thể vơ đũa cả nắm/không thể coi như nhau được/không thể giống nhau
不如意事常八九=việc không như ý thường xảy ra nhiều/không bằng ý sự thường bát cửu
不得已而为之=có chút bất đắc dĩ
不怕没柴烧=lo gì không có củi đốt
不打不相识=không đánh nhau thì không quen biết/không hòa thuận/đánh nhau xong mới thành bằng hữu
不敢越雷池一步=không dám vượt qua giới hạn
不明飞行物=bất minh phi hành vật
不显山不露水=không hiển sơn không lộ thủy
不登大雅之堂=không lịch sự/tao nhã/không thể bày ra/không thể phô ra/không thể trình ra/tục tằn
不看僧面看佛面=không nể mặt sư thì cũng nể mặt phật
不知为不知=không biết thì là không biết
不知其所以然=không biết giá trị
不知天高地厚=không biết trời cao đất rộng/không biết trời cao đất dầy/kiến thức nông cạn mà tự cao tự đại/không biết mức độ nghiêm trọng của sự tình/coi trời bằng vung/kiêu căng ngạo mạn
不管三七二十一=bất chấp tất cả/không cần biết đúng sai/không xét xanh đỏ đen trắng/không xét phải trái đúng sai/bất cần tất cả/bất cần mọi thứ/chẳng xét đúng sai ngọn ngành
不结盟运动=phong trào không liên kết/phong trào phi liên kết
不见棺材不掉泪=chưa thấy quan tài chưa đổ lệ
不费吹灰之力=không cần tốn nhiều sức/dễ dàng chóng vánh/dễ như bỡn/chẳng tốn công/chẳng tốn hơi sức nào/dễ như trở bàn tay/không phí nhiều sức/dễ như ăn bánh
不足为外人道=không thể để người khác biết/không phải cho người ngoài/chúng ta hãy giữ điều này giữa chúng ta
不问青红皂白=không biết phải quấy/không hỏi bừa bãi/không phân biệt đỏ xanh hay đen trắng
世界卫生组织=tổ chức y tế thế giới/Tổ chức Y tế Thế giới
世界贸易组织=Tổ chức Thương mại Thế giới/Tổ chức thương mại thế giới, WTO
东风压倒西风=gió đông thổi bạt gió tây/lực lượng cách mạng áp đảo thế lực phản cách mạng
两万五千里=hai mươi lăm ngàn dặm
两亿七千万=270 triệu
两千一百万=21 triệu
两千三百多年=hơn 2,300 năm
两千五百多年=hơn 2,500 năm
两百八十里=280 dặm
两眼一抹黑=hai mắt đen thui/hai mắt tối thui
个人所得税=thuế thu nhập cá nhân
中国人民解放军=quân giải phóng nhân dân Trung Quốc
中国同盟会=Trung Quốc đồng minh hội
中国工农红军=hồng quân công nông Trung Quốc/hồng quân
中央书记处=trung ương thư ký xử
中央政治局=cục chính trị trung ương/cục chính trị trung ương
中央电视台=đài truyền hình trung ương
义务兵役制=chế độ nghĩa vụ quân sự
九曲十八弯=chín quẹo mười tám rẽ/con queo uốn lượn/cong queo uốn lượn
九牛二虎之力=sức chín trâu hai hổ
九百九十七=chín trăm chín mươi bảy/997
九百九十九=chín trăm chín mươi chín/999
九百九十八=chín trăm chín mươi tám/998
九百二十二=chín trăm hai mươi hai/922
事后诸葛亮=mã hậu pháo/sau đó Gia Cát Lượng/một thiên tài trong việc nhìn lại/nhận thức muộn màng là 20-20
二一添作五=chia đồng ăn đủ/ngang nhau/đều nhau/chia đều hai bên/kẻ tám lạng, người nửa cân
二万五千里=hai mươi lăm ngàn dặm
二十一二岁=hai mươi hai mốt tuổi
二十七八岁=hai mươi bảy hai mươi tám tuổi
二十万左右=chừng hai mươi vạn
二十八九岁=hai mươi tám hai mươi chín tuổi
二十六七岁=hai mươi sáu hai mươi bảy tuổi
二十多分钟=hơn 20 phút
二千七百万=27 triệu
二桃杀三士=mượn đao giết người/nhị đào giết tam sĩ
二百一十三=hai trăm mười ba/213
二百七十多年=hơn 270 năm
二百三十一=hai trăm ba mươi mốt/231
二百三十五=hai trăm ba mươi lăm/235
二百三十八=hai trăm ba mươi tám/238
二百三十多=hơn 230
二百九十三=hai trăm chín mươi ba/293
二百九十九=hai trăm chín mươi chín/299
二百二十万=220 vạn
二百二十五=hai trăm hai mươi lăm/225
二百五十万两=hai triệu năm trăm ngàn lượng
二百五十米=250 mét
二百五十里=hai trăm năm mươi dặm/250 dặm
二百八十万两=hai triệu tám trăm ngàn lượng
二百六十四=hai trăm sáu mươi bốn/264
二百四十五=hai trăm bốn mươi lăm/245
二百四十里=240 dặm
二百零四万=204 vạn
二零一零年=năm 2010
二零零二年=năm 2002
二零零五年=năm 2005
互不侵犯条约=hiệp ước không xâm phạm lẫn nhau
五一劳动节=ngày Quốc tế Lao động/ngày 1 tháng 5
五万七千多=hơn 57,000
五亿八千万=580 triệu
五十万左右=khoảng 500 ngàn
五十步笑百步=chó chê mèo lắm lông/năm mươi bước cười một trăm bước/chuột chù chê khỉ rằng hôi, khỉ mới bảo rằng cả họ mày thơm/lươn ngắn chê trạch dài/người chạy năm mươi bước cười người chạy một trăm bước
五百八十五=năm trăm tám mươi lăm/585
五百六十万=560 vạn
五百四十万=năm trăm bốn mươi vạn/540 vạn
井水不犯河水=nước giếng không phạm nước sông/nước giếng không xâm phạm nước sông/không xâm phạm nhau/không động chạm nhau
京杭大运河=Kinh Hàng Đại Vận Hà/Grand Canal, 1800 km từ Bắc Kinh đến Hàng Châu, được xây dựng bắt đầu từ năm 486 trước Công nguyên
人力资源部=bộ tài nguyên nhân lực
人心不足蛇吞象=lòng tham không đáy
人心隔肚皮=lòng người khó dò
人有旦夕祸福=người có họa phúc sớm chiều
人民代表大会=đại hội đại biểu nhân dân
人民检察院=viện kiểm sát nhân dân
人民解放军=quân giải phóng nhân dân
人民陪审员=thẩm phán nhân dân/bồi thẩm nhân dân
人生七十古来稀=nhân sinh thất thập cổ lai hy
人生地不熟=chưa quen cuộc sống nơi đây
人生自古谁无死=nhân sinh tự cổ thùy vô tử
人至察则无徒=người quá xét ắt chẳng ai theo
人逢喜事精神爽=người gặp việc vui tinh thần sảng khoái/người gặp chuyện vui tinh thần sảng khoái
什什什什什=cái cái cái cái cái
他乡遇故知=tha hương ngộ cố tri
任重而道远=gánh nặng đường xa/trọng trách thì nặng mà đường thì xa
伊万诺维奇=Ivanovic
伊尔库茨克=Irkutsk
伊斯坦布尔=Istanbul/Istanbul, Thổ Nhĩ Kỳ
伏尔加格勒=Volgograd
伸手不见五指=đưa tay không thấy được năm ngón
何乐而不为=cớ sao mà không làm/sao không tự nguyện mà làm
你一言我一语=ngươi một lời ta một câu/bạn nói với tôi một từ/anh nói một lời tôi
依样画葫芦=y dạng họa hồ lô/y dạng họa hồ lô (*đồ lên vật có sẵn mà ra hình vẽ)
依葫芦画瓢=xem mèo vẽ hổ
便携式电脑=máy tính xách tay
俄克拉荷马=Nga Khắc Lạp Hà Mã
俗话说得好=có câu nói rất hay
修行在个人=tu hành tại cá nhân
候风地动仪=máy đo địa chấn
做一天和尚撞一天钟=một ngày làm hòa thượng đánh chuông đủ một ngày/một ngày làm hòa thượng/đánh chuông đủ một ngày/sống ngày nào hay ngày ấy/qua ngày đoạn tháng/đến đâu hay đến đó
先下手为强=tiên hạ thủ vi cường/ra tay trước thì chiếm được lợi thế
先天下之忧而忧=lo trước cái lo của thiên hạ
克拉斯诺亚尔斯克=Krasnoyars/Krasnoyarsk
兔子不吃窝边草=thỏ không ăn cỏ gần hang
全国运动会=đại hội thể dục thể thao toàn quốc/Đại hội Thể thao Quốc gia/Đại hội thể dục thể thao toàn quốc
八万四千里=tám mươi bốn ngàn dặm
八九不离十=tám chín phần mười/mười phần chắc/mười phần được tám, chín/hầu như/gần như/gần đúng/tám chín phần
八八六十四=tám tám sáu tư
八千八百万=88 triệu
八字没一撇=làm không chu đáo/chưa đâu vào đâu cả/không đến nơi đến chốn/làm không cẩn thận/làm việc ẩu tả/một nhát đến tai, hai nhát đến gáy
八百零七万=807 vạn
八竿子打不着=bắn đại bác cũng không tới/cực kỳ xa/không liên quan/không quen biết/không có quan hệ thân thích/quăng tám sào cũng không tới/tám sào cũng không tới/chẳng chút liên quan/đại bác bắn cũng không tới
公用电话亭=buồng điện thoại công cộng
公说公有理=ông nói ông có lý
六七十年代=những năm 60-70/thập niên sáu mươi bảy mươi
六九五十四=lục cửu ngũ thập tứ
六亿五千万=650 triệu
六百三十三=633
六百三十四=sáu trăm ba mươi bốn/634
六百五十二=sáu trăm năm mươi hai/652
六百五十米=650 mét
关塔那摩湾=Vịnh Guantanamo
兵败如山倒=binh bại như núi đổ/binh bại như núi đổ
冒天下之大不韪=chọc cho thiên hạ khiển trách/coi trời bằng vung
军国主义者=người theo chủ nghĩa quân phiệt
冰冻三尺非一日之寒=băng dày ba thước không phải do chỉ một ngày lạnh
决胜千里之外=quyết thắng ngoài ngàn dặm
准噶尔盆地=bồn địa Junggar
几十分之一=một phần mấy chục
凯恩斯主义=chủ nghĩa Keynes
出淤泥而不染=trong bùn mà chẳng hôi tanh mùi bùn/gần bùn mà chẳng hôi tanh mùi bùn/ra khỏi bùn mà không bị nhiễm bẩn/Gần bùn mà chẳng hôi tanh mùi bùn
分子生物学=phân tử sinh vật học/sinh học phân tử
切尔诺贝利=Chernobyl
刑事诉讼法=luật tố tụng hình sự/Bộ luật Tố tụng Hình sự/tố tụng hình sự
初生之犊不畏虎=nghé mới sinh không sợ cọp
初生牛犊不怕虎=nghé con mới đẻ không sợ cọp/con bê mới sinh không sợ hổ/Nghé con không biết sợ cọp
前怕狼后怕虎=đắn đo do dự/trước sợ sói sau sợ hổ
功到自然成=bỏ công sẽ có thành quả/muốn thu được kết quả, phải tốn công/có công mài sắt có ngày nên kim/có chí thì nên
加利福尼亚州=bang California
加拉帕戈斯=Galápagos
劳动生产率=năng suất lao động/năng suất làm việc
勿以恶小而为之=chớ thấy việc ác nhỏ mà làm
化干戈为玉帛=biến chiến tranh thành tơ lụa
化腐朽为神奇=hóa mục nát thành thần kỳ
北京电影学院=Học viện điện ảnh Bắc Kinh/Học viện Điện ảnh Bắc Kinh
十一点左右=khoảng mười một giờ
十万八千里=cách xa vạn dặm/xa tít tắp/mười vạn tám ngàn dặm
十万分之一=một phần một trăm ngàn
十二万四千=124,000
十八般兵器=thập bát ban binh khí/mười tám món binh khí
十八般武艺=thập bát ban võ nghệ/các kiểu kỹ năng/các ngành nghề
千万分之一=một phần ngàn vạn
千叮咛万嘱咐=dặn đi dặn lại
千里送鹅毛=của ít lòng nhiều/ngàn dặm gửi lông ngỗng/lông ngỗng gửi từ xa/một món quà lặt vặt với một ý nghĩ nặng nề đằng sau nó
卖狗皮膏药=bán cao da chó/quảng cáo bịp
卡拉什尼科夫=Kalashnikov
卡斯蒂利亚=Castilla/Castilla, vương quốc Tây Ban Nha cũ
印第安纳州=bang Indiana/Indiana, tiểu bang Hoa Kỳ
印第安纳波利斯=Indianapolis/Indianapolis, Indiana
历史唯物主义=chủ nghĩa duy vật lịch sử
原子反应堆=lò phản ứng nguyên tử
原教旨主义=chủ nghĩa cơ yếu/chủ nghĩa cơ bản
反其道而行之=phương pháp trái ngược/cách trái ngược/cách làm trái ngược
发展中国家=quốc gia đang phát triển/nước đang phát triển
古生物学家=nhà cổ sinh vật học
可望而不可即=khó thể thực hiện/khó với tới/muốn gần mà không gần được/nhìn thấy nhưng không với tới được/có thể thực hiện được nhưng thực tế rất khó làm được/nhìn thấy nhưng không với được
司马昭之心=lòng dạ Tư Mã Chiêu/tâm tư Mã Chiêu
吃一堑长一智=ngã một lần khôn hơn một chút/ngã một lần/khôn hơn một chút/ngã một lần khôn ra thêm
吃不了兜着走=chịu không nổi
吃人不吐骨头=ăn người không nhả xương/ăn tươi nuốt sống
吃力不讨好=tốn công mà không có kết quả
吃硬不吃软=rượu mời không uống, muốn uống rượu phạt/ăn mềm mà không ăn cứng/thích cứng không thích mềm
吃软不吃硬=ăn mềm không ăn cứng/thích mềm không thích cứng
合成洗涤剂=bột giặt tổng hợp
吉人自有天相=ở hiền gặp lành/người Cát có thiên tướng riêng/Trời giúp người xứng đáng
吉尔吉斯斯坦=Kyrgyzstan/Kyrgystan/Kyrghyzstan
名不见经传=không có danh tiếng gì
名师出高徒=danh sư xuất cao đồ
后天下之乐而乐=vui sau cái vui của thiên hạ
后浪推前浪=sóng sau đè sóng trước/thúc đẩy tiến lên/lớp sóng sao đẩy lớp sóng trước/tre già măng mọc
君主立宪制=chế độ quân chủ lập hiến
吹胡子瞪眼=phùng mang trợn mắt/thổi râu trừng mắt/bốc khói
哈佛商学院=trường Kinh doanh Harvard/Trường Kinh doanh Harvard
哈利法克斯=Halifax
哑巴吃黄连=người câm ăn hoàng liên/có nỗi khổ không thể nói ra
哥德巴赫猜想=giả thuyết Goldbach/giả thuyết Goldbach trong lý thuyết số
唯物主义者=người chủ nghĩa duy vật
唯物辩证法=phép biện chứng duy vật
喀斯特地貌=địa mạo karst/địa hình karst/dạng địa hình karst
喜马拉雅山脉=dãy Himalaya/Himalayas
四两拨千斤=tứ lạng bạt thiên cân
四亿五千万=450 triệu
四十七八岁=bốn mươi bảy bốn mươi tám
四千零三十=4,030
四海之内皆兄弟=tứ hải giai huynh đệ/trong bốn biển đều là huynh đệ/Anh em bốn biển một nhà
四百三十万=bốn trăm ba mươi vạn/430 vạn
四百六十七=bốn trăm sáu mươi bảy/467
因斯布鲁克=Innsbruck/Innsbruck, thành phố ở Áo
国家博物馆=nhà bảo tàng quốc gia
国际刑警组织=tổ chức cảnh sát quốc tế/interpol/Interpol
国际妇女节=ngày quốc tế phụ nữ
国际日期变更线=đường phân chia ngày quốc tế
国际货币基金组织=Quỹ Tiền tệ Quốc tế/Quỹ tiền tệ quốc tế
土地革命战争=chiến tranh cách mạng ruộng đất
地理信息系统=hệ thống thông tin địa lý
地缘政治学=địa chính trị học/địa chính trị
坐山观虎斗=tọa sơn quan hổ đấu/nghêu cò tranh nhau, ngư ông đắc lợi/toạ sơn quan hổ đấu
埃尔南德斯=Hernandez/Hernández
埃菲尔铁塔=tháp Eiffel
塞萨洛尼基=Thessaloniki
士为知己者死=kẻ sĩ chết vì tri kỷ/sĩ vi tri kỷ giả tử (*)
多一事不如少一事=nhiều một chuyện không bằng bớt một chuyện
多行不义必自毙=ác giả ác báo/trời có mắt
大幅度提高=đề cao mạnh/tăng lên rất cao
大珠小珠落玉盘=ngọc trai rơi trên mâm ngọc
大男子主义=đại nam tử chủ nghĩa/chủ nghĩa đàn ông lớn/chủ nghĩa sô vanh nam
大老爷们儿=đại lão gia
大英博物馆=bảo tàng Anh/Bảo tàng Anh/Viện bảo tàng Anh
大陆性气候=khí hậu lục địa
大鱼吃小鱼=cá lớn nuốt cá bé
天字第一号=cao nhất/lớn nhất/mạnh nhất/số một
天安门广场=quảng trường Thiên An Môn
天无绝人之路=trời không tuyệt đường người
天时地利人和=thiên thời địa lợi nhân hoà
天有不测风云=trời có gió mưa khó đoán/làm sao tính được số trời
太岁头上动土=động thủ trên đầu thái tuế/động thổ làm nhà xúc phạm sao thái tuế/xúc phạm người có quyền thế lớn
奥斯曼帝国=đế quốc Ottoman/Đế chế Ottoman
好汉做事好汉当=dám làm dám chịu/hảo hán dũng cảm nhận trách nhiệm về mình
如入无人之境=như vào chỗ không người
季米特洛夫=Dimitrov
宁可信其有=thà rằng tin là có/thà tin rằng nó có
安德烈耶夫=Andreyev
安达卢西亚=Andalucía
官僚资本主义=chủ nghĩa tư bản quan liêu
客观唯心主义=chủ nghĩa duy tâm khách quan/duy tâm khách quan
家丑不可外扬=chuyện xấu trong nhà không thể truyền ra ngoài
宾夕法尼亚州=bang Pennsylvania/Pennsylvania
富贵不能淫=không bị tiền bạc cám dỗ/phú quý bất năng dâm/giàu sang không đam mê
对乙酰氨基酚=Paracetamol/acetaminophen
射人先射马=bắt người trước hết phải bắt ngựa/xạ nhân tiên xạ mã/bắn người phải bắn ngựa trước
小不忍则乱大谋=nhỏ không nhịn sẽ loạn mưu lớn/nhỏ không đành lòng thì loạn đại mưu/Việc nhỏ không nhịn ắt hỏng việc lớn
小儿麻痹症=bệnh bại liệt trẻ em/bệnh bại liệt
小巫见大巫=tiểu vu gặp đại vu/gặp sư phụ/phù thuỷ nhỏ gặp phù thuỷ lớn/người có năng lực kém gặp người có năng lực tốt/tiểu vu kiến đại vu/như gặp sư phụ
尼古拉耶夫=Mykolaiv
山雨欲来风满楼=gió thổi báo giông bão sắp đến/gió thổi mưa giông trước cơn bão/gió thổi báo giông tố sắp đến/cơn giông trước lúc mưa nguồn/gió nổi lên trong lầu trước cơn mưa
山高皇帝远=núi cao hoàng đế xa/hoàng đế núi cao xa xôi
工农兵学员=học viên công nông binh
工欲善其事=muốn làm chuyện gì/làm việc tốt/thợ muốn giỏi việc/trước tiên phải làm công cụ sắc bén. ý nói muốn làm tốt một việc/cần phải có sự chuẩn bị tốt.
巧妇难为无米之炊=không bột đố gột nên hồ
巴塔哥尼亚=Patagonia
巴黎圣母院=Nhà thờ Đức Bà Paris/Nhà thờ Đức Bà
巾帼不让须眉=bậc cân quắc không thua đấng mày râu/bậc cân quắc(phụ nữ) không thua đấng mày râu/mày liễu không nhường mày râu
布拉戈维申斯克=Blagoveshchensk
布里斯托尔=Bristol/thành phố cảng Bristol ở tây nam nước Anh
帕洛阿尔托=Palo Alto
常务委员会=uỷ viên thường vụ
平地一声雷=sấm dậy đất bằng/đất bằng nổi sóng
平行四边形=hình bình hành
幼吾幼以及人之幼=ấu ngô ấu/dĩ cập nhân chi ấu
广播电视局=đài phát thanh truyền hình
庐山真面目=bộ mặt thật/lư sơn chân diện mục/bộ mặt thật
库兹涅佐夫=Kuznetsov
弗吉尼亚州=bang Virginia/Virginia, tiểu bang Hoa Kỳ
弹指一挥间=một cái búng tay
强中更有强中手=kẻ mạnh càng có kẻ mạnh hơn
强中自有强中手=cường trung tự hữu cường trung thủ
强将手下无弱兵=dưới tay tướng mạnh không có binh hèn
强扭的瓜不甜=dưa hái xanh không ngọt
当一天和尚撞一天钟=sống ngày nào hay ngày ấy/làm sư ngày nào, gõ mõ ngày ấy/sống hôm nay không biết đến ngày mai
得饶人处且饶人=tìm chỗ khoan dung mà độ lượng/khuyên người phải có lòng khoan dung/tha cho người được nên tha
德克萨斯州=bang Texas/Texas/tiểu bang Texas
德米凯利斯=Demichelis
德谟克利特=Democritus
心有余而力不足=có lòng không đủ lực
心有灵犀一点通=tâm hữu linh tê nhất điểm thông/tâm ý tương thông
心脏起搏器=máy tạo nhịp tim
必先利其器=tất phải chuẩn bị trước/trước tiên phải lợi dụng/thợ muốn giỏi việc/trước tiên phải làm công cụ sắc bén. ý nói muốn làm tốt một việc/cần phải có sự chuẩn bị tốt.
快刀斩乱麻=giải quyết dứt khoát/dao sắc chặt đay rối/giải quyết nhanh chóng/xong cái một/chặt phăng
怒从心头起=trong lòng tức giận
急急如律令=cấp cấp như luật lệnh
恭敬不如从命=cung kính không bằng tuân mệnh
恶人先告状=ăn cướp còn la làng/ác nhân cáo trạng trước/bên có tội nộp đơn kiện
恶向胆边生=càng ngày càng bạo
患难见真情=hoạn nạn thấy chân tình/tình cảm thực sự được nhìn thấy trong thời gian khó khăn
情人眼里出西施=trong mắt người tình biến thành Tây Thi
惊天地泣鬼神=kinh thiên địa khiếp quỷ thần
惶惶不可终日=hoảng sợ không chịu nổi một ngày/hoảng loạn không thể sống sót
慷他人之慨=của người phúc ta
戈尔巴乔夫=Gorbachev
手扶拖拉机=xe đẩy
打开天窗说亮话=nói trắng ra/nói toạc móng heo/nói thẳng ra
打破沙锅问到底=truy hỏi kỹ càng sự việc
打破砂锅问到底=đập vỡ nồi đất hỏi đến cùng/tìm cho ra ngọn nguồn sự việc/phá vỡ nồi để hỏi đến cùng/truy hỏi kỹ càng sự việc/đào tận gốc, trốc tận rễ
打肿脸充胖子=mạo xưng là trang hảo hán/phùng má giả làm người mập/việc quá khả năng
打蛇打七寸=đánh rắn đánh bảy tấc/đánh rắn đánh giập đầu
托特纳姆热刺=Tottenham Hotspur
披头士乐队=The Beatles
抬头不见低头见=ngẩng đầu không thấy cúi đầu thấy/ngẩng đầu không thấy cúi đầu gặp
拆东墙补西墙=bóc tường đông bổ tường tây/phá hủy bức tường phía đông để bổ sung cho bức tường phía tây/Cướp Peter để trả cho Paul
拉大旗作虎皮=mượn oai hùm
拒人于千里之外=tránh xa người ngàn dặm
拧成一股绳=bện thành một sợi dây thừng
挂羊头卖狗肉=treo đầu dê bán thịt chó/treo dê bán chó
挟天子以令诸侯=hiệp thiên tử dĩ lệnh chư hầu
捏了一把汗=lau một vệt mồ hôi
损人不利己=hại người không lợi mình/tổn nhân bất lợi kỷ
换汤不换药=bình mới rượu cũ/đổi thang mà không đổi thuốc/thay đổi bên ngoài
摩尔曼斯克=Murmansk
摩根士丹利=Morgan Stanley
摸不着头脑=không nghĩ ra/bó tay/không tìm được manh mối
摸着石头过河=mò đá quá sông
撒哈拉沙漠=Sa mạc Sahara
擒贼先擒王=bắt giặc trước bắt vua/bắt giặc phải bắt vua trước
攘外必先安内=diệt bên ngoài thì trước hết phải yên bên trong
放之四海而皆准=đúng mọi nơi mọi lúc/dùng được mọi nơi/thích hợp mọi nơi
放射性元素=nguyên tố phóng xạ/nguyên tố có tính phóng xạ
放长线钓大鱼=thả dây dài câu cá lớn/đặt dây dài câu cá lớn/dùng dây câu dài để câu được con cá lớn/một kế hoạch dài hạn cho lợi nhuận lớn
政治协商会议=hội nghị hiệp thương chính trị
政治经济学=môn kinh tế chính trị/kinh tế chính trị học
故意杀人罪=tội cố ý giết người
教育工作者=người làm giáo dục/nhà giáo dục
敢怒不敢言=giận mà không dám nói gì
敢怒而不敢言=bực mình chẳng dám nói ra/tức giận nhưng không dám nói/giận mà không dám nói
敬酒不吃吃罚酒=rượu mời không uống chỉ thích uống rượu phạt
敬鬼神而远之=kính quỷ thần nhi viễn chi
数以十万计=số lượng hàng trăm ngàn
数以百万计=đến trăm vạn mà tính/con số hàng triệu
数百平方米=mấy trăm mét vuông
文化大革命=Đại Cách mạng Văn hóa
斯大林格勒=Stalingrad
斯洛文尼亚=Slovenia
斯特拉迪瓦里=Stradivarius
斯科菲尔德=Scofield
新官上任三把火=quan mới đến đốt ba đống lửa
新文化运动=phong trào văn hoá mới
新民主主义革命=cách mạng dân chủ mới
方程式赛车=xe đua công thức
无功不受禄=vô công bất thụ lộc
无可无不可=sao cũng được/thế nào cũng được/quan tám cũng ừ, quan tư cũng gật/ba phải
无巧不成书=vô xảo bất thành thư
无心插柳柳成荫=vô tâm cắm liễu liễu xanh um
无所不用其极=dùng bất cứ thủ đoạn nào/bằng mọi cách/giở mọi mánh khoé
无政府主义=chủ nghĩa vô chính phủ/vô chính phủ/chỉ hành vi, tư tưởng chống lại tổ chức trong đội ngũ cách mạng
无毒不丈夫=vô độc bất trượng phu
无用武之地=không có đất dụng võ/vô dụng vũ chi địa
无立锥之地=không mảnh đất cắm dùi/không cục đất chọi chim
无风不起浪=không có lửa làm sao có khói/không có gió làm sao có sóng
日久见人心=lâu ngày mới rõ lòng người
旧石器时代=thời đại đồ đá
时势造英雄=thời thế tạo anh hùng
春蚕到死丝方尽=xuân tàm đáo tử ti phương tẫn
春风吹又生=gió xuân thổi lại mọc/qua gió xuân lại mọc
普莉兹姆利巴=Prismriver
更上一层楼=nâng cao một bước/lại lên thêm một tầng lầu nữa/cao hơn một tầng lầu
最大公约数=ước số chung lớn nhất
有其父必有其子=cha nào con nấy/con nhà tông không giống lông cũng giống cánh
有奶便是娘=ngã theo chiều gió/tham phú phụ bần
有志者事竟成=có chí ắt làm nên/nếu có chí nhất định thành/người có chí ắt thành công/có công mài sắt, có ngày nên kim
有情人终成眷属=người có tình cuối cùng cũng thành thân thuộc/có tình nhân cuối cùng cũng thành quyến thuộc/tình yêu sẽ tìm ra cách
有百害而无一利=có trăm hại mà không một lợi/không có lợi thế gì
有眼不识泰山=có mắt mà không thấy Thái Sơn/có mắt như mù/có mắt mà không nhìn thấy núi Thái Sơn/có mắt mà không biết bậc thầy/có mắt mà không thấy núi thái sơn
有过之无不及=chỉ có hơn chứ không kém/còn nhiều hơn
有过之而无不及=chỉ có hơn chứ không kém/chỉ có hơn chớ không kém/chỉ có hơn mà không thua
有钱能使鬼推磨=có tiền mua tiên cũng được/có tiền có thể làm cho ma mài giũa/với tiền, bạn có thể làm bất cứ điều gì bạn thích
有鼻子有眼儿=nghe cứ như thật/có căn cứ hẳn hoi/có mắt có mũi hẳn hoi
朱门酒肉臭=cửa son rượu thịt thối/chu môn rượu thịt thối
朽木不可雕=gỗ mục không điêu khắc được
杀人不眨眼=giết người không chớp mắt/người tàn nhẫn độc ác
杀人不见血=giết người không thấy máu/giết người không gươm
杀鸡焉用牛刀=giết gà sao lại dùng đao mổ trâu
李自成起义=cuộc khởi nghĩa ' Lý Tự Thành'/cuộc khởi nghĩa 'Lý Tự Thành'
杜塞尔多夫=Düsseldorf
条条大路通罗马=mọi con đường đều dẫn đến thành Rome/tận những con đường lớn đi qua Rome/mọi con đường đều dẫn tới Rome
来而不往非礼也=đến mà không trả lễ thì không hay
杯酒释兵权=dùng rượu tước binh quyền
松下幸之助=Matsushita Kōnosuke
枪打出头鸟=súng bắn chim đầu đàn/kẻ nổi tiếng thì dễ bị ghen ghét
柳暗花明又一村=liễu ám hoa minh hựu nhất thôn
柴油发动机=động cơ diesel
柴米油盐酱醋茶=củi gạo dầu muối tương giấm trà/củi gạo dầu muối tương dấm trà/nhu cầu thiết yếu hàng ngày của cuộc sống
标准大气压=khí áp chuẩn
树倒猢狲散=tan đàn xẻ nghé/cây đổ bầy khỉ tan/xẻ đàn tan nghé/thầy bại thì tớ cụp đuôi
树欲静而风不止=cây muốn lặng mà gió chẳng ngừng/cây muốn lặng mà gió chẳng muốn ngừng
格勒诺布尔=Grenoble
格林纳丁斯=Grenadines
桃李满天下=học trò khắp thiên hạ
植物性神经=thần kinh thực vật
横挑鼻子竖挑眼=bắt bẻ/vặn vẹo/bới lông tìm vết
横眉冷对千夫指=quắc mắt coi khinh nghìn lực sĩ
欧罗巴人种=người da trắng/người Ơ-Rốp
欲速则不达=dục tốc bất đạt/dục tốc tắc bất đạt/nóng vội thì không thành công/muốn nhanh việc, chẳng thành/dục tốc thì bất đạt
正则表达式=biểu thức chính quy
此一时彼一时=trước khác nay khác
此地无银三百两=giấu đầu lòi đuôi/lạy ông tôi ở bụi này/ở đây không có ba trăm lạng bạc
武装到牙齿=trang bị đến tận răng
死无葬身之地=chết không có chỗ chôn
死猪不怕开水烫=lợn chết không sợ bỏng nước sôi
死马当活马医=lấy ngựa chết làm ngựa sống chữa
比较语言学=ngôn ngữ học so sánh
毕其功于一役=một lần là xong/giải quyết dứt điểm
毛泽东思想=tư tưởng Mao Trạch Đông
民主集中制=chế độ tập trung dân chủ/nguyên tắc tập trung dân chủ
民以食为天=dân dĩ thực vi thiên
水火不相容=xung khắc như nước với lửa
水至清则无鱼=nước quá trong ắt không có cá/người quá xét nét hẳn chẳng có ai chơi
河水不犯井水=nước sông không phạm nước giếng/Hãy để tâm đến việc kinh doanh của riêng bạn.
治标不治本=trị ngọn không trị gốc
法不传六耳=phương pháp không được truyền qua tai
法兰西共和国=Cộng hoà Pháp
法属波利尼西亚=Polynesia thuộc Pháp
法西斯主义=chủ nghĩa phát xít
波粒二象性=lưỡng tính sóng-hạt
波鲁萨利诺=Borsalino
活字印刷术=in chữ rời thuật
流氓无产者=vô sản lưu manh
浪子回头金不换=con hư biết nghĩ lại quý hơn vàng/biết nhận lỗi là tốt rồi
海军陆战队=lính thủy đánh bộ/thủy quân lục chiến/Lính thủy đánh bộ
海洋性气候=khí hậu biển
海阔凭鱼跃=biển rộng mặc cá bơi/biển rộng mặc cá nhảy
润物细无声=nhuận vật tế vô thanh/nhuận vật nhỏ không tiếng động/tự nhiên/âm thầm mà ảnh hưởng tới sự vật
深一脚浅一脚=chậm rãi từng bước/thâm nhất cước thiển nhất cước/thất thiểu/một bước sâu một bước nông
温故而知新=ôn cố mà tri tân
滑天下之大稽=làm trò cười cho thiên hạ
激光打印机=máy in laser
火焰喷射器=súng phun lửa/máy phun lửa
热锅上的蚂蚁=kiến bò trên chảo nóng/con kiến trên chảo nóng
照葫芦画瓢=trông bầu vẽ gáo/"nhìn quả bầu mà vẽ ra chiếc gáo"/nhìn quả bầu mà vẽ ra chiếc gáo
燕雀安知鸿鹄之志=yến tước sao biết chí hồng hộc
牛头不对马嘴=ông nói gà bà nói vịt/trống đánh xuôi, kèn thổi ngược/râu ông nọ cắm cằm bà kia/nồi vuông úp vung tròn
物以稀为贵=vật hiếm thì quý
牵一发而动全身=rút dây động rừng/một cái tác động đến nhiều cái/rút giây động rừng/kéo một sợi tóc động đến cả người
特洛伊木马=kế ngựa gỗ/ngựa gỗ thành Tơ-roa
狗咬吕洞宾=không phân biệt tốt xấu/chó cắn Lã Động Tân/không biết người có lòng tốt
独木不成林=một cây làm chẳng nên non/một con chim én không làm nên mùa xuân
狮子大张口=sư tử há mồm
狮身人面像=tượng nhân sư
理想主义者=người chủ nghĩa lý tưởng
瑞星杀毒软件=Rising Antivirus
瑞雪兆丰年=tuyết lành báo hiệu năm bội thu/thụy tuyết triệu phong niên
生活必需品=nhu cầu thiết yếu hàng ngày/nhu yếu phẩm hàng ngày/nhu cầu thiết yếu của cuộc sống
生米煮成熟饭=gạo nấu thành cơm/gạo đã thành cơm/ván đã đóng thuyền/gạo sống nấu thành cơm chín
电子显微镜=kính hiển vi điện tử
电子游戏机=trò chơi điện tử
电子计算机=máy vi tính/máy tính điện tử
电影摄影机=máy quay phim/máy chụp hình
电视发射塔=cột truyền hình/tháp truyền hình
男儿有泪不轻弹=nước mắt nam nhi không dễ chảy/nam nhi có nước mắt không nhẹ/Đàn ông đích thực không dễ khóc
男女授受不亲=nam nữ thụ thụ bất thân
留得青山在=lưu được núi xanh
疾风知劲草=gió mạnh mới biết cỏ cứng/gian nan mới biết người có khí tiết
病急乱投医=cái gì cũng có thể thử khi tuyệt vọng
痛打落水狗=đánh chó mù đường/đánh kẻ sa cơ
癞蛤蟆想吃天鹅肉=cóc ghẻ mà đòi ăn thịt thiên nga/cóc mà đòi ăn thịt thiên nga/ăn mày đòi ăn xôi gấc/ăn chực đòi bánh chưng
白首为功名=bạc đầu vì công danh/nỗ lực phấn đấu lâu dài
百万分之一=một phần một triệu
百分之一百=một trăm phần trăm
百分之一百二十=120%/một trăm hai mươi phần trăm
百分之七八十=bảy tám mươi phần trăm/70-80%
百分之七十=bảy mươi phần trăm/70%
百分之七十五=75%/bảy mươi lăm phần trăm
百分之三十=ba mươi phần trăm/30%
百分之三十五=35%/ba mươi lăm phần trăm
百分之三十六=36%/ba mươi sáu phần trăm
百分之三四十=30-40%
百分之九十=chín mươi phần trăm/90%
百分之九十九=chín mươi chín phần trăm/99%
百分之九十五=95%/chín mươi lăm phần trăm
百分之九十八=chín mươi tám phần trăm/98%
百分之二三=2-3% /2-3%
百分之二十=hai mươi phần trăm/20%
百分之二十九=29%/hai mươi chín phần trăm
百分之二十二=22%
百分之二十五=hai mươi lăm phần trăm/25%
百分之二十几=hai mươi mấy phần trăm
百分之二百=hai trăm phần trăm/200%
百分之五十=năm mươi phần trăm/50%
百分之五十一=51%/năm mươi mốt phần trăm
百分之八九十=8-9-10%/8, 9, 10%
百分之八十=tám mươi phần trăm/80%
百分之八十五=85%/tám mươi lăm phần trăm
百分之六七=6-7% /6-7%
百分之六十=sáu mươi phần trăm/60%
百分之六十五=65%/sáu mươi lăm phần trăm
百分之六十六=66%/sáu mươi sáu phần trăm
百分之几十=mấy chục phần trăm
百分之十一=11%/mười một phần trăm
百分之十七=17%/mười bảy phần trăm
百分之十三=13%/mười ba phần trăm
百分之十九=19%/mười chín phần trăm
百分之十二=12%/mười hai phần trăm
百分之十五=mười lăm phần trăm/15%
百分之十八=18%/mười tám phần trăm
百分之十六=16%/mười sáu phần trăm
百分之十四=mười bốn phần trăm/14%
百分之四十=bốn mươi phần trăm/40%
百分之四十九=49%/bốn mươi chín phần trăm
百分之四十八=bốn mươi tám phần trăm/48%
百分之四十四=44%/bốn mươi bốn phần trăm
百尺竿头更进一步=cố gắng tiến lên một bước/luôn cố gắng cho giỏi hơn
百思不得其解=trăm mối vẫn không có cách giải/bách tư bất đắc kỳ giải/nghĩ mãi mà không ra
百闻不如一见=trăm nghe không bằng một thấy/trăm nghe không bằng gặp mặt
皮笑肉不笑=ngoài cười nhưng trong không cười/vẻ bên ngoài thì cười nhưng trong lòng không cười
真人不露相=chân nhân bất lộ tướng
真金不怕火炼=vàng thật không sợ lửa/cây ngay không sợ chết đứng
眼不见为净=nhắm mắt làm ngơ
知人知面不知心=biết người biết mặt không biết lòng/tri nhân tri diện bất tri tâm/biết người biết mặt nhưng không biết lòng
知其所以然=biết nó vì sao
知子莫若父=biết con không khác ngoài cha
知耻而后勇=biết thẹn mà dũng mãnh/biết xấu hổ rồi mới dũng cảm
破罐子破摔=vò đã mẻ không sợ rơi
破题儿第一遭=lần đầu/lần đầu tiên/lần thứ nhất
碰一鼻子灰=mũi dính đầy tro/bị một vố/bị chửi mắng té tát
碳水化合物=Cacbohydrat/đường/chất đường
磁悬浮列车=tàu đệm từ trường
磨刀不误砍柴工=ngồi mài đao cũng không làm mất kỹ thuật đốn củi/ngồi mài đao cũng không làm mất kỹ thuật đốn củi(*)
社会契约论=Khế ước xã hội
社会民主主义=chủ nghĩa dân chủ xã hội
神不知鬼不觉=thần không biết quỷ không hay
神农本草经=Thần Nông Bản Thảo Kinh
神龙见首不见尾=thần long kiến thủ bất kiến vĩ/thần long thấy đầu mà không thấy đuôi
秋风扫落叶=gió thu quét lá vàng/thế mạnh như chẻ tre
科学共产主义=chủ nghĩa Cộng Sản khoa học
科罗拉多州=bang Colorado/Colorado
科罗曼德尔=Coromandel
稳坐钓鱼台=Lã Vọng buông cần
穷人的孩子早当家=trẻ nhà nghèo sớm biết chuyện/trẻ em nghèo sớm là một gia đình
空口说白话=chỉ nói mà không làm/nói suông chứ không làm
立于不败之地=đứng ở thế bất bại
竹筒倒豆子=triệt để/đến nơi đến chốn
笔记型电脑=notebook
符拉迪沃斯托克=Vladivostok
第一次世界大战=đại chiến thế giới thứ nhất/chiến tranh thế giới lần thứ nhất/đệ nhất thế chiến
第一次鸦片战争=chiến tranh nha phiến lần thứ nhất
第七十一回=hồi thứ bảy mươi mốt
第七十三回=hồi thứ bảy mươi ba
第七十二回=hồi thứ bảy mươi hai
第三十二代=đời thứ ba mươi hai
第二十一回=hồi 21
第二十一次=lần thứ hai mươi mốt
第二十三回=hồi 23
第二十二位=người thứ hai mươi hai
第二十二回=hồi 22
第二十二次=lần thứ hai mươi hai
第二十四卷=quyển thứ hai mươi bốn
第二十四集=tập thứ 24
第二次世界大战=đại chiến thế giới lần hai/thế chiến thứ hai
第五十一回=hồi thứ năm mươi mốt
第五十七回=hồi thứ năm mươi bảy
第五十三回=hồi thứ năm mươi ba
第五十九回=hồi thứ năm mươi chín
第五十二回=hồi thứ năm mươi hai
第五十五回=hồi thứ năm mươi lăm
第五十八回=hồi thứ năm mươi tám
第五十六回=hồi thứ năm mươi sáu
第五十四回=hồi thứ năm mươi bốn
第六十一回=hồi thứ sáu mươi mốt
第六十七回=hồi thứ sáu mươi bảy
第六十三回=hồi thứ sáu mươi ba
第六十二回=hồi thứ sáu mươi hai
第六十五回=hồi thứ sáu mươi lăm
第六十六回=hồi thứ sáu mươi sáu
第六十四回=hồi sáu mươi bốn
第十三分钟=phút thứ mười ba
米开朗基罗=Michelangelo/Michelangelo Buonarroti
米德尔斯堡=Middlesbrough
精神分裂症=bệnh tâm thần phân liệt
索尔兹伯里=Salisbury
纸包不住火=giấy không thể gói được lửa/cây kim trong bọc lâu ngày cũng lòi ra
维多利亚海湾=vịnh Victoria/Vịnh Victoria
维多利亚港=cảng Victoria
置之死地而后生=tìm đường sống trong chỗ chết
羊毛出在羊身上=lông dê rơi từ trên thân dê/len ra khỏi cừu/Mỡ nó rán nó/ngỗng ông lễ ông
美利坚合众国=hợp chủng quốc Hoa Kỳ
美国有线电视新闻网=Cable News Network
群起而攻之=hợp nhau tấn công
翻脸不认人=trở mặt không quen biết/trở mặt không biết người/trở mặt/quay lưng
老死不相往来=cả đời không qua lại với nhau
联邦调查局=FBI/Cục Điều Tra Liên Bang - FBI
聚四氟乙烯=polytetrafluoroethylene/polyetrafluoroethylene
聪明反被聪明误=thông minh quá sẽ bị thông minh hại
肥水不流外人田=phù sa không lưu ruộng người ngoài/phì thủy bất lưu ngoại nhân điền/chỗ béo bở không cho người ngoài
胜读十年书=hơn hẳn đọc sách mười năm
胜造七级浮屠=còn hơn xây bảy cấp phù đồ
胡笳十八拍=hồ già thập bát phách
胳膊拧不过大腿=trứng chọi đá/châu chấu đá xe/nhỏ không địch lại lớn/yếu không thể địch lại mạnh
脚踏两只船=chân đứng hai thuyền/chân trong chân ngoài/đòn xóc hai đầu/ăn ở hai lòng/bắt cá hai tay
自动售货机=máy bán hàng tự động
自然科学家=nhà khoa học tự nhiên
自由职业者=người làm nghề tự do/freelancer
自由贸易区=khu tự do mua bán
艺高人胆大=kẻ tài cao gan cũng lớn/tài cao mật lớn/người tài cao gan lớn
艾克佐迪亚=Exodia
艾森豪威尔=Dwight D. Eisenhower
花无百日红=thời trẻ qua mau/hoa nở thì phải tàn
芳香族化合物=hợp chất thơm
苏伊士运河=kênh đào Xuy-ê/Suez Canal
苏门答腊岛=đảo Sumatra/Sumatra
若要人不知=nếu muốn người không biết
英雄所见略同=anh hùng sở kiến lược đồng
英雄无用武之地=anh hùng không đất dụng võ/anh hùng không có chỗ múa gươm
茅盾文学奖=giải Văn học Mao Thuẫn/Giải thưởng Văn học Mao Shield/Giải thưởng Văn học Mao Dun, giải thưởng viết tiểu thuyết của CHND Trung Hoa, được trao từ năm 1982
茹科夫斯基=Zhukovsky
荷兰东印度公司=công ty Đông Ấn Hà Lan
获得性免疫=miễn dịch nhận được
菜篮子工程=công trình cung cấp rau xanh
菲茨杰拉德=Fitzgerald
虎毒不食子=hổ dữ không ăn thịt con
蚂蚁啃骨头=kiến tha lâu đầy tổ/tích tiểu thành đại/có công mài sắt, có ngày nên kim
蚍蜉撼大树=châu chấu đá xe/kiến càng lay cổ thụ/lấy trứng chọi đá
蜡炬成灰泪始干=lạp cự thành hôi lệ thủy càn
行百里者半九十=đường đi trăm dặm nửa tại chín mươi
行行出状元=ngành nghề nào cũng có chuyên gia/nghề nào cũng có trạng nguyên/chuyên gia/người xuất sắc
衣带渐宽终不悔=y đái tiệm khoan chung bất hối
表演艺术家=biểu diễn nghệ thuật gia/nghệ sĩ biểu diễn
装甲运兵车=xe vận binh bọc thép
解铃还需系铃人=cởi chuông còn cần người buộc chuông/chỉ có người thắt nút mới cởi nút được
解铃还须系铃人=cởi chuông phải do người buộc chuông
计划单列市=thành phố cấp đặc biệt/lập kế hoạch liệt kê các thành phố
计算机操作=thao tác máy tính
计算机系统=hệ thống máy tính
识时务者为俊杰=kẻ thức thời mới là tuấn kiệt/thức thì vụ giả vi tuấn kiệt/hiểu rõ thời thế mới là người tài giỏi/kẻ thức thời là người tài giỏi/thức thời vụ giả vi tuấn kiệt/kẻ thức thời mới là tuấn kiệt
话不投机半句多=lời không hợp ý không hơn nửa câu
语不惊人死不休=lời không làm cho người ta kinh ngạc thì đến chết cũng không thôi
说一千道一万=kể một ngàn nói một vạn
说不清道不明=không nói rõ được cũng không tả rõ được
说时迟那时快=nói thì chậm mà xảy ra thì nhanh/nói thì chậm nhưng xảy ra rất nhanh
诺夫哥罗德=Novgorod/Novgorod, thành phố ở Nga
贝洛奥里藏特=Belo Horizonte
贝阿朵莉丝=Beatrice
贪多嚼不烂=tham thì thâm
贵人多忘事=quý nhân hay quên
赔了夫人又折兵=mất cả chì lẫn chài/tiền mất tật mang/xôi hỏng bỏng không/vừa mất phu nhân lại thiệt quân
赔本赚吆喝=bán lỗ vốn quảng cáo/mất vốn kiếm được
赶鸭子上架=bất đắc dĩ/không trâu bắt chó đi cày/ngoài khả năng
超现实主义=chủ nghĩa siêu hiện thực
超级计算机=siêu máy tính
路易斯安那州=Louisiana/Louisiana, tiểu bang Hoa Kỳ
路有冻死骨=ngoài đường chết cóng xương/con đường có xương có lạnh
路漫漫其修远兮=đường dài còn lắm gian truân
路遥知马力=đường xa mới biết sức ngựa
身在曹营心在汉=thân tại Tào doanh tâm tại Hán/thân ở trong lòng Tào Doanh ở Hán/sống ở trại Cao nhưng lại có lòng ở trại Hán
身残志不残=thân tàn nhưng chí không tàn
车到山前必有路=xe đến trước núi ắt có đường/cứ đi ắt có đường/đừng ngại khó, nhất định sẽ có cách vượt qua/xe tới trước núi tất có đường
车里雅宾斯克=Chelyabinsk/thị trấn Chelyabinsk ở sườn phía đông của Ural, trên tuyến đường sắt xuyên Siberia
辩证唯物主义=chủ nghĩa duy vật biện chứng/duy vật biện chứng
达尔文主义=chủ nghĩa Đác-uyn/học thuyết Đác-uyn
达维多维奇=Davidovich
迅雷不及掩耳=sét đánh không kịp bưng tai/nhanh như chớp/sét đánh không kịp bưng tay
迅雷不及掩耳之势=thế sét đánh không kịp bưng tai
过五关斩六将=qua năm quan chém sáu tướng
运动神经元=tế bào thần kinh vận động
近水楼台先得月=nhà ở ven hồ hưởng trước ánh trăng/làm quan hưởng lộc vua, ở chùa ăn lộc Phật/gần quan được ban lộc/gần gũi người có thế lực nên được lợi trước/làm quan ăn lộc vua, ở chùa ăn lộc Phật/cận thủy lâu thai tiên đắc nguyệt
还治其人之身=trả lại cho người
这山望着那山高=đứng núi này trông núi nọ/được voi đòi tiên
远亲不如近邻=bà con xa không bằng láng giềng gần
远水救不了近火=nước xa không cứu được lửa gần
远水解不了近渴=nước xa không cứu được lửa gần/nước ở xa không giải được cái khát ở gần/chờ được va, má đã sưng
迪斯尼乐园=công viên Disneyland
退而求其次=lùi lại mà cầu việc khác
通货膨胀率=tỷ lệ lạm phát
道不同不相为谋=đạo bất đồng bất tương vi mưu/đường không giống không thể cùng mưu đồ
醉翁之意不在酒=ý không ở trong lời/ý của Tuý Ông không phải ở rượu/có dụng ý khác/túy ông chi ý bất tại tửu/ý của Tuý Ông không phải ở rượu (có dụng ý khác)
里三层外三层=trong ba tầng ngoài ba tầng
里外不是人=trong ngoài không phải nhân
野火烧不尽=dã hỏa thiêu bất tẫn
针尖对麦芒=cây kim so với cọng râu/mũi nhọn đấu với đao sắc
铁杵磨成针=sắt mài thành kim/có công mài sắt, có ngày nên kim/nước chảy đá mòn/sắt mài nên kim
铁肩担道义=bờ vai gánh đạo nghĩa/thiết kiên đam đạo nghĩa
长江三角洲=vùng tam giác Trường Giang
长江后浪推前浪=trường giang sóng sau đè sóng trước/sóng sau sông Dương Tử đẩy sóng trước/không ngừng phát triển
闻名不如见面=nghe danh không bằng gặp mặt
防患于未然=phòng ngừa rắc rối có thể xuất hiện
阿兹海默症=bệnh Alzheimer/chứng Alzheimer/Bệnh Alzheimer
阿卡普尔科=Acapulco/Acapulco, thành phố ở Mexico
阿尔卑斯山=núi Alps/dãy Alps
阿尔卑斯山脉=Alps sơn mạch
阿拉伯数字=chữ số Ả rập
阿斯特拉罕=Astrakhan
陈谷子烂芝麻=đồ vô dụng/thóc mục vừng thối/chuyện vụn vặt nhạt nhẽo
除非己莫为=trừ phi mình đừng làm
隔行如隔山=khác nghề như cách núi/không trong nghề không biết tình hình nghề đó/cách hành như cách sơn
难于上青天=khó như lên trời
雅罗斯拉夫=Yaroslav
雅鲁藏布江=sông Nhã Lỗ Tàng Bố/Sông Yarlung Tsangpo, Tây Tạng
集体所有制=chế độ sở hữu tập thể
雷克雅未克=Reykjavík/Reykjavik, thủ đô của Iceland
青出于蓝而胜于蓝=trò giỏi hơn thầy
青铜器时代=thời đại đồ đồng/thời kỳ đồng thiếc
面和心不和=bằng mặt không bằng lòng/bằng mặt nhưng không bằng lòng
顾前不顾后=nhìn trước mà không ngó sau
顾头不顾尾=xem đầu mà chẳng xem đuôi
顾左右而言他=nói lảng nói tránh/đánh trống lảng/cố trái phải mà nói hắn
领事裁判权=thẩm quyền phán quyết lãnh sự/quyền tài phán lãnh sự
风湿性关节炎=bệnh viêm khớp mãn tính
风里来雨里去=dãi nắng dầm mưa/gian khổ
风马牛不相及=không liên quan nhau/không dính dáng nhau/dùi đục chấm mắm tôm/lảng xẹt
飞流直下三千尺=phi lưu trực hạ tam thiên xích
饱暖思淫欲=no bụng thì nghĩ dâm dục
饱汉不知饿汉饥=người no không biết đói/no hán không biết đói hán đói/Người được ăn no không thể biết người chết đói khổ như thế nào.
马克思主义=chủ nghĩa Mác
马绍尔群岛=Quần đảo Marshall
马萨诸塞州=bang Massachusetts/Massachusetts, tiểu bang Hoa Kỳ
马达维基亚=Mahdavikia
马雅可夫斯基=Mayakovsky/Vladimir Mayakovsky
驴唇不对马嘴=râu ông nọ cắm cằm bà kia/hỏi một đằng trả lời một nẻo/đầu Ngô mình Sở
高不成低不就=cao không được thấp không xong/cao không với tới, thấp không bằng lòng/cao không được thấp không phải là được/Cao không với tới/thấp không bằng lòng
高尔夫球场=sân đánh Golf/sân golf
高科技产品=sản phẩm công nghệ cao
魔幻现实主义=chủ nghĩa hiện thực huyền ảo/chủ nghĩa hiện thực huyền diệu
鸣鼓而攻之=công khai lên án tội trạng/lên án/công khai lên án
齐家治国平天下=tề gia trì quốc bình thiên hạ
