一主=một chủ/nhất chủ|a
一亮=sáng lên/sáng ngời|a
一似=dường như/giống như|a
一僵=cứng đờ|a
一冷=lạnh lẽo/lạnh lẽo|a
一净=Nhất Tịnh|a
一凉=mát lạnh/mát mẻ/nguội lạnh/chợt lạnh|a
一博=đánh cược|a
一厉=mãnh liệt|a
一吃=ăn một lần|a
一和=vừa cùng/một loại|a
一喝=quát một tiếng/vừa quát/vừa uống/hét một tiếng|a
一守=một thủ|a
一安=nhất an|a
一害=một hại|a
一弛=hòa hoãn|a
一弱=một yếu/một khi yếu|a
一急=quýnh lên|a
一悲=bi|a
一慧=Nhất Tuệ|a
一扭=uốn éo/lắc một cái/uốn một cái|a
一拗=bẻ một phát|a
一振=chấn động/rung lên|a
一挺=một khẩu/ưỡn một cái/một cái|a
一捏=bóp/sờ/bóp một cái/sờ một cái|a
一撞=va chạm/đụng một cái|a
一放=vừa để xuống|a
一敛=thu vào/thu lại/hơi thu lại|a
一散=tản ra|a
一昂=hả ra một phát|a
一昧=nhất muội|a
一显=vừa hiển/vừa hiện ra|a
一晃=nhoáng một cái/nhoáng lên/thoáng một cái/loáng một cái/vụt qua/thoáng qua|a
一暖=ấm áp|a
一松=buông lỏng/buông lỏng một cái|a
一柔=một nhu|a
一歪=nghiêng một cái/lệch đi|a
一浮=khẽ phồng|a
一涌=bay vọt|a
一涩=miệng khô khốc/chát chúa|a
一滑=trượt đi/vừa trượt|a
一炼=nhất luyện|a
一热=nóng lên|a
一熟=mới chín|a
一爆=nhất bạo/một vụ nổ/nổ một phát/vừa nổ|a
一爽=nhất sảng/thoải mái|a
一甜=ngòn ngọt|a
一登=trèo lên một lần/vừa bước|a
一矮=trùn xuống|a
一福=khẽ chào|a
一稳=vừa vững|a
一窘=quẫn bách|a
一肃=nghiêm một chút/nghiêm túc/nghiêm nghị|a
一脱=cởi một cái|a
一舒=thả lỏng|a
一般=Bình thường|a
一菲=nhất phỉ|a
一诧=kinh ngạc|a
一蹬=đạp một cái/giẫm một cái|a
一软=mềm nhũn|a
一迈=một bước|a
一进=tiến/vừa vào|a
一透=bỗng thấu|a
一醒=vừa tỉnh|a
一钻=vừa chui|a
一错=một sai/xê dịch|a
一闹=nháo trò/quậy một phát|a
一静=yên tĩnh|a
一靠=khẽ dựa/dựa vào một chút|a
一高=một cao|a
万般=mọi loại/cực kì/tất cả/hết thảy/hết sức/rất|a
不久=không lâu/không lâu sau/ngay sau đó/chẳng bao lâu nữa/liền/sớm|a
不亮=không sáng|a
不俗=không tầm thường|a
不倦=không biết mỏi mệt/tận tình/tận tuỵ|a
不全=không hoàn toàn/không được đầy đủ|a
不兴=không thịnh hành/không thể/lỗi thời/không hợp thời/đề-mốt/cổ lỗ sĩ/không được|a
不冥=bất minh|a
不冷=không lạnh|a
不净=không sạch|a
不出意外=không có gì bất ngờ xảy ra|a
不利=bất lợi/không có lợi/không thuận tiện/xui/rủi/có hại|a
不劲=không xong|a
不勉=không khỏi|a
不单=không chỉ/không chỉ ... mà còn/không riêng/chẳng những/không những|a
不合宜=bất hợp nghi/không hợp|a
不同=khác biệt/bất đồng/khác nhau/không giống|a
不吝=không tiếc/vui lòng|a
不好受=không dễ chịu|a
不好惹=không dễ chọc/kiên định/không dễ lung lay/không dễ đối phó|a
不好意思=không có ý tứ/ngượng ngùng/xấu hổ/mắc cỡ/thẹn thùng/ngại/không nỡ/không tiện/thật không tiện|a
不好玩=không dễ chơi/chơi không vui|a
不妙=không ổn/không hay/xấu|a
不妥=không ổn/không thích hợp/không thích đáng|a
不孝=bất hiếu/không có hiếu/đứa con bất hiếu này|a
不安=bất an/bất ổn/không yên/không thanh thản/lo lắng/không an lòng/không yên tâm/bứt rứt/băn khoăn|a
不宜=không nên/không thích hợp/không hợp/không vừa sức|a
不富=không giàu|a
不小=không nhỏ|a
不巧=không khéo|a
不幸=bất hạnh/không may/rủi ro/xấu/chẳng may/chẳng ngờ/tai hoạ/thảm hoạ/tai ách|a
不得劲=khó/không dễ chịu/không thuận tay/uể oải/khó chịu/ngượng ngùng/thẹn thùng/bất đắc kình|a
不得好死=chết không yên lành/không chết tử tế được/chết dữ|a
不忘=không quên|a
不怠=không lười/không tha|a
不急=không vội/không kịp|a
不悦=không vui/không hờn giận/không thích|a
不惭=không biết thẹn/bất tàm/không hổ|a
不愁=không lo|a
不愉=không vui|a
不愧=không hổ/xứng đáng|a
不慌=không hoảng hốt|a
不慎=vô ý/sơ suất/không cẩn thận/lơ đễnh/cẩu thả/không để ý/khinh suất/không thận trọng|a
不懂=không hiểu/không biết|a
不懈=không ngừng/liên tục/không lơ là/không buông lỏng/bền bỉ/luôn luôn/ngoan cường|a
不折=không gãy|a
不振=không phấn chấn/không vượng/không thịnh vượng/uể oải suy sụp|a
不易=không dễ/không đổi|a
不显=không hiện/không hiện ra|a
不景气=kinh tế đình trệ/kinh tế không phồn vinh/buôn bán ế ẩm/tàn tạ/sa sút/tiêu điều/không thịnh vượng/không hưng vượng|a
不智=không khôn ngoan/bất trí|a
不朽=bất hủ/bất diệt|a
不松=không buông|a
不殆=không thua/không nguy hiểm/không nguy|a
不浅=không cạn/sâu|a
不淑=không quen|a
不淡=không nhạt|a
不满=bất mãn/chưa tròn/không đầy/chưa đầy|a
不灵=mất linh/không linh nghiệm|a
不烈=không gắt|a
不熟=không quen/không chín|a
不爽=khó chịu/bực dọc/không sảng khoái/không sai/đúng đắn/chính xác/xác đáng|a
不爽快=khó chịu|a
不特=không chỉ/chẳng những/không những|a
不甚=không quá/không...lắm|a
不由=không khỏi/không phải do/không theo/không nghe|a
不畅=không thông suốt/không khoái|a
不瘦=không gầy|a
不睦=không hòa thuận|a
不矮=không thấp/không lùn/thấp|a
不祥=bất tường/chẳng lành/điềm xấu/chẳng may/không rõ|a
不稳=bất ổn/không yên/không ổn|a
不稳固=chưa vững chắc/không vững chắc|a
不笨=không ngu ngốc|a
不老=bất lão/không già|a
不耐烦=không kiên nhẫn/không nhịn được/sốt ruột/bực mình/không nhẫn nại/thiếu kiên nhẫn|a
不耻=trơ trẽn/trơ tráo/vô liêm sỉ/không biết xấu hổ|a
不胖=không mập|a
不腻=không ngán|a
不良=bất lương/không tốt/xấu/kém/rối loạn/có hại/không có hiệu quả|a
不菲=không ít/xa xỉ/không rẻ|a
不蔽=không che được|a
不薄=không tệ/không mỏng|a
不蠢=không ngốc/không ngu|a
不规则=bất quy tắc/không theo quy tắc/không theo luật lệ gì cả/khác thường/dị thường|a
不豫=khó chịu|a
不贞=bất trinh|a
不贵=không đắt/không quý/không mắc|a
不趣=bất thú|a
不足=không đủ/chưa đủ/bất túc/thiếu/chưa tới/chưa đủ số/không đầy/không đáng/không thể|a
不躁=không nóng nảy|a
不适=khó chịu/không khỏe/khó ở/không dễ chịu/không thoải mái|a
不逊=kiêu ngạo/không kém/vô lễ/ngông nghênh/càn rỡ|a
不重=không nặng|a
不错=không sai/không tệ/đúng/đúng vậy/chính xác/phải/tốt/không xấu/khoẻ mạnh|a
不雅=bất nhã/thiếu lễ độ|a
不饶=không buông tha/không tha thứ/không bỏ qua|a
不驯=bất tuân/bất tuần|a
丑俊=xấu đẹp|a
丑怪=xấu xí|a
丑恶=ghê tởm/đáng ghê tởm/xấu xa/bôi nhọ/đáng ghét/kinh tởm/ghê sợ/khủng khiếp/kinh khủng/sửu ác|a
丑陋=xấu xí/khó coi|a
专诚=đặc biệt/chuyên biệt/riêng biệt|a
丢眼=nháy mắt/đưa mắt ra hiệu|a
严同=Nghiêm Đồng|a
严守=giữ nghiêm/giữ kín|a
严密=nghiêm mật/chu đáo/kín đáo/chặt chẽ/không sơ hở|a
严寒=giá lạnh/cực lạnh/rất lạnh/nghiêm hàn|a
严峻=nghiêm trọng/nghiêm túc/nghiêm khắc/gay gắt/nghiêm nghị|a
严整=nghiêm chỉnh|a
严明=nghiêm minh/Nghiêm Minh|a
严直=Nghiêm Trực|a
严紧=nghiêm ngặt/kín đáo|a
严肃=nghiêm túc/nghiêm/làm cho nghiêm túc/nghiêm minh|a
严苛=khắc nghiệt/nghiêm khắc|a
严谨=nghiêm cẩn/chặt chẽ cẩn thận|a
严酷=tàn khốc/nghiêm khắc/thảm khốc|a
严重=nghiêm trọng|a
个人爱好=ưa thích cá nhân|a
个好=tốt|a
个忙=chuyện/khó khăn|a
个歉=lời xin lỗi|a
个遍=mấy lần/một lần/một cái|a
中厚=trung hậu|a
丰体=thân thể xinh đẹp/phong mãn|a
丰厚=phong phú/dày/nhiều/hậu hĩnh/to/hậu|a
丰姿=phong thái|a
丰娆=Phong Nhiêu|a
丰嫩=phong phú mà non nớt|a
丰富=phong phú/dồi dào/nhiều/dư dật/làm giàu thêm/làm phong phú|a
丰沛=đầy đủ/dồi dào/phong phái|a
丰润=nở nang/phúng phính|a
丰满=đầy đặn/đầy ắp/đầy đủ/sung túc/đầy/đẫy đà/béo chắc/nở nang|a
丰盈=đẫy đà/nở nang/giàu có/sung túc/đầy đủ/đủ|a
丰盛=phong phú/nhiều/giàu có/thịnh soạn|a
丰硕=to lớn/lớn lao/đáng kể/phong thạc|a
丰美=tốt tươi/dồi dào/tươi tốt|a
丰腴=nở nang/đẫy đà/tươi tốt/dồi dào tươi tốt/thịnh soạn/phong du|a
丰茂=um tùm/rậm rạp/sum suê/tươi tốt|a
丰裕=sung túc/giàu có/dư dả|a
丰足=sung túc/đầy đủ/no ấm/giàu có/phong túc|a
丰采=phong thái/vẻ đẹp|a
丰雅=Phong Nhã|a
丰韵=thuỳ mị/hấp dẫn/quyến rũ/phong vận|a
丰饶=phì nhiêu/màu mỡ/phong phú/phong nhiêu|a
久旱=hạn hán đã lâu|a
义勇=nghĩa dũng/anh dũng đấu tranh vì chính nghĩa|a
义结=kết nghĩa|a
乏乏=mệt lả|a
乏倦=mệt mỏi/mệt lử|a
乏力=không còn chút sức lực nào/mệt mỏi/mệt nhọc/không có sức lực/bất tài/không có năng lực/mất sức|a
乏味=không thú vị/chán nản/nhạt nhẽo/kém thú vị/vô vị/nhàm chán|a
乏善=phạp thiện|a
乏困=mệt nhọc/mệt mỏi|a
乏累=mệt mỏi|a
乏顿=mệt/mệt mỏi|a
乐乐=nhạc nhạc/vui vui mừng mừng/thật vui vẻ|a
乐和=vui sướng/thoải mái/dễ chịu|a
乐感=nhạc cảm/cảm giác vui vẻ|a
乐活=vui vẻ sinh hoạt|a
乐然=vui vẻ|a
乐见=vui thấy|a
乐观=lạc quan/vui vẻ|a
乐趣=niềm vui thú/lạc thú/niềm vui/hứng thú/thích thú|a
乐进=Nhạc Tiến|a
乖僻=kỳ quái/quái gở/kỳ quặc/lập dị/kỳ cục/quái đản/cổ quái|a
乖巧=nhu thuận/khôn ngoan/khôn khéo/hợp lòng người/được người ta thích/lanh lợi/tinh khôn/lanh trí/thông minh/quai sảo/khéo léo/ngoan ngoãn|a
乖异=kỳ khôi/kỳ quặc/chuyện lạ/việc lạ|a
乖张=quái đản/kỳ quái/kỳ quặc/gàn dở/ương bướng/ngược/không thuận/không may/ngang bướng|a
乖戾=bất thường/trái tính trái nết/không hợp nhau/dở hơi/lố lăng/gàn dở/ương bướng/quai lệ/ngang trái|a
乖谬=quái đản/vô lý/hoang đường/bất thường|a
乖顺=thuận theo/nghe theo/ngoan thuận|a
了然=hiểu rõ/rõ ràng/sáng tỏ/liễu nhiên|a
争艳=tranh diễm|a
些大=có chút lớn|a
些小=một ít/một tý/nhỏ/ít|a
亢旱=đại hạn/hạn nặng/rất lâu rồi không có mưa/hạn hán nghiêm trọng/kháng hạn/nắng quá|a
亮丽=xinh đẹp|a
亮敞=sáng sủa|a
亲切=thân thiết/thân cận/thân mật/thân thương/nhiệt tình/ân cần|a
亲密=thân mật/thân thiết|a
亲昵=thân thiết/vô cùng thân thiết/thân mật/rất thân|a
亲热=thân mật/thân thiết/nồng nhiệt/nồng thắm/thắm thiết|a
亲爱=thân ái/thân thiết/thân mến/thương yêu|a
亲疏=thân sơ|a
亲贵=hoàng thân quốc thích/hoàng gia/hoàng thất/cận thần|a
仁弱=nhân từ yếu đuối|a
仓急=vội vã|a
仗义=trượng nghĩa/giữ gìn chính nghĩa/ủng hộ chính nghĩa/coi trọng nghĩa khí/trọng nghĩa|a
仗着=ỷ vào|a
优劣=ưu khuyết/ưu liệt|a
优厚=hậu đãi/ưu đãi/ưu hậu|a
优异=ưu dị/xuất sắc nhất/hơn hẳn/trội nhất/đặc biệt tốt|a
优柔=ôn nhu/do dự/rộng lượng/khoan thai/hoà nhã/ôn hoà/dịu dàng/không cương quyết|a
优沃=ưu đãi|a
优渥=hậu đãi/đãi ngộ|a
优秀=ưu tú/vĩ đại/xuất sắc|a
优美=ưu mỹ/đẹp hơn/tốt đẹp/đẹp đẽ/tươi đẹp|a
优裕=đầy đủ/sung túc|a
优越=ưu việt/hơn hẳn/cực tốt|a
优酷=Youku|a
优雅=ưu nhã/tao nhã/thanh nhã/xinh đẹp/đẹp mắt|a
伟大=vĩ đại/lớn lao|a
伟姿=vĩ tư|a
伟平=Vĩ Bình|a
伤害=tổn thương/thương tổn/làm hại/xúc phạm|a
伤寒=bệnh thương hàn/bệnh sốt/cảm lạnh|a
伤悲=bi thương|a
伤残=tàn tật/bị thương tàn phế|a
伤热=hư vì nóng/ôi thối|a
伤痛=đau xót/đau đớn|a
伤难=thương nạn|a
伶人=đào kép|a
伶仃=linh đinh/mồ côi/lẻ loi/trơ trọi/không nơi nương tựa/gầy yếu/ốm yếu/Linh đinh/đi vò võ một mình/cô đơn|a
伶俐=lanh lợi/thông minh/linh hoạt/lanh lị|a
低俗=thấp kém/dung tục|a
低劣=thấp kém/kém/tồi/thấp|a
低哑=khàn khàn/khàn và nhỏ|a
低廉=rẻ/rẻ tiền/giá thấp/giá hạ/giá hời|a
低效=không hiệu quả|a
低昂=lên xuống/nhấp nhô|a
低智=trí tuệ thấp/Sa sút trí tuệ|a
低武=đê võ/đê vũ|a
低沉=trầm thấp/âm u/tối sầm/thấp/trầm/xuống/giảm/lắng xuống|a
低洼=chỗ trũng/trũng/thấp/thấp trũng|a
低浅=nông cạn/thấp cạn|a
低湿=ẩm thấp|a
低热=sốt nhẹ|a
低矮=thấp bé/bé nhỏ/thấp lùn|a
低贱=đê tiện/thấp/thấp hèn/thấp kém/rẻ mạt|a
何遽=sao/thế nào|a
侠名=hiệp danh|a
侠少=thiếu hiệp|a
侠白=hiệp bạch|a
侥幸=may mắn/gặp may/số đỏ|a
便人=tiện nhân/người tiện thể/người tiện nhờ|a
便便=tiện tiện/béo phệ/phệ nệ|a
便利=tiện lợi/thuận tiện/tiện/tiện cho/đem lại tiện lợi|a
便宜=tiện nghi/tiện lợi/tuỳ nghi/thuận tiện/rẻ/hời/lợi/bở/làm được lợi|a
便当=liền làm/cơm hộp/liền đem/tiện lợi (cơm hộp)/tiện lợi/thuận tiện/đơn giản/dễ dàng|a
便急=liền vội|a
便捷=nhanh gọn/nhanh và tiện/tiện lợi/dễ dàng/trôi chảy/lưu loát/nhạy bén/nhanh nhẹn/lanh lẹ/nhanh trí/linh lợi|a
便易=thuận tiện|a
便由=liền do|a
便秘=táo bón/chứng táo bón|a
促狭=ranh mãnh/bỡn cợt/trêu ghẹo/tinh nghịch/tinh quái/láu lỉnh/đùa dai|a
俊俏=tuấn tiếu/tuấn tú/xinh đẹp/đẹp đẽ/khôi ngô/anh tuấn|a
俊少=Tuấn thiếu/thiếu Tuấn|a
俊挺=tuấn đĩnh|a
俊朗=tuấn lãng|a
俊气=tuấn khí|a
俊然=Tuấn Nhiên|a
俊猛=tuấn mãnh|a
俊秀=tuấn tú/thanh tú/đẹp đẽ|a
俊美=tuấn mỹ/tuấn tú/khôi ngô/đẹp trai|a
俊脸=khuôn mặt tuấn tú/gương mặt tuấn tú|a
俊雅=tuấn nhã/trẻ đẹp lịch sự|a
俏丽=xinh đẹp/xinh xắn/đẹp đẽ/tiếu lệ|a
俏俏=Tiếu Tiếu|a
俏媚=tiếu mị|a
俏气=tiếu khí|a
俏皮=hoạt bát/dí dỏm/đẹp đẽ/xinh đẹp/ dí dỏm/tiếu bì|a
俏眼=tiếu nhãn|a
俏秀=tiếu tú|a
俏美=tiếu mỹ|a
俏脸=gương mặt xinh đẹp/khuôn mặt/|a
俏鼻=mũi thon|a
保洁=nhân viên quét dọn/bảo khiết|a
俭朴=đơn giản/tiết kiệm/giản dị/tằn tiện/kiệm phác|a
俱佳=đều tốt/câu giai|a
俱厉=câu lệ/nghiêm túc|a
倒挺=cũng rất|a
倒霉=không may/xui xẻo/xui/xúi quẩy/rủi ro|a
倔傲=kiên cường|a
倔劲=quật kình|a
倔巴=gàn/gàn bướng/bộc trực/bướng bỉnh/ngoan cố/khó bảo/dai dẳng/khó trị|a
倔强=quật cường/ngang ngược/bướng bỉnh/không chịu khuất phục|a
倔犟=quật cường|a
倔起=quật khởi|a
倜傥=lỗi lạc/hào phóng|a
倜然=khác thường/xa rời|a
倥偬=việc cấp bách/việc khẩn cấp/khốn cùng/nghèo khổ/bần cùng|a
倦乏=mệt mỏi|a
倦怠=quyện đãi/mệt mỏi|a
倦意=ủ rũ/mỏi mệt|a
倨傲=kiêu căng/ngạo mạn/kiêu ngạo|a
值勤=thường trực/trực ban/gác|a
偏僻=vắng vẻ/hẻo lánh/hoang vu/khuất nẻo|a
偏劳=chịu khó giúp cho/làm phiền/thêm phiền|a
偏坦=thiên vị|a
偏大=thiên đại|a
偏小=còn hơi nhỏ|a
偏瘦=hơi gầy|a
偏薄=thiên bạc|a
偏要=càng muốn|a
偏重=thiên về/nghiêng về/chú trọng về/thiên trọng|a
偏错=sai lệch|a
停匀=đều/đều đặn|a
停妥=xong xuôi/đâu ra đấy/ổn thoả|a
健体=kiện thể|a
健全=kiện toàn/khoẻ mạnh/vững vàng/hoàn thiện/hoàn hảo/hoàn chỉnh/hoàn mỹ|a
健壮=cường tráng/tráng kiện|a
健实=cường tráng/khoẻ mạnh/tráng kiện|a
健康=khỏe mạnh/lành mạnh/tráng kiện|a
健忘=dễ quên/hay quên/chóng quên/mau quên|a
健旺=sức khoẻ dồi dào/cường tráng/sung sức|a
健朗=kiện khang/khỏe mạnh/khoẻ mạnh/cường tráng/tráng kiện|a
健硕=tráng kiện/to lớn|a
健美=khỏe đẹp cân đối/kiện mỹ/khỏe đẹp/khoẻ đẹp/thể hình khỏe đẹp cân đối|a
健胃=kiện vị/kích thích tiêu hoá|a
偶出=thỉnh thoảng xuất hiện|a
偶见=thỉnh thoảng thấy|a
傑出=kiệt xuất/nói người hay vật gì sinh ra khác hẳn mọi loài|a
傲俗=khinh đời|a
傲僻=kiêu căng ngang ngạnh|a
傲劲=ngạo kình|a
傲寒=Ngạo Hàn|a
傲慢=ngạo mạn/kiêu kỳ/kiêu căng|a
傲气=ngạo khí/thói kiêu ngạo/thái độ kiêu kỳ|a
傲纵=hỗn láo xấc xược|a
傲诞=ngạo mạn ngông cuồng|a
傲达=coi thường phép tắc|a
像要=như muốn|a
僵冷=lạnh cứng|a
僵固=cứng đờ|a
僵硬=cứng nhắc/cứng đờ/cứng ngắc/không linh hoạt|a
僻陋=vắng vẻ hoang sơ|a
僻静=yên lặng/yên tĩnh/vắng lặng/tĩnh lặng|a
充刻=Sung Khắc|a
充好=hàng nhái/hàng giả/sung hảo/nạp xong|a
充当=sung làm/hành động/giữ chức/làm/phụng sự/phục vụ/đảm nhiệm|a
充沛=dồi dào/sự dư thừa/tràn đầy/sôi nổi/mãnh liệt/hoạt bát/hùng hồn/dư thừa/dồi dào|a
充满=tràn ngập/lấp đầy/tràn trề/nạp đầy|a
充畅=dồi dào/phong phú/thịnh vượng|a
充盈=tràn đầy/phong phú/dồi dào/đầy đặn/béo chắc/mũm mĩm/mập mạp/phinh phính/nần nẫn/sung doanh|a
充耳=từ chối nghe/bịt tai|a
充裕=dư dả/đầy đủ/sung túc/dồi dào/dư dật|a
充足=sung túc/đầy đủ/dồi dào/phong phú/dư dật|a
先严=vong phụ/tiên phụ/người cha đã khuất|a
先吃=ăn trước|a
先听=trước hết nghe|a
先圣=tiên thánh|a
先富=tiên phú|a
先挑=chọn trước|a
先朗=Tiên Lãng|a
先烈=tiên liệt/bậc tiên liệt|a
先登=giành trước|a
先福=Tiên Phước|a
先进=tiên tiến/trước vào|a
光亮=sáng ngời/ánh sáng/sáng/rực rỡ/sáng choang/ánh sáng mặt trời|a
光嫩=quang nộn|a
光宠=vinh dự/ân huệ|a
光洁=trơn bóng/sáng bóng/mượt/bằng phẳng/bóng loáng/quang khiết|a
光滑=bóng loáng/trơn truột/nhẵn bóng/trơn như đổ mỡ|a
光爆=quang bạo|a
光艳=rực rỡ/sáng chói/quang diễm|a
光靠=chỉ dựa vào/dựa hết vào|a
光鲜=quang vinh/ngăn nắp/vinh quang/gọn gàng|a
公募=công mộ/chào bán công khai/phát hành công khai|a
公谨=Công Cẩn|a
兴趣不大=hứng thú không lớn|a
具体=cụ thể/rõ ràng/rõ rệt/tỉ mỉ/xác định rõ ràng/một cách cụ thể/cụ thể tới|a
具杂=lẫn lộn|a
典丽=tao nhã hoa lệ|a
典当=cầm cố/cầm/thế chấp/hiệu cầm đồ/tiệm cầm đồ|a
典雅=trang nhã/tao nhã/thanh lịch/điển nhã|a
内急=quá mót/nội cấp/bên trong cấp|a
内疚=áy náy/đau lòng|a
冒功=mạo nhận công lao|a
冒昧=mạo muội/đánh liều/đánh bạo|a
冗余=dư thừa/dư thừa rườm rà/nhũng dư|a
冗杂=rườm rà/rắc rối|a
冥冥=tối tăm/minh minh/sâu xa thăm thẳm|a
冥顽=gian ngoan/hồ đồ ngu xuẩn/ngu đần/ngu xuẩn|a
冲凉=tắm/rửa/xối nước/giội nước cho mát|a
冲劲=bốc đồng/trùng kình|a
冲淡=hòa tan/pha loãng/làm nhạt đi/giảm bớt/mất chất/phai/nhạt/làm yếu đi/do dự|a
冲虚=Xung Hư|a
冷不冷=có lạnh hay không|a
冷傲=lãnh ngạo|a
冷僻=hẻo lánh/hẻo lánh vắng vẻ/ ít gặp/ít thấy/ít gặp/lãnh tích|a
冷冷=lạnh lùng|a
冷厉=lạnh lùng/sẳng giọng/lạnh lùng nghiêm nghị|a
冷寂=lãnh tịch/vắng lặng/im lặng/im ắng|a
冷寞=lãnh tĩnh/lạnh nhạt|a
冷峭=lạnh buốt/lạnh cóng/lạnh giá/thái độ hà khắc|a
冷峻=lạnh lùng/lạnh lùng nghiêm nghị|a
冷智=lãnh trí|a
冷洌=lãnh liệt|a
冷淡=lãnh đạm/vắng lặng/im lìm/ế ẩm/nhạt nhẽo/lạnh nhạt/nhạt nhẽo với|a
冷烈=lạnh lùng|a
冷热=lạnh nóng/nóng lạnh|a
冷眼=lặng lẽ/đối xử lạnh nhạt/mắt lạnh/trầm tĩnh/con mắt khách quan/thờ ơ|a
冷硬=lạnh lẽo cứng rắn/nguội lạnh|a
冷肃=lãnh túc|a
冷莹=Lãnh Oánh|a
冷酷=lãnh khốc/cay nghiệt/ác nghiệt/lạnh lùng hà khắc|a
冷静=tỉnh táo/lãnh tĩnh/vắng vẻ/yên tĩnh/bình tĩnh/nguội lạnh/vắng lặng/tỉnh táo|a
冷鲜=tươi lạnh|a
凄冷=thê lãnh/lạnh lẽo thê lương|a
凄凉=thê lương/lạnh lẽo/vắng lặng|a
凄切=thê lương bi ai/thảm thiết/thảm thương|a
凄厉=thê lương/thảm thiết/thê thảm|a
凄婉=réo rắt thảm thiết/thê uyển/thảm thiết|a
凄容=thê dung|a
凄弱=thê nhược|a
凄怆=thê thảm/đau thương|a
凄恻=tan nát|a
凄惨=thê thảm/thảm thương|a
凄惶=thê lương/kinh hoàng|a
凄楚=thống khổ/bi thảm/đau buồn thê thảm|a
凄清=lạnh lẽo/lạnh buốt/lạnh lùng/thê lương|a
凄美=thê mỹ|a
凄艳=thê diễm|a
凄苦=đau khổ|a
凄迷=thê lương/ảm đạm/bi thương/đau thương/bâng khuâng|a
凄酸=chua xót|a
凄风=thê phong/rét buốt/thê lương buồn bã|a
准确=chuẩn xác/chính xác/đúng/đúng đắn|a
凉凉=lành lạnh|a
凉快=mát mẻ/hóng mát/mát/mau lạnh|a
凉爽=mát mẻ/mát|a
凋敝=khó khăn/suy thoái/khốn khổ/suy tàn/suy vi|a
凌乱=lộn xộn/mất trật tự/ngổn ngang/lung tung/nhốn nha nhốn nháo/bừa bộn/xốc xếch|a
凌动=Lăng Động|a
凌杂=lộn xộn/hỗn tạp|a
凑凑=đến một chút/góp góp|a
凑合着=thích hợp|a
凑巧=trùng hợp/đúng dịp/đúng lúc/may mắn/may thay/may/gặp may/vừa khéo|a
凑趣=góp vui/để phù hợp với khẩu vị của người khác|a
凑足=kiếm đủ/đủ|a
凑齐=góp đủ/gom góp/hồi môn/tập hợp|a
凛冽=lạnh thấu xương/lẫm liệt/lạnh lẽo|a
凛起=rét lạnh|a
凛风=lẫm phong|a
凶信=tin chẳng lành/hung tin/tin dữ|a
凶名=hung danh|a
凶怖=hung dữ|a
凶恶=hung ác|a
凶悍=hung hãn|a
凶戾=hung lệ|a
凶暴=hung bạo/dữ tợn hại người/ác dữ|a
凶横=hung hoành/hung ác ngang ngược|a
凶死=chết thảm|a
凶残=hung tàn/độc ác tàn nhẫn/kẻ hung ác/kẻ hung bạo|a
凶气=khí thế hung ác/thần sắc hung ác/hung khí|a
凶烈=hung liệt|a
凶狂=hung ác điên cuồng|a
凶狞=dữ tợn|a
凶狠=hung ác/hung ác độc địa/hung ác tàn nhẫn/mãnh liệt|a
凶猛=hung mãnh/hung dữ mạnh mẽ|a
凶着=hung|a
凶肆=cừa hàng đồ tang lễ|a
凶虐=hung ác bạo ngược|a
凶蛮=hung man|a
凶邪=hung tà|a
凶顽=hung ngoan/hung dữ/khốc liệt và không thể kiểm soát|a
凸显=nổi bật/nổi lên/lộ ra|a
出奇=lạ thường/thần kỳ/đặc biệt/cực kỳ/khác thường/phi thường/xuất kỳ/lạ kỳ|a
刁悍=gian giảo/xảo quyệt/điêu ngoa/gian xảo|a
刁泼=giảo quyệt không vâng lời|a
刁滑=gian xảo/xảo trá/xảo quyệt|a
刁猾=gian xảo|a
刁难=làm khó dễ/hoạnh hoẹ/gây khó khăn/gây khó khăn cho|a
刚亮=mới vừa sáng|a
刚健=tráng kiện/khoẻ mạnh/cường tráng/mạnh mẽ|a
刚决=cương quyết|a
刚出=mới ra|a
刚劲=cương kình/mạnh mẽ/hiên ngang/vững vàng/kiên quyết/cứng cáp/vững chắc/cường tráng/sung sức|a
刚强=kiên cường/vững vàng/vững chắc/không chịu khuất phục/bất khuất/cương cường|a
刚散=mới vừa tan|a
刚柔=cương nhu|a
刚烈=cương liệt/rắn rỏi khí khái/kiên cường khí khái/bốc lửa/nảy lửa|a
刚硬=kiên cường/bất khuất/cương ngạnh|a
刚进=vừa mới tiến/mới vừa vào/vừa vào|a
利薄=lời ít|a
利足=chân nhọn|a
利钝=cùn/bén/thuận lợi/khó khăn|a
别名=biệt danh/tên gọi khác/biệt hiệu|a
别急=đừng nóng vội|a
别扭=khó chịu/không được tự nhiên/chướng/kỳ quặc/kỳ cục/khó tính/chưa quen/không hợp/hục hặc/rầy rà/xích mích/cự nự/không trôi chảy/không xuôi/không lưu loát/không thông suốt|a
别挤=chớ đẩy|a
别闹=đừng làm rộn/đừng nghịch|a
刺猥=nhím/con nhím/nhím Âu/quả có nhiều gai/người khó giao thiệp/nhím Âu|a
刻薄=cay nghiệt/không tốt/không tử tế/hà khắc/khắt khe/khắc nghiệt/khắc bạc|a
削瘦=gầy gò/gầy|a
削韧=đánh choáng/stagger|a
剧烈=kịch liệt/mạnh/dữ dội|a
剧疼=đau dữ dội/đau đớn|a
剽悍=nhanh nhẹn dũng mãnh/nhanh nhẹn|a
劬劳=mệt nhọc/vất vả|a
劲爆=kình bạo/kình bạo|a
劲爽=tinh thần sảng khoái|a
劲猛=kình mãnh|a
劳倦=mệt mỏi/mệt nhọc/mệt lử/kiệt sức|a
劳烦=làm phiền/nhờ/phiền/cảm phiền|a
劳瘁=vất vả mệt nhọc/mệt nhọc vất vả/mệt lử/kiệt sức|a
劳碌=lao lực/vất vả/gian khổ/khó nhọc|a
劳苦=khổ cực/lao khổ/cực khổ/vất vả/cực nhọc/mệt nhọc|a
势均=thế quân|a
勇健=dũng kiện/khỏe mạnh|a
勇悍=dũng mãnh gan dạ/dũng mãnh không biết sợ|a
勇敢=dũng cảm/gan dạ|a
勇武=vũ dũng/võ dũng|a
勇猛=dũng mãnh/hùng dũng|a
勤俭=cần kiệm/cần cù tiết kiệm|a
勤劳=cần cù/cần lao|a
勤奋=chăm chỉ/siêng năng/cần cù/chuyên cần|a
勤快=chịu khó/cần mẫn|a
勤恳=cần cù chăm chỉ/cần cù và thật thà|a
勤苦=chịu khổ chịu khó/cần cù|a
勤谨=chăm chỉ/siêng năng/cần cù|a
匀净=đều đặn/đều|a
匀出=san ra|a
匀和=đều đặn/đều/làm cho đều/chia đều/so bằng|a
匀实=đều đặn/đều|a
匀整=đều đặn ngay ngắn|a
匀气=quân khí|a
匀溜=đồng dạng/quân phục/đều đặn/đều tăm tắp/đầy đặn/cân đối|a
匀称=cân xứng/đều đặn/đều/quân xưng|a
匆促=vội vàng/gấp gáp|a
华诞=hoa đản/ngày sinh|a
卑劣=ti tiện/đê hèn/bỉ ổi/ty liệt/đều là nhời chê kém cả/ti liệt|a
卑屈=khúm núm/quỳ luỵ/luồn cúi|a
卑微=hèn mọn/thấp kém/nhỏ bé/tầm thường/ti tiện/ti vi|a
卑怯=đê hèn/hèn nhát bỉ ổi|a
卑恭=nhún nhường dễ bảo/khiêm tốn ngoan ngoãn|a
卑贱=ti tiện/hèn mọn/thấp kém/đê hèn/thấp hèn|a
卑鄙=hèn hạ/đê tiện/bỉ ổi/tồi tệ/vô đạo đức/hèn mọn/quê mùa thô lậu/thấp hèn, bỉ lậu|a
卓异=hơn hẳn/hơn đời/hơn mọi người|a
卓然=lỗi lạc/trác việt/tài tình/nổi bật/xuất sắc/trác nhiên|a
卓着=rất cao|a
卓著=lớn lao/hết sức/tốt lắm/hay lắm/xuất sắc|a
卓见=cao kiến/kiến giải sáng suốt|a
卓远=trác viễn|a
单单=vẻn vẹn/chỉ riêng/chỉ cần/riêng/trơ trọi/chỉ một|a
单弱=yếu ớt/gầy yếu/ốm yếu/yếu/mỏng|a
单挑=đơn đấu/solo/một mình đấu|a
单看=chỉ nhìn|a
单纯=đơn thuần/đơn giản/không phức tạp/đơn nhất/chỉ|a
单练=luyện một mình/đơn luyện|a
单薄=đơn bạc/phong phanh/ít ỏi/yếu ớt/gầy yếu/yếu/mỏng/không vững|a
单足=một chân|a
单靠=chỉ dựa vào|a
卖俏=làm duyên làm dáng|a
卖惨=bán thảm/buôn than bán vãn/bán than|a
博大=bao la/rộng lớn rộng rãi/phong phú/rộng lớn/rộng rãi/bác đại|a
博杂=tạp nham|a
危困=nguy khốn|a
危急=nguy cấp/nguy ngập/hiểm nghèo|a
危殆=nguy ngập/nguy kịch/hết sức nguy hiểm|a
厉切=Lệ Thiết|a
厉喝=quát chói tai|a
厉害=lợi hại/kịch liệt/gay gắt|a
厉杀=lệ sát|a
厉气=lệ khí|a
厉老=Lệ lão|a
厉色=tàn khốc/vẻ mặt nghiêm nghị|a
厉行=nghiêm khắc thực hiện/thi hành nghiêm ngặt|a
厚厚=thật dày/dày đặc/hậu hậu/dày/thật dầy|a
厚实=dày đặc/chắc nịch/dày/bền/chắc/rắn chắc/uyên thâm/thâm hậu/hiền hậu/trung thực/hiền lành/phúc hậu/trung hậu/giàu có/phong phú/thật dầy|a
厚望=kỳ vọng cao/kỳ vọng rất lớn/niềm hi vọng/hậu vọng|a
厚爱=hậu ái/ưu ái/yêu mến/yêu thích/yêu thương tha thiết/yêu quý|a
厚薄=độ dày/dày mỏng/nặng nhẹ|a
厚足=chân sau|a
厚软=êm dày/dày và êm ái/dày và mềm mại|a
厚重=nặng nề/dày nặng/trọng hậu/rất nặng/trầm trọng/vừa dày vừa nặng/giàu/giàu có/phong phú/đôn hậu cẩn thận/đôn hậu nhưng thận trọng/dầy cộm nặng nề|a
原凉=hãy thứ cho|a
友善=thân mật/thân thiện/hữu thiện|a
友好=hữu hảo/bạn thân/bạn tốt/bạn bè/hữu nghị|a
友好度=độ thân thiện|a
友尽=hữu tận/kết thúc tình bạn|a
友爱=hữu ái/tình bạn bè/thân mật|a
反切=phiên thiết|a
发单=hoá đơn|a
发恼=tức giận|a
发愤=cố gắng/nỗ lực|a
发慌=hốt hoảng/hoảng sợ/phát hoảng|a
发暗=tái đi|a
发涩=cảm thấy chát/phát sáp/khàn khàn|a
发狂=phát cuồng/nổi giận/phát điên/hóa rồ/hoá rồ/nổi điên|a
发瘪=phát lạnh|a
发糕=bánh xốp/bánh bò|a
发紫=phát tím/tím bầm|a
发胖=béo phì/béo ra/phát phì/mập lên|a
发躁=bực|a
发软=như nhũn ra|a
发霉=mốc meo/mốc/lên mốc/nổi mốc|a
发飒=nổi đoá lên|a
古怪=cổ quái/kỳ dị/kỳ lạ/quái đản/gàn dở/lập dị/quái lạ|a
古拙=cổ sơ/cổ chuyết/cổ kính|a
古旧=cũ kỹ/cổ xưa/cũ rích/cổ|a
古朴=cổ phác/xưa cũ/phong cách cổ xưa/cổ điển|a
古松=cổ tùng|a
古稀=thất tuần/tuổi bảy mươi/cổ hi|a
可乐=Cocacola/khả nhạc/có thể vui mừng|a
可巧=khả xảo/vừa vặn/vừa tròn/vừa may/vừa khéo/vừa lúc|a
可怖=đáng sợ/khủng bố|a
可恼=đáng cáu/có thể khó chịu/làm trầm trọng thêm|a
可悲=đáng buồn/thật đáng buồn/thảm thương/thương hại/đáng thương|a
可惨=nhưng thảm/chắc thảm|a
可憎=đáng ghét/khó ưa/khả tăng|a
可柔=khả nhu|a
可欣=Khả Hân|a
可耻=đáng xấu hổ/đáng thẹn/hổ thẹn/ô danh/ngượng/xấu hổ|a
可观=khả quan/có thể nhìn/đáng xem/cao/lớn/to|a
可贵=đáng ngưỡng mộ/đáng quý/đáng phục/đáng ca tụng/đáng hâm mộ|a
可鄙=đáng khinh/đê tiện/bần tiện/đáng khinh bỉ|a
可钻=có thể chui|a
可雅=Kaya|a
可馨=Khả Hinh|a
吃劲=vất vả/mất sức/khó nhọc/lao lực|a
吃吃=ăn một chút/cật cật/ha ha|a
吃好=ăn được/ăn xong|a
吃惊=giật mình/chùn lại/hết hồn/sợ hãi/hoảng hốt|a
吃瘪=kinh ngạc/cật biết/ăn quả đắng|a
吃穷=ăn chết|a
吃腻=ăn ngán/chán ăn|a
吃苦=chịu khổ/đau khổ/chịu/khó khăn/chịu gian khổ|a
吃重=nặng nề/vất vả/gay go/gian khổ/khó khăn/căng thẳng/phí sức/tốn sức/trọng tải/tải trọng|a
各别=đều khác biệt/khác biệt/khác nhau/phân biệt/riêng biệt/tân kỳ/đặc biệt/lạ thường/kỳ cục/kỳ quặc/các biệt|a
各安=các an|a
各异=khác nhau|a
各显=các hiển|a
合同=hợp đồng/giao kèo|a
合宜=hợp/thích hợp/phù hợp/vừa vặn|a
合当=đáng|a
合眼=chợp mắt/ngủ/nhắm mắt/qua đời/chết/hợp nhãn|a
合著=đồng tác giả|a
合辛=Hoshin|a
合适=phù hợp/hợp/thích hợp/vừa/vừa vặn|a
名显=danh hiển|a
吝啬=keo kiệt/bủn xỉn|a
含悲=đau khổ trong lòng/ôm sầu/ngậm đau thương/đau đớn trong lòng/đau thương|a
含糊=mập mờ/hàm hồ/mơ hồ/không rõ ràng/lơ mơ/úp úp mở mở/ậm ờ/không biết rõ/cẩu thả/ẩu tả/không cẩn thận/qua loa/chịu/chịu thua|a
含羞=xấu hổ/ngượng ngùng/thẹn thùng/ngượng ngập/e lệ/e thẹn|a
呆傻=đần độn/ngu si/ngu đần/đần|a
呆滞=ngốc trệ/dại ra/ngớ ra/thừ ra/thừ người ra/đờ đẫn/đực ra/ứ đọng/đình trệ/tồn đọng/bán không chạy|a
呆笨=trì độn/đần độn/tối dạ|a
呛鼻=nhức mũi/nức mũi/sang tị|a
周和=Chu Hòa|a
和哉=Kazuya|a
和好=hòa hảo/cùng tốt|a
和婉=dịu dàng/nhỏ nhẹ/hoà nhã/ôn hoà|a
和畅=ấm áp dễ chịu/mát mẻ/hây hẩy|a
和缓=hòa hoãn/ôn hoà/lành/hoà hoãn/làm cho hoà hoãn/làm dịu/giảng hoà|a
和谐=hài hòa/hài hoà/dịu dàng/êm dịu/du dương/êm ái|a
哀乐=nhạc buồn/nhạc tang/nhạc mặc niệm|a
哀哉=ai tai|a
哀婉=thảm thiết/ai uyển|a
哀恳=khẩn khoản cầu xin|a
哀恸=đau buồn|a
哀愁=sầu bi/đau buồn/xót xa/rầu rĩ/buồn rầu/âu sầu/buồn phiền/buồn bã|a
哀痛=bi thương/bi ai/bi thống/đau buồn/sầu khổ/thương tiếc/âu sầu|a
哀矜=xót thương/thương xót/mũi lòng|a
哀老=ai lão|a
哀艳=lâm li/não nùng/thê lương|a
响亮=vang dội|a
响劲=hưởng kình|a
唯楚=Duy Sở|a
唯美=duy mỹ|a
善丽=Thiện Lệ|a
善名=thiện danh/Zenna|a
善后=giải quyết tốt hậu quả/khắc phục hậu quả/thiện hậu|a
善哉=thiện tai|a
善恶=thiện ác|a
善本=bản tốt nhất/bản trội nhất|a
善美=thiện mỹ|a
善良=thiện lương/lương thiện/hiền lành/tốt bụng|a
喜悦=vui sướng/vui thích/khoái trá|a
喜静=yêu thích yên tĩnh|a
嘈乱=hỗn loạn|a
嘈杂=ồn ào/ầm ĩ/huyên náo|a
嘴强=mạnh miệng|a
嘴快=lanh mồm lanh miệng/mau mồm mau miệng/mồm năm miệng mười/nhanh miệng|a
嘴拙=khó nói/chủy chuyết|a
嘴甜=nói ngọt/khéo nói/nói ngọt như mía lùi/miệng ngọt/dẻo mồm|a
嘴直=nói thẳng/chủy trực|a
嘴硬=mạnh miệng/cãi bướng/nói ngang/ăn nói ngang ngạnh|a
嘴稳=kín miệng/nói năng thận trọng|a
嘴笨=ăn nói vụng về/kém mồm kém miệng|a
嘴紧=thận trọng/kín kẽ/kín miệng|a
嘴贫=nói nhiều/ba hoa|a
嘴软=nhu nhược/mềm yếu|a
嘴阔=miệng rộng|a
嘴馋=thèm ăn/chủy sàm/thèm/muốn ăn|a
嘶哑=khàn giọng/khàn khàn|a
嘹亮=to rõ/lảnh lót/lanh lảnh/liệu lượng|a
嘹喨=Liệu lượng/véo von|a
嘹高=liệu cao/trong trẻo/thánh thót|a
噜嗦=nói nhiều|a
噜苏=lắm chuyện|a
噪杂=ầm ĩ/táo tạp/ồn ã|a
嚣张=phách lối/hung hăng càn quấy/kiêu ngạo/hung hăng càn quấy/hung hăng|a
嚣狂=điên cuồng|a
嚣闹=náo nhiệt|a
团名=tên đoàn|a
团建=xây dựng theo nhóm/xây dựng nhóm/Teambuilding|a
团练=đoàn luyện|a
团结=đoàn kết/hoà thuận/hữu nghị/hoà nhã|a
困倦=buồn ngủ/mệt mỏi|a
困惑=hoang mang/nghi hoặc/không biết xử trí thế nào/cảm thấy khó khăn/không biết làm thế nào/khốn hoặc|a
困惫=mệt mỏi|a
困窘=khốn quẫn/ngượng ngùng/khó xử/bối rối/lúng túng/ngượng nghịu/khốn cùng/quẫn bách/khốn khó/khó khăn|a
固体=thể rắn/cố thể|a
固守=cố thủ/phòng thủ kiên cố/khư khư/khăng khăng/cố giữ lấy/cố bám lấy/giữ đến cùng|a
固定=cố định/đứng yên/bất động/ổn định|a
固执=cố chấp/khư khư/khăng khăng/ngoan cố|a
固本=cố bổn|a
固穷=cố cùng|a
固结=cố kết/củng cố/đoàn kết/liên kết/biến thành thể rắn|a
固陋=kiến thức hạn hẹp/kiến thức nông cạn/nông cạn/hẹp hòi|a
圆全=hoàn hảo/tốt đẹp/chu đáo|a
圆寂=viên tịch/tịch|a
圆柔=viên nhu|a
圆滑=khéo đưa đẩy/tròn trịa/khôn khéo/trơn tru/viên hoạt|a
圆满=viên mãn/toàn vẹn/hoàn hảo/tốt đẹp/chu đáo|a
圆熟=thuần thục/thành thục/thành thạo/lão luyện/linh hoạt/viên thục|a
圆真=Viên Chân|a
圆缺=tròn khuyết|a
圣宠=thánh sủng|a
圣洁=thánh khiết/thiêng liêng/thần thánh/thánh thiện|a
均匀=đều đều/đều đặn/đều/bằng|a
均大=cùng đại|a
均称=quân xưng|a
均等=bình quân/bằng nhau/ngang nhau/đều nhau|a
均衡=cân đối/thăng bằng/ngang nhau/đều nhau/cân bằng/quân hành|a
坎坷=long đong/nhấp nhô/gập ghềnh/mấp mô/dằn xóc/trớ trêu/lận đận/khảm khả|a
坚固=kiên cố/chắc chắn/vững vàng/vững bền/vững chắc|a
坚定=kiên định/không dao động/kiên quyết/làm cho kiên định/giữ vững/củng cố|a
坚挺=cứng chắc/kiên đĩnh/kiên quyết/thẳng cứng/mạnh/cứng/chắc|a
坚毅=kiên nghị/dứt khoát/cứng rắn/vững vàng và có nghị lực|a
坚硬=cứng rắn/cứng/chắc/rắn/cứng chắc|a
坚致=rắn chắc|a
坚苦=chịu đựng gian khổ/lăn lộn gian khổ|a
坚贞=kiên trinh/kiên trung|a
坚韧=cứng cỏi/bền vững kiên cố/vững chắc/kiên trì/bền bỉ|a
坦缓=bằng phẳng|a
坦诚=thành khẩn/thẳng thắn/|a
基建=xây dựng cơ bản/xây cất|a
壮严=tráng nghiêm|a
壮丽=tráng lệ/lộng lẫy/đẹp đẽ/đồ sộ|a
壮健=tráng kiện/mạnh khoẻ/cường tráng|a
壮壮=tráng tráng/mạnh mẽ|a
壮大=lớn mạnh/tăng cường/phát triển/mở rộng/làm lớn mạnh/vạm vỡ/cường tráng to lớn|a
壮实=khỏe mạnh/mạnh khoẻ/vạm vỡ/chắc nịch/chắc khoẻ|a
壮心=chí lớn/ý chí/chí khí|a
壮悍=tráng hãn/cường tráng dũng mãnh|a
壮烈=oanh liệt/dũng cảm/lừng lẫy/tráng liệt|a
壮硕=cường tráng/khoẻ mạnh/sung sức/to con|a
壮观=hùng vĩ/tráng lệ/đồ sộ/nguy nga/cảnh hùng tráng/tráng quan|a
壮阔=bao la hùng vĩ/ào ạt/hùng vĩ/vĩ đại/to lớn/ồ ạt/tráng khoát/bao la|a
复兴=phục hưng/làm phục hưng/chấn hưng|a
复利=lãi gộp/lãi kép|a
复壮=phục tráng|a
复旧=khôi phục lại cái cũ/khôi phục nguyên trạng|a
复本=phúc bản/bản sao/bản sao lại/bản chép lại|a
复杂=phức tạp|a
复眼=mắt kép|a
复雜=phức tạp|a
多愁=đa sầu|a
多智=đa trí/thông minh/trí tuệ|a
多爽=sảng khoái hơn|a
多见=thấy nhiều/thấy nhiều/gặp nhiều|a
多贵=đắt cỡ nào/đắt quá|a
多足=nhiều chân|a
够亮=đủ sáng|a
够劲儿=quá sức/cừ thật/giỏi thật|a
够厚=đủ dày|a
够味=đủ vị/đủ hương vị/thông minh|a
够大=đủ lớn|a
够好=thật tốt/cú hảo/đủ tốt|a
够快=đủ nhanh|a
够戗=quá/dữ/quá sức/quá chừng|a
够数=đủ số/đủ|a
够本=đủ vốn/đủ/huề/bù vốn/hoà vốn/không thua không thắng/hoà|a
够狠=đủ hung ác/ngoan độc|a
够瞧的=quá sức/quá chừng/ghê thật/quá sức chịu đựng|a
够硬=đủ cứng/đủ cứng/rất cứng|a
够笨=ngốc nghếch/cú bản/đủ ngốc/đủ vốn|a
够紧=đủ chặt|a
够蠢=quá ngu|a
够足=đầy đủ|a
够重=đủ nặng|a
够高=đủ cao|a
大急=khẩn trương/sốt sắng|a
大恸=nỗi đau lớn|a
大敞=mở rộng|a
大显=đại hiển|a
大讶=thực sự kinh ngạc|a
太妙=thật là khéo/quá là khéo|a
太对=rất hợp/rất thích hợp/rất ăn ý/quá đúng/quá hợp|a
太弱=quá yếu|a
太快=quá nhanh|a
太怕=quá sợ|a
太急=quá gấp/quá mau|a
太慢=quá chậm|a
太挤=quá chật|a
太沉=quá nặng|a
太淡=quá nhạt|a
太狂=thật ngông cuồng/quá ngông cuồng|a
太狠=quá ác|a
太疼=quá đau|a
太穷=nghèo quá|a
太窄=quá chật|a
太胖=quá béo|a
太薄=quá mỏng|a
太蠢=quá ngu|a
太软=quá mềm/quá mềm yếu|a
夭矫=uốn cong nhưng có khí thế/yêu kiểu|a
失单=đơn cớ mất/giấy cớ mất/đơn khai mất đồ|a
失密=lộ bí mật|a
失常=thất thường|a
失慎=sơ ý/lơ là/không cẩn thận/sơ xuất/thiếu thận trọng/cháy|a
失效=mất đi hiệu lực/mất hiệu lực|a
失衡=mất cân bằng/mất thăng bằng|a
失要=thất yếu|a
头功=công đầu/đầu công/bằng khen hạng nhất|a
头大=nhức đầu/đau đầu|a
头热=nóng đầu|a
头疼=đau đầu/nhức đầu|a
奇功=kỳ công|a
奇厚=kỳ hậu/dầy mo|a
奇大=vô cùng lớn|a
奇好=kỳ hảo|a
奇妙=kỳ diệu/tinh xảo|a
奇寒=kỳ hàn|a
奇小=kỳ tiểu|a
奇崛=kiệt xuất|a
奇巧=tinh xảo/khéo léo/kỳ xảo|a
奇异=kỳ dị/kỳ quái/quái lạ/lạ lẫm/kỳ lạ|a
奇效=kỳ hiệu|a
奇痒=ngứa lạ|a
奇稳=kỳ ổn|a
奇缺=rất thiếu|a
奇臭=hôi thối|a
奇观=kỳ quan/hiện tượng lạ|a
奇贵=cực đắt|a
奢侈=xa xỉ/xa phí|a
奢华=xa hoa/xa xỉ phung phí|a
奢望=hi vọng xa vời/tham vọng quá đáng/ước mong quá cao/xa vọng/mong mỏi thái quá|a
奢靡=xa hoa lãng phí/phung phí/xa mỹ|a
奸乱=dâm loạn|a
奸恶=gian ác/gian trá độc ác|a
奸猾=gian xảo/gian hoạt|a
奸细=gian tế/mật thám/do thám|a
奸诈=gian trá/gian giảo/gian xảo dối trá|a
奸邪=gian tà/nham hiểm/kẻ gian tà|a
好亮=thật sáng/thật là sáng|a
好俊=thật tuấn/Tuấn|a
好凉=thật mát|a
好劲=thật mạnh|a
好困=buồn ngủ quá/hảo khốn|a
好大=thật lớn/thật là lớn|a
好奇=hiếu kì/tò mò/ham thích điều lạ|a
好好看=xem thật kỹ|a
好嫩=thật mềm|a
好富=thật giàu|a
好巧=thật là đúng dịp|a
好康=tốt|a
好急=thật gấp|a
好恶=yêu ghét/thích và ghét/sở thích/thật là ác|a
好惨=thật thê thảm|a
好景不常=hảo cảnh bất thường|a
好景不长=tiệc vui chóng tàn/ngày vui ngắn chẳng tầy gang/điều tốt đẹp không tồn tại mãi|a
好暗=thật tối|a
好松=thật xốp|a
好武=thích võ/tốt võ|a
好淡=hơi lạt/cay quá|a
好烈=thật mạnh|a
好烦=thật là phiền|a
好熟=rất quen thuộc/thật quen thuộc|a
好爱=thật yêu|a
好爽=sảng khoái/thật là thoải mái|a
好狂=thật cuồng|a
好猛=thật mạnh mẽ/thật là mạnh|a
好甜=rất ngọt|a
好硬=quá cứng/cứng quá/thật là cứng|a
好笨=đần quá|a
好蠢=thật xuẩn|a
好贱=hảo tiện|a
好贵=rất đắt/thật là đắt|a
好软=thật mềm/thật là mềm|a
好酷=cực giỏi|a
好鲜=thật tươi|a
妍丽=Nghiên Lệ|a
妍妍=Nghiên Nghiên|a
妖娆=xinh đẹp/diêm dúa loè loẹt|a
妖媚=yêu mị/người con gái lẳng lơ/người con gái không đứng đắn|a
妖艳=yêu diễm/đẹp đẽ/đẹp đẻ/diêm dúa loè loẹt|a
妥妥=thoả thoả/thỏa đáng|a
妥定=thỏa định|a
妥帖=thoả đáng/thích hợp|a
妥当=thỏa đáng/thoả đáng/ổn thoả|a
妩媚=vũ mị/quyến rũ/dễ thương/xinh tươi|a
委婉=uyển chuyển/dịu dàng/khéo léo/ngọt ngào|a
委琐=vụn vặt/câu nệ tiểu tiết/tầm thường|a
委靡=ủ rủ/ủ rũ/uỷ mị/ủ ê|a
威严=uy nghiêm/oai phong/uy phong|a
威名=uy danh/oai danh|a
威猛=uy mãnh|a
娇丽=diễm lệ/tươi đẹp|a
娇体=kiều thể/thân thể yêu kiều|a
娇俏=xinh xắn/đáng yêu/xinh đẹp/thanh tú/kiều tiếu|a
娇傲=kiều ngạo/kiêu ngạo|a
娇喝=khẽ kêu/khẽ kêu|a
娇好=nhu mì xinh đẹp|a
娇娆=xinh đẹp/thanh mảnh/mảnh mai/mềm mại/đẹp đẽ|a
娇媚=kiều mị/nũng nịu/nhõng nhẽo/đẹp đẽ/nhu mì|a
娇嫩=kiều nộn/mềm mại/yếu ớt/ẻo lả|a
娇宠=nuông chiều/chiều chuộng|a
娇小=nhỏ nhắn xinh xắn/xinh xắn/xinh xẻo/thon nhỏ/kiều tiểu|a
娇弱=mảnh mai/yểu điệu/kiều nhược|a
娇憨=hồn nhiên/ngây thơ/kiều hàm|a
娇柔=mềm mại/nhu mì/điềm đạm|a
娇气=yếu ớt/mỏng manh/duyên dáng/thanh nhã/thanh tao/thanh tú|a
娇泼=ngang tàng/khí thế - yêu kiều/mềm mại/đáng yêu/làm nũng/nhõng nhẽo|a
娇美=xinh đẹp/diễm lệ/tươi đẹp|a
娇羞=thẹn thùng/e thẹn|a
娇脆=mềm giòn dễ vỡ|a
娇艳=kiều diễm/tươi đẹp/xinh tươi|a
娇蛮=ngang ngược/kiều man|a
娇贵=dễ hỏng/chiều chuộng/nuông chiều/yêu chiều/cưng chiều/dễ hư/yêu kiều|a
娇软=kiều nhuyễn|a
娟儿=Quyên nhi|a
娟姐=Quyên tỷ|a
娟子=Quyên Tử|a
娟容=Quyên Dung|a
娟秀=xinh đẹp/đẹp/đẹp đẽ/tú lệ/quyên tú|a
娟透=quyên thấu|a
娴儿=Nhàn nhi|a
娴慧=nhàn tuệ|a
娴熟=thành thạo/thông thạo/nhàn thục|a
娴雅=thanh tao lịch sự/nhã nhặn/thanh nhã|a
娴静=nhã nhặn/nhã nhặn lịch sự/nhã nhặn trầm tĩnh|a
婀娜=thướt tha/tha thướt|a
婉君=Uyển Quân|a
婉婉=Uyển Uyển|a
婉贞=Uyển Trinh|a
婉馨=Uyển Hinh|a
媚功=mị công|a
媚外=theo đuôi nước ngoài/nịnh hót nước ngoài/bám gót nước ngoài|a
媚媚=Mị Mị|a
媚惑=mị hoặc/mê hoặc quyến rũ|a
媚笑=mị tiếu/cười mà quyến rũ/cười - quyến rũ/xinh đẹp/nịnh hót/nịnh bợ/cười quyến rũ|a
孤傲=cao ngạo/cô độc và kiêu ngạo/ngạo mạn|a
孤僻=quái gở/cô độc/lầm lì/cô tịch/đều là cái ý nghĩa không cùng hòa hợp với chúng cả|a
孤单=cô đơn/lẻ loi/trơ trọi/bơ vơ/cô độc/yếu/mỏng|a
孤寂=cô tịch/vắng vẻ/hiu quạnh|a
孤寒=cô hàn/ki bo|a
孤弱=ốm yếu/yếu ớt/mồ côi/trẻ mồ côi/người cô độc|a
孤本=bản độc nhất/bản đơn lẻ|a
孤独=cô độc/cô đơn/lẻ loi/trơ trọi|a
孤老=tuổi già cô đơn/tuổi già cô độc/người già cô đơn/người già cô độc|a
孤苦=cơ khổ/bơ vơ/cô khổ|a
孤陋=ngu dốt/dốt nát/nông cạn|a
孤高=cao ngạo/kiêu ngạo/xa rời quần chúng|a
孱头=thằng ẻo ọt/đồ bất tài yếu đuối|a
孱弱=yếu đuối/gầy yếu/yếu đuối bất lực/mỏng yếu/không đầy đủ|a
宁缺=Ninh Khuyết|a
守拙=thủ chuyết/giữ vụng về/vẫn trung thực và nghèo|a
安好=mạnh khỏe/bình an/bình yên|a
安妥=thanh thản/bớt căng thẳng|a
安沛=Yên Bái/tỉnh Yên Bái|a
安稳=an ổn/vững/vững chắc/an toàn/chắc chắn/trầm tĩnh/vững vàng/điềm tĩnh/bình thản/bình tĩnh/yên lặng/tĩnh mịch/yên tĩnh|a
安贫=an bần/an phận nghèo|a
安适=yên tĩnh/yên tĩnh thoải mái/ấm áp/ấm cúng/thoải mái/dễ chịu|a
完好=hoàn hảo/vẹn toàn/tốt đẹp|a
完小=xong tiểu/tiểu học toàn cấp|a
完整=hoàn chỉnh/nguyên vẹn/đầy đủ/toàn vẹn|a
完本=hoàn thành/bản hoàn tất/hoàn bổn|a
完美=hoàn mỹ/tốt đẹp hoàn toàn|a
宏丽=hùng vĩ đẹp đẽ/tráng lệ|a
宏亮=vang dội/hoành lượng|a
宏伟=to lớn/hùng vĩ/hào hùng/vĩ đại|a
宏偉=to lớn/hùng vĩ|a
宏大=hùng vĩ/to/to lớn/lớn lao/vĩ đại/hoành đại|a
宏扬=phát huy/tăng cường|a
宏远=Hồng Viễn|a
宏阔=to và rộng/to lớn|a
审慎=thận trọng/cẩn thận/kĩ lưỡng|a
客动=phát động|a
客满=đầy ngập khách|a
害惨=hại thảm|a
害燥=hại táo|a
害羞=xấu hổ/thẹn thùng/ngượng ngùng/thẹn thò/bẽn lẽn/e lệ/mắc cỡ|a
害臊=e lệ/xấu hổ/thẹn thùng/ngượng ngùng/hại tao|a
容受=dung nạp/chịu đựng|a
容忍=khoan dung/tha thứ/dễ dàng tha thứ/khoan nhượng|a
容情=khoan dung/tha thứ/độ lượng|a
容易=dễ dàng/dễ/có thể|a
容秀=Dung Tú|a
容错=dung sai|a
容静=dung tĩnh|a
宽余=thư thái/thư thả/thanh thản/thong dong/dư dả/dư dật/khá giả/sung túc|a
宽厚=khoan hậu/dày rộng/hồn hậu/nở nang/rộng lượng/khoan hồng/độ lượng/đại lượng/nhân hậu/hiền hậu/khoan dung/mộc mạc/chất phác|a
宽和=khoan dung/rộng rãi/rộng lượng|a
宽大=rộng lớn/rộng thùng thình/rộng/rộng lượng/khoan dung/khoan hồng|a
宽宏=khoan dung độ lượng/khoan hồng/khoan dung|a
宽容=khoan dung/tha thứ|a
宽广=rộng lớn/rộng/bao la/mênh mông/rộng rãi|a
宽心=giải sầu/giải phiền/tiêu sầu/bớt buồn/khoan tâm|a
宽怀=rộng lượng|a
宽慰=trấn an/an ủi/khuyên giải|a
宽敝=rộng rãi|a
宽敞=rộng rãi/rộng mở/rộng lớn|a
宽旷=rộng rãi/trống trải/mênh mông|a
宽松=rộng rãi/rộng thùng thình/rộng/bớt đông/bớt chật/thư thản/thanh thản/thư thái/thả lỏng/buông lỏng/buông xuôi/giàu có/dư dả/to|a
宽泛=rộng rãi/rộng/bao la/mênh mông|a
宽润=trơn rộng/trơn bóng rộng rãi|a
宽畅=cởi mở/thoải mái/xởi lởi|a
宽窄=rộng hẹp/bề rộng/bề ngang/khổ|a
宽绰=rộng rãi/thoáng/thư thái/thanh thản/nhẹ nhàng/giàu có/dư dả|a
宽舒=thư thái/thanh thản/thong dong/ung dung/thênh thang|a
宽裕=dư dả/khá giả/sung túc/dư dật/thoải mái/rộng rãi|a
宽达=rộng chừng|a
宽阔=rộng lớn/rộng/rộng rãi/phóng khoáng/không bị gò bó|a
宽限=thư thả/gia hạn/nới/nới rộng hạn định|a
宽饶=khoan thứ/tha thứ/khoan dung|a
寂寂=vắng vẻ/yên lặng/yên tĩnh|a
寂寞=tịch mịch/cô đơn lạnh lẽo/cô quạnh/vắng lặng/trống vắng/yên tĩnh/hiu quạnh/Tịch mịch/yên lặng|a
寂杀=Tịch Sát|a
寂渺=Tịch Miểu|a
寂火=Tịch Hỏa|a
寂然=vắng lặng/yên lặng/im lìm/lặng yên|a
寂静=yên tĩnh/vắng vẻ/trống trải/yên lặng|a
寂默=vắng vẻ/yên lặng/yên tĩnh|a
密秘=bí mật|a
密致=kết cấu chặt|a
密要=mật yếu|a
富余=có dư/dư/dư dật/thừa thãi/thừa/nhiều/phú dư|a
富厚=phú hậu/sung túc/giàu có|a
富实=giàu có/sung túc|a
富庶=giàu có/giàu có và đông đúc|a
富裕=giàu có/dồi dào/sung túc/làm cho giàu có|a
富贵=phú quý/giàu sang|a
富足=giàu có/đầy đủ sung túc/phong phú sung túc/phú túc|a
富饶=màu mỡ/dồi dào/giàu/giàu có|a
寒伤=hàn thương|a
寒似=lạnh như|a
寒傲=hàn ngạo|a
寒冷=rét lạnh/hàn lãnh/lạnh/lạnh lẽo/rét mướt/lạnh giá/giá rét|a
寒凉=lạnh|a
寒功=hàn công|a
寒劲=hàn kình|a
寒峭=lạnh ghê người/khí lạnh ghê người/rét căm căm|a
寒幽=Hàn U|a
寒微=hàn vi/bần hàn/nghèo/nghèo hèn|a
寒松=hàn tùng|a
寒湿=lạnh lẽo ẩm ướt|a
寒热=nóng lạnh/sốt rét/sốt/phát sốt/hàn nhiệt|a
寒笑=cười lạnh|a
寒苦=nghèo khổ/nghèo túng/bần hàn/nghèo khó|a
寒薄=hàn bạc|a
寒重=thật rét|a
寡淡=nhạt nhẽo/tẻ nhạt|a
寡陋=kiến thức nông cạn/thiển cận|a
对劲=thích hợp/thoải mái/vừa ý/hợp/ăn ý/hợp ý/ăn khớp/vừa tay/khớp|a
对等=ngang nhau/ngang hàng/đồng đẳng/cùng địa vị cấp bậc và địa vị ngang nhau|a
寻常=bình thường/tầm thường|a
封严=Phong Nghiêm|a
封善=Phong Thiện|a
封困=phong khốn/vây nhốt|a
封套=phong bì/giấy bọc/vỏ bọc|a
封建=phong kiến/chế độ phong kiến/cổ hủ/lạc hậu/bảo thủ|a
尊严=tôn nghiêm/danh dự/trang trọng/uy nghiêm|a
尊老=tôn lão/Tôn lão|a
尊贵=tôn quý/cao quý|a
尊重=tôn trọng/tôn kính/nghiêm túc/xem trọng/trang trọng|a
小爆=tiểu bạo|a
少壮=trẻ trung/trai trẻ/thiếu tráng|a
少活=sống ít đi/ít sống|a
少煌=Thiếu Hoàng|a
少要=ít đi/ít phải|a
尖亢=cao nhọn|a
尖促=chói tai|a
尖俏=tiêm tiếu/sắc nét|a
尖冷=lạnh thấu xương/lạnh buốt|a
尖利=sắc nhọn/sắc/sắc bén/tinh/bén nhọn|a
尖刻=chua ngoa/gay gắt/khắt khe/khắc nghiệt|a
尖削=nhọn/đỉnh nhọn/đầu nhọn|a
尖厉=sắc lạnh, the thé/tiêm lệ/sắc nhọn|a
尖嫩=lảnh lót dịu dàng|a
尖峭=nhọn đứng|a
尖挺=cao nhọn|a
尖新=mới/mới mẻ|a
尖着=tiêm|a
尖硬=cứng nhọn|a
尖窄=hẹp nhọn/nhọn và hẹp|a
尖笑=cười the thé|a
尖细=lanh lảnh/chói tai/tiêm tế|a
尖钻=dùi nhọn|a
尖锐=bén nhọn/sắc bén/sắc nhọn/bén/sâu sắc/sắc sảo/chói tai/kịch liệt/gay gắt|a
尴尬=xấu hổ/lúng túng|a
尷尬=ngượng ngùng/xấu hổ/tôi|a
峻峭=núi cao dốc đứng/vách núi cheo leo|a
峻急=nước chảy xiết/nghiêm khắc/nghiệt ngã|a
崎岖=gập ghềnh/gồ ghề/khúc khuỷu|a
工稳=thoả đáng/thích hợp/đắc/chỉnh|a
巧劲=xảo kình|a
巧妙=xảo diệu/tài tình/khéo léo|a
巧舌=khua môi múa mép|a
巧足=xảo chân|a
巨喝=hét lớn|a
巨大=to lớn/cực lớn/thật lớn/vĩ đại/thật to|a
巨富=cự phú|a
巨怪=cự quái|a
巨狠=cự lang|a
巨疼=cơn đau/thật đau|a
巨痛=đau đớn|a
巨眼=cự nhãn/mắt thật to|a
巨着=cự trứ|a
巨硬=to cứng|a
巨粗=thô to|a
巨细=chi tiết/lớn nhỏ/việc to việc nhỏ|a
巨脸=gương mặt khổng lồ|a
巨著=tác phẩm lớn/kiệt tác/trước tác/kiệt tác/cự trứ/một tác phẩm khổng lồ|a
巨行=cự hành|a
巨足=cự túc/chân lớn|a
帅富=đẹp trai giàu có|a
帅级=Soái cấp|a
常乐=thường nhạc|a
常套=kiểu cũ/kiểu cổ truyền/kiểu thường dùng|a
常康=Thường Khang|a
常见=phổ biến/thường thấy/thông thường/chung/tự nhiên/thiên tính/tầm thường/thông tục/thường gặp|a
干冷=khô lạnh/lạnh và khô ráo/khô hanh/hanh khô|a
干净=sạch sẽ/sạch/sạch gọn/lôi thôi/dài dòng/rườm rà/hết sạch/sạch sành sanh/sạch sẽ|a
干劲=nhiệt tình/lòng hăng hái/tinh thần hăng hái/năng nổ/cứng mạnh|a
干哑=khô khàn|a
干急=nóng ruột/sốt ruột|a
干旱=khô hạn/hạn hán|a
干松=khô/khô xốp|a
干活=làm việc/lao động|a
干涩=khô khốc/khô/khô khan/không mượt mà/khản/khàn/gượng gạo/gượng/sượng/ngượng|a
干烈=khô liệt|a
干燥=khô ráo/khô/hanh/khô hanh/khô khan/chán/không thú vị/kém thú vị|a
干爽=khô mát/khô/khô ráo/khô xốp|a
干甚=làm cái gì|a
干痛=khô đau|a
干瘦=gầy còm/gầy/gầy đét/gầy nhom/gầy giơ xương/khô gầy/gầy gò|a
干瘪=khô quắt/khô đét/héo/teo lại/khô xác/khô khan/nhạt nhẽo/tẻ ngắt/khẳng kheo|a
干硬=khô cứng/khô rắn|a
干练=già dặn/giỏi giang/giàu kinh nghiệm/lão luyện/kiền luyện|a
干躁=khô ráp|a
干重=trọng lượng khô/trọng lượng ròng|a
干静=kiền tĩnh|a
平乐=bình nhạc|a
平乱=bình loạn|a
平允=công bằng/thoả đáng/vừa phải/bình duẫn/xử đoán phải chăng|a
平凡=bình thường/thông thường/tầm thường|a
平动=tịnh tiến/vận động tịnh tiến|a
平和=bình thản/ôn hoà/hoà nhã/nhã nhặn/ngừng quấy rối/ôn hòa|a
平均=bình quân/chia đều/trung bình/đổ đồng/đều/đồng đều|a
平坦=bằng phẳng/bằng/phẳng/bình thản|a
平妥=thoả đáng/hợp lý/ổn thoả|a
平安=bình an/bình yên/yên ổn|a
平定=bình định/ĐỊNH/ổn định/yên ổn/dẹp yên/Bình Định/tỉnh Bình Định|a
平实=thật thà/chất phác|a
平寂=bình tĩnh|a
平常=bình thường/giản dị/ngày thường|a
平平=thường thường/bình thường/không đáng kể/trung bình|a
平康=Bình Khang|a
平庸=bình thường/tầm thường/xoàng/không có gì nổi bật/không có gì đặc sắc|a
平恶=dẹp loạn cái ác|a
平整=bằng phẳng/vuông vức/hình thành/san bằng/san phẳng/bừa đất|a
平旷=bằng phẳng|a
平明=vừa sáng/bình minh|a
平易=bình dị/khiêm tốn/ôn hoà/giản dị/dễ hiểu/mộc mạc dễ hiểu/bình dịch|a
平服=phục tùng/phục/ổn định|a
平淡=bình thản/bình thường/vô vị/nhạt nhẽo/tầm thường|a
平滑=trơn nhẵn/phẳng lì/bằng phẳng nhẵn nhụi|a
平白=không duyên cớ/bỗng dưng/tự nhiên/bình bạch|a
平直=bằng phẳng/thẳng/cấp độ|a
平福=Bình Phước/tỉnh Bình Phước|a
平稳=bình ổn/vững vàng/ổn định/yên tĩnh/bình an/vững chãi|a
平穩=vững vàng|a
平等=bình đẳng/ngang hàng/công bằng/bình quyền/bằng đẳng|a
平级=cùng cấp/cùng cấp bậc|a
平缓=nhẹ nhàng/bằng phẳng/êm dịu/ôn hoà/thong thả/ôn hòa|a
平老=Bình lão|a
平衡=cân bằng/cân đối/thăng bằng|a
平足=bàn chân bẹt|a
平远=Bình Viễn|a
平静=bình tĩnh/yên lặng/yên ổn/yên bình/yên ả|a
平靜=bình tĩnh/phẳng|a
平齐=ngang bằng|a
年满=tuổi tròn|a
年轻=trẻ tuổi/tuổi trẻ/tuổi còn trẻ/thanh niên|a
年迈=cao tuổi/tuổi già/lớn tuổi|a
幸喜=may mà/may mắn|a
幸奋=hạnh phấn|a
幸好=may mắn/may là/may mà/thật may là|a
幸甚=hi vọng/thật là may mắn|a
幸福=hạnh phúc/vừa lòng đẹp ý|a
幸运=may mắn/vận may/dịp may/vừa lòng đẹp ý/thoả lòng vừa ý|a
幸进=hãnh tiến|a
幼功=công phu luyện tập lúc còn trẻ|a
幼嫩=non nớt/ấu nộn|a
幼弱=ấu nhược|a
幼稚=ngây thơ/ấu trĩ/còn nhỏ/non nớt|a
幽亮=u lượng|a
幽冥=U Minh|a
幽净=u tịnh|a
幽华=U Hoa|a
幽婉=gãy gọn/sâu xa/sâu sắc/hàm ý sâu xa mà rành mạch|a
幽寂=tịch mịch/vắng vẻ/yên tĩnh/u tịch|a
幽微=yếu ớt/thoang thoảng/phản phất/thâm thuý tinh vi/sâu xa/sâu sắc|a
幽怨=u oán/nỗi hận thầm kín/nỗi oán hận trong lòng|a
幽愤=nỗi căm giận trong lòng/nỗi oán hận trong lòng|a
幽明=u minh/âm ty và trần gian/âm phủ và dương gian|a
幽暗=u ám/âm u/tối tăm/u tối|a
幽浮=U Phù|a
幽深=tĩnh mịch/sâu thẳm/u thâm|a
幽紫=u tử|a
幽美=u nhã/u nhã đẹp đẽ/u mỹ|a
幽趣=thú vị/vui thích/sự hứng thú u nhã|a
幽远=sâu thẳm/tịch mịch/u viễn|a
幽邃=sâu thẳm/tĩnh mịch|a
幽闲=thong dong/thuỳ mị/dịu dàng/nhàn nhã/u nhàn|a
幽雅=u nhã/êm ả/thanh nhã|a
幽静=u tĩnh/tĩnh mịch/vắng vẻ/u nhã tĩnh mịch|a
幽默=hài hước/ẩn dấu/hóm hỉnh/dí dỏm|a
广大=rộng rãi/quảng đại/rộng/rộng lớn/to lớn/nhiều/đông/đông đảo|a
广松=Quảng Tùng|a
广泛=rộng khắp/đông đảo/phổ biến/rộng rãi|a
广瀚=rộng lớn|a
广袤=rộng lớn/diện tích/rộng dài/chiều dài và chiều rộng/mênh mông|a
广远=rộng lớn bao la/mênh mông/rộng rãi/sâu rộng|a
广阔=rộng lớn/trống trải/khoáng đạt/rộng/rộng rãi/bát ngát/bao la/mênh mông|a
庄严=trang nghiêm/trang trọng nghiêm túc/nghiêm trang|a
庄重=trang trọng/trang nghiêm|a
庞大=khổng lồ/to lớn/to/lớn/bự|a
庞杂=bề bộn/ngổn ngang/kềnh càng/rối ren/bàng tạp|a
庞然=to lớn/bàng nhiên|a
庸俗=dung tục/tục tằng/tầm thường/thấp hèn|a
庸劣=dong liệt/hèn kém|a
庸庸=xoàng xĩnh|a
庸懒=lời nói thường|a
庸碌=tầm thường/xoàng xĩnh/dung lục/hèn hạ|a
庸肿=dong thũng|a
庸行=dong hành/sự làm thường|a
廉洁=liêm khiết/trong sạch|a
廉耻=liêm sỉ|a
开套=khai sáo|a
开豁=rộng rãi/thoải mái/dễ chịu/phóng khoáng/tấm lòng rộng mở/thoáng đãng/phấn khởi|a
异动=dị động|a
异同=dị đồng/khác nhau/chỗ giống nhau và chỗ khác nhau/ý kiến khác nhau|a
异彩=dị sắc/tia sáng kỳ dị/thành tựu xuất sắc/dị thải|a
异见=dị kiến|a
异趣=không cùng chí hướng/sở thích khác người|a
弛懈=lơi lỏng|a
弛缓=dịu lại/lắng lại/xẹp xuống|a
弱弱=yếu ớt|a
强似=hơn/vượt|a
强健=cường kiện/cường tráng/khoẻ mạnh/lực lưỡng/tráng kiện|a
强劲=mạnh mẽ/mạnh/mạnh mẽ|a
强固=kiên cố/vững chắc|a
强壮=cường tráng/khoẻ mạnh/rắn chắc|a
强大=cường đại/lớn mạnh/mạnh mẽ/hùng mạnh|a
强弱=mạnh yếu|a
强忍=cố nén|a
强悍=cường hãn/dũng mãnh/dũng cảm/quả quyết|a
强憾=cường hám|a
强效=cường hiệu|a
强暴=cường bạo/hung bạo/hung dữ/thế lực hung bạo/thế lực hung tàn|a
强横=cường hoành/mạnh mẽ/ngang ngược/ngang tàng/ngang ngạnh/ngỗ ngược/mạnh mẽ|a
强烈=mãnh liệt/cường liệt/mạnh mẽ/rõ ràng/sáng sủa|a
强猛=mạnh mẽ/mạnh mẽ|a
强盛=cường thịnh/hùng mạnh/thịnh vượng|a
强硬=cường ngạnh/cứng rắn/cương quyết/kịch liệt|a
强良=Cường Lương|a
强蛮=mạnh mẽ|a
强迫=ép buộc/bắt buộc/cưỡng bức/cưỡng bách/cưỡng ép|a
强韧=bền bỉ/kiên cường dẻo dai/cường nhận|a
彪壮=khoẻ mạnh/vạm vỡ/lực lưỡng|a
彪悍=bưu hãn/dũng mãnh/dũng cảm/anh dũng/hung hãn|a
很乐=rất thích|a
很乱=rất loạn|a
很亮=rất sáng|a
很亲=rất thân|a
很伤=rất đau đớn|a
很低=rất thấp|a
很值=rất đáng|a
很假=rất giả dối|a
很傻=rất ngu ngốc/rất ngốc/rất ngu|a
很全=rất đủ|a
很冷=rất lạnh|a
很净=rất sạch sẽ/rất sạch sẽ|a
很凉=thật lạnh|a
很利=rất sắc bén|a
很厚=rất dày/rất dầy|a
很受=rất thụ/rất được|a
很和=rất hợp|a
很圆=rất tròn|a
很大=rất lớn|a
很好懂=rất dễ hiểu|a
很妙=rất là khéo|a
很嫩=rất non|a
很富=rất giàu|a
很小=rất nhỏ|a
很差=rất kém cỏi/cực kém|a
很平=rất phẳng|a
很广=rất rộng|a
很废=rất phế/rất lởm|a
很弱=rất yếu|a
很强=rất mạnh|a
很得劲=rất thoải mái|a
很急=rất gấp|a
很恨=rất hận|a
很懂=rất hiểu/hiểu lắm|a
很懒=rất lười|a
很挤=rất chen chúc|a
很挺=rất kiệt xuất/rất cao|a
很棒=rất tuyệt/rất giỏi|a
很气=rất giận|a
很沉=rất nặng/rất trầm|a
很浅=rất nhạt/rất cạn|a
很浪=rất lãng|a
很淡=rất nhạt|a
很滑=rất trơn|a
很满=rất vẹn toàn|a
很火=rất hỏa/rất giận|a
很烂=rất dở|a
很热=rất nóng|a
很熟=rất quen/rất thuộc/quen/rất quen thuộc|a
很爱=rất thích/rất yêu|a
很狂=rất ngông cuồng|a
很猛=rất mạnh|a
很甜=rất ngọt|a
很疼=rất đau/rất thương|a
很痛=rất đau|a
很瘦=rất gầy|a
很白=rất trắng|a
很短=rất ngắn|a
很矮=rất thấp|a
很硬=rất cứng/thực cứng|a
很累=rất mệt mỏi/mệt chết đi/rất mệt a/rất mệt|a
很细=rất nhỏ|a
很老=rất già|a
很胖=rất mập/ rất béo/rất béo|a
很脏=rất bẩn/rất dơ|a
很臭=rất thúi/rất hôi thối|a
很薄=rất mỏng|a
很蠢=rất ngu ngốc/rất ngu|a
很象=rất giống|a
很贱=rất tiện/ti tiện|a
很贵=rất đắt|a
很足=rất đủ|a
很辣=rất cay|a
很配=rất xứng đôi|a
很重=rất nặng|a
很长=rất dài/lâu|a
很静=rất yên tĩnh|a
很飘=rất phiêu|a
很香=rất thơm|a
很高=rất cao|a
得体=vừa vặn/khéo/khéo léo/xác đáng/thoả đáng/đúng mức/đắc thể|a
得急=phải gấp|a
得由=phải do|a
微亮=hơi sáng/mờ sáng|a
微冷=lạnh lùng|a
微厚=hơi dầy|a
微妙=vi diệu/tế nhị/tinh xảo/nhỏ bé/khéo léo/tinh tế màu nhiệm không thể nghĩ bàn được|a
微安=mi-crô am-pe/micrô ampe|a
微张=khẽ nhếch|a
微弱=yếu ớt/mỏng manh/nhỏ yếu/nhỏ mọn/nhỏ nhoi|a
微急=hơi gấp|a
微惧=hơi sợ|a
微效=vi hiệu|a
微明=không rõ/mờ|a
微显=hơi lộ/lộ vẻ|a
微松=khẽ buông lỏng/nhẹ nhõm|a
微浊=hơi đục|a
微渺=vi miểu/bé nhỏ|a
微疼=hơi đau|a
微瘦=hơi gầy|a
微矮=hơi lùn|a
微硬=hơi cứng|a
微细=nhỏ bé/nhỏ nhặt/nhỏ xíu/cực nhỏ|a
微羞=hơi ngại ngùng|a
微胖=hơi mập|a
微薄=ít ỏi/thiếu/nhỏ bé/mỏng manh/hơi mỏng|a
微诧=hơi kinh ngạc/hơi ngạc nhiên|a
微贱=nghèo hèn/hàn vi/hèn mọn/hèn hạ|a
微软=hơi mềm/Microsoft|a
心切=sốt ruột/nóng lòng/trong lòng cảm thấy bức thiết/tâm thiết|a
心劲=suy nghĩ/ý nghĩ/năng lực suy nghĩ phân tích/sức nghĩ|a
心同=tâm đồng|a
心好=tâm thật/tâm tính thiện lương|a
心急=nóng vội/nóng ruột/sốt ruột/nóng lòng sốt ruột/nóng lòng|a
心悲=tâm bi|a
心惊=kinh hãi/hoảng sợ|a
心慌=hoảng hốt/hoảng sợ/sợ sệt/tim đập mạnh và loạn nhịp/tâm hoảng|a
心烦=tâm phiền/phiền muộn trong lòng/phiền lòng/bực dọc|a
心狠=lòng dạ ác độc/tâm ngoan|a
心疼=đau lòng/yêu thương/thương/không nỡ/tiếc|a
心痒=lòng ngứa ngáy|a
心盛=nhiệt tình/hăng hái|a
心硬=vững tâm/lòng dạ sắt đá|a
心窄=bụng dạ hẹp hòi|a
心细=thận trọng/kỹ tính/cẩn thận|a
心软=mềm lòng/nhẹ dạ|a
心闷=tâm muộn|a
心静=lòng yên tĩnh/tĩnh tâm/tâm tĩnh|a
必异=tất dị|a
忐忑=thấp thỏm/tâm thần bất định/không yên/lo lắng không yên/tâm thần bất định/thấp thỏm không yên|a
忙乱=rối ren/lộn xộn/mang loạn|a
忙活=bận rộn/bận việc/bận làm ăn/việc gấp|a
忙碌=bận rộn/bận bịu|a
忠勇=trung dũng/trung thành dũng cảm|a
忠厚=trung hậu|a
忠孝=trung hiếu|a
忠实=trung thực/trung thành/trung thành đáng tin/chân thực/chân thành|a
忠烈=trung liệt/người trung liệt|a
忠直=trung trực|a
忠良=trung lương/trung thực thẳng thắn/người trung thành thẳng thắn/người trung lương|a
忠诚=trung thành/tận tâm/tận tâm tận lực|a
忠顺=một lòng nghe theo/ngoan ngoãn/trung thành|a
忧劳=âu sầu/ưu lao / âu sầu|a
忧心=lo lắng/lo âu/nỗi lo/nỗi buồn/ưu tâm|a
忧思=ưu tư/suy nghĩ ưu sầu/ý nghĩ lo lắng|a
忧悒=lo lắng không yên/buồn bực lo lắng|a
忧惧=lo sợ|a
忧愁=ưu sầu/buồn lo/buồn rầu/lo buồn/lo phiền/âu sầu/lo âu/phiền lo|a
忧愤=buồn giận|a
忧烦=ưu phiền/buồn bực|a
忧郁=u buồn/buồn thương/sầu muộn|a
忧闷=buồn phiền/buồn bực|a
快乐=vui vẻ/khoái hoạt/vui sướng/sung sướng/hạnh phúc/may mắn|a
快亮=sắp sáng/mau sáng|a
快哉=khoái chăng/sung sướng|a
快感=khoái cảm/vui vẻ/sảng khoái/vui thích/vui sướng/thích thú/niềm khoái cảm/điều thích thú|a
快慰=khuây khoả/an ủi/khoái úy|a
快捷=mau lẹ/nhanh nhẹn/lẹ làng/đường tắt/biện pháp nhanh chóng trực tiếp hơn/khoái tiệp/cấp tốc|a
快极=cực nhanh|a
快气=mau tức|a
快碎=vở vụn thật nhanh/vỡ vụn thật nhanh|a
快美=khoái mỹ|a
快进=tiến nhanh/mau vào|a
忸怩=xấu hổ/bẽn lẽn/ngượng nghịu|a
忿怒=phẫn nộ|a
忿恨=phẫn hận/căm hận/căm gan|a
忿然=phẫn nhiên|a
怅怅=bực mình/thất vọng/buồn rầu/rầu rĩ/phiền lòng/không như ý|a
怅恨=trái ý/khó chịu/bực mình/buồn giận|a
怅惘=thẫn thờ/đờ đẫn/quẫn trí/buồn rầu/rầu rĩ|a
怕不怕=có sợ hay không/có sợ không|a
怕事=sợ phiền phức/sợ lôi thôi/ngại rầy rà|a
怕人=sợ người/sợ nhân|a
怕冷=sợ lạnh|a
怕寒=sợ lạnh|a
怕怕=hơi sợ|a
怕死=sợ chết|a
怕生=sợ người lạ/sợ lạ|a
怕痒=sợ nhột/sợ ngứa|a
怕羞=xấu hổ/thẹn/ngượng nghịu/ngại ngùng/e thẹn/mắc cỡ|a
怕脏=sợ bẩn/sợ dơ|a
怕黑=sợ tối|a
怠倦=lười nhác cẩu thả|a
怠惰=lười biếng/biếng nhác/uể oải|a
怡然=vui mừng/sung sướng/di nhiên|a
急促=gấp rút/dồn dập/gấp/dốc/nhanh/cấp bách/ngắn ngủi/cấp xúc/vội gấp/gấp gáp|a
急切=vội vàng/cấp thiết/cần thiết/khẩn thiết/thiết tha/vội vã/bức thiết|a
急劲=cấp kình|a
急急=vội vã/cấp cấp/vội vàng/gấp/cấp thiết/gấp gấp|a
急智=nhanh trí/tháo vát/phương pháp đối phó nhất thời/phương pháp đối phó tức thời|a
急暴=nôn nóng/hấp tấp|a
急燥=nôn nóng/nhanh nhẩu|a
急躁=vội vàng xao động/cuống/cuống lên/cuống cuồng/luống cuống/nôn nóng/hấp tấp/nóng nẩy/gấp gáp|a
急遽=cấp tốc/nhanh chóng|a
性急=gấp gáp/tính tình nóng nảy/nóng tính|a
性虐=tính ngược|a
怪僻=cổ quái/quái gở/càn dở/kỳ cục/càn rỡ/kỳ quặc/kỳ quái|a
怪哉=quái tai|a
怪异=quái dị/kỳ dị/kỳ lạ/kỳ quặc/quái lạ/hiện tượng kỳ lạ/hiện tượng kỳ quặc|a
怪秘=cổ quái huyền bí|a
怪笑=cười quái dị|a
怪讶=kinh ngạc|a
怪诞=quái đản/kỳ quái/quái gở/cổ quái/lạ lùng|a
怪谲=quái dị/nhảm nhí|a
怯弱=khiếp nhược/nhát gan/hèn yếu/yếu ớt|a
怯意=khiếp ý|a
怯懦=nhát gan/sợ sệt/hèn nhát|a
恍惚=hoảng hốt/hốt hoảng/ngẩn ngơ/tựa như/hình như/không rõ/phảng phất/Hoảng hốt/thấy không đích xác|a
恐怖=khủng bố/kinh khủng|a
恐高=sợ độ cao|a
恒久=vĩnh cửu/lâu dài/vĩnh hằng/mãi mãi/vĩnh viễn|a
恒等=giống hệt/y hệt/đồng nhất|a
恢宏=rộng rãi/to lớn/khoáng đạt/phát huy/khôi hoành/rộng rãi|a
恢弘=rộng lớn/rộng rãi/to lớn/khoáng đạt/phát huy/khôi hoằng|a
恬噪=điềm tĩnh|a
恬淡=không màng danh lợi/không mưu cầu danh lợi/điềm tĩnh/điềm đạm/nhạt nhẽo|a
恬然=điềm nhiên/thản nhiên|a
恬适=điềm tĩnh/điềm nhiên/thư thái|a
恬静=điềm tĩnh/yên tĩnh|a
恭喜=chúc mừng|a
恭敬=cung kính/kính cẩn|a
恭正=cung kính/ngay ngắn/ngăn nắp|a
恭肃=khiêm tốn lễ độ|a
恭谨=kính cẩn|a
恭顺=kính cẩn nghe theo/ngoan ngoãn/cung thuận|a
恰似=đúng như/giống như|a
恰盈=vừa đủ|a
恳切=khẩn thiết/thành khẩn/tha thiết/ân cần/khẩn khoản|a
恳挚=chân thành/tha thiết|a
恶俗=tục tĩu/thói quen xấu|a
恶劣=ác liệt/tồi tệ/xấu xa/tồi/tầm thường|a
恶名=tiếng xấu/ác danh/danh xấu|a
恶感=ác cảm/ác ý/cảm tình không tốt|a
恶搞=chơi ác/ác cảo/rởn vãi/làm ác|a
恶整=ác chỉnh|a
恶浊=vẩn đục/ô nhiễm/bẩn thỉu|a
恶臭=hôi thối/tanh tưởi/tanh rình/tanh hôi/mùi hôi thối|a
恼人=phiền lòng/phiền não|a
恼恨=oán hận/cáu giận/tức giận/oán giận/căm tức/giận|a
悖晦=lẩm cẩm/lú lẫn/hồ đồ|a
悖谬=xằng bậy/hoang đường/trái đạo lý|a
悚人=kinh người|a
悚然=sợ hãi/vẻ sợ hãi/bộ dạng sợ hãi/tủng nhiên|a
悠久=lâu đời/đã lâu|a
悠哉=thảnh thơi/không lo lắng|a
悠容=du dung|a
悠扬=du dương/êm ái/trầm bổng|a
悠着=kiềm chế/giữ ở mức độ vừa phải/vừa vừa|a
悠远=xa xăm/xa xưa/lâu đời/xa xôi/cách trở xa xôi/xa xa|a
悦心=Duyệt Tâm|a
悦服=mến phục/tâm phục|a
悦目=vui mắt/thích mắt/dễ coi/đẹp mắt/duyệt mục|a
悦耳=êm tai/dễ nghe/vui tai|a
悬殊=cách xa/khác xa nhau/chênh lệch xa|a
悭吝=bủn xỉn/keo kiệt/hà tiện|a
悱恻=đau khổ/đau đớn/phỉ trắc|a
悲伤=bi thương/khổ đau/đau khổ/thương cảm/buồn phiền/âu sầu|a
悲凄=buồn rầu/buồn phiền/âu sầu|a
悲凉=bi thương/cô tịch/thê lương/vắng vẻ lạnh lẽo|a
悲切=bi thiết/bi thương/buồn rầu/ảm đạm/tang tóc/thê lương|a
悲劳=mỏi mệt|a
悲叹=than thở/than thở buồn thương/bi thán|a
悲哀=bi ai/xót xa/đau xót trong lòng/thương tâm/buồn đau|a
悲喜=buồn vui|a
悲壮=bi tráng/bi hùng|a
悲怆=bi thương/buồn đau/bi sảng|a
悲怒=buồn giận|a
悲怨=bi oán/bi thương và oán hận|a
悲恐=bi khủng|a
悲恸=cực kỳ bi ai/bi thương/bi ai|a
悲惨=bi thảm/nghèo khổ/khổ cực/thảm thương|a
悲愁=sầu bi/buồn đau/bi thương u sầu|a
悲愤=bi phẫn/đau buồn phẫn nộ/đau thương căm giận/căm uất|a
悲拗=buồn bã|a
悲楚=đau buồn/đau đớn/đau khổ|a
悲痛=bi thống/đau buồn/bi thương/thống khổ|a
悲笑=cười buồn|a
悲观=bi quan/yếm thế|a
悲辛=đau xót/chua cay/thống thiết|a
悲郁=u uất/đau thương|a
情涩=tình sáp|a
惆怅=phiền muộn/thương cảm/rầu rĩ/oán hận/buồn phiền/chán nản/thất vọng/trù trướng|a
惊人=kinh người/làm kinh ngạc/làm ngạc nhiên/khác thường/lạ thường/giật gân/kinh ngạc|a
惊动=kinh động/quấy rầy/động đến|a
惊喜=kinh hỉ/kinh ngạc vui mừng/ngạc nhiên mừng rỡ/ngạc nhiên|a
惊奇=ngạc nhiên/kinh ngạc/lấy làm lạ/kỳ lạ/sửng sốt|a
惊寂=Kinh Tịch|a
惊异=kinh dị/kinh ngạc/sửng sốt/hết sức ngạc nhiên/rất đỗi ngạc nhiên|a
惊心=kinh tâm|a
惊怕=kinh sợ|a
惊怖=kinh hãi|a
惊急=kinh cấp/choáng váng và lo lắng|a
惊恐=hoảng sợ/kinh khủng/kinh hoàng/kinh hồn/sợ hãi/sợ hãi|a
惊悚=kinh dị/kinh hãi/sợ hãi/kinh sợ|a
惊惧=sợ hãi/kinh cụ/kinh sợ/hoảng sợ/hoảng loạn/kinh hoàng|a
惊惶=kinh hoàng/hoảng hốt/kinh sợ|a
惊愕=kinh ngạc/sửng sốt/hết sức ngạc nhiên|a
惊慌=kinh hoảng/hoang mang/lúng túng/lo sợ/sợ hãi|a
惊疑=kinh nghi/ngạc nhiên nghi ngờ|a
惊空=kinh không|a
惊羞=hoảng sợ ngượng ngập|a
惊艳=kinh diễm/tươi đẹp|a
惊觉=giật mình/kinh giác|a
惊讶=kinh ngạc/ngạc nhiên/sửng sốt|a
惊诧=kinh ngạc/ngạc nhiên/sửng sốt|a
惊醒=bừng tỉnh/giật mình tỉnh giấc/thức giấc/thức dậy/làm tỉnh giấc/làm bừng tỉnh/tỉnh ngủ/dễ tỉnh giấc/dễ giật mình/thức tỉnh|a
惊险=mạo hiểm/giật gân/phiêu lưu/nguy hiểm/kinh hiểm|a
惊骇=kinh hãi/sợ hãi/hoảng sợ|a
惊魂=kinh hồn/hoảng hồn/hết hồn|a
惋惜=tiếc hận/thương tiếc/thương xót/tiếc cho|a
惨厉=thê lương/thê thảm/thảm lệ|a
惨烈=thảm liệt/thảm thiết/vô cùng thê thảm/cực kỳ oanh liệt/vô cùng oanh liệt/mãnh liệt/lợi hại/ghê gớm/khốc liệt|a
惨痛=thê thảm đau đớn/thảm thống/đau đớn/đau thương/đau đớn thê thảm/thê thảm|a
惨苦=đau khổ thê thảm|a
惨重=thảm trọng/nặng nề/vô cùng nghiêm trọng/nặng nề|a
惫懒=bại hoại|a
惫赖=bại lại|a
惬当=thích hợp/thích đáng|a
惬心=mãn nguyện/hài lòng/thoả lòng/hả dạ|a
惬怀=mãn nguyện/hài lòng/thoả lòng/vừa lòng|a
惬意=hài lòng/thoải mái/thích ý/mãn nguyện/mãn ý/thanh thản dễ chịu|a
惭怒=phẫn nộ|a
惭怖=lo sợ|a
惭怯=xấu hổ|a
惭恨=hối tiếc|a
惭惧=lo sợ|a
惭惶=hoảng sợ|a
惭感=hổ thẹn cảm kích|a
惭愤=tức giận|a
惭愧=hổ thẹn/xấu hổ|a
惭疚=áy náy|a
惭羞=thẹn|a
惭色=nét hổ thẹn/vẻ xấu hổ|a
惶乱=hoảng loạn|a
惶急=hoảng loạn/hoảng hốt/hoảng lên|a
惶恐=kinh hoảng/hoảng hốt/sợ hãi/kinh hoàng lo sợ|a
惶悚=khủng hoảng/hoảng sợ/kinh hoàng sợ hãi|a
惶惑=lo sợ nghi hoặc/e sợ/ngại ngùng/lo sợ không yên/lo sợ nghi ngờ|a
惶惧=hoảng hốt/sợ hãi|a
惶惶=hoảng sợ/kinh hoàng/hoang mang/lo ngay ngáy/sợ hãi/lo sợ/hoàng hoàng|a
惶窘=hoảng sợ/kinh sợ|a
惶遽=hoảng hốt/sợ hãi/kinh hoàng/e sợ|a
惹恼=chọc giận/chọc tức|a
惺忪=nhập nhèm/mắt nhập nhèm/lim dim/dấp dính/tỉnh táo|a
惺松=lim dim|a
愁伤=sầu thương|a
愁白=sầu bạch|a
愁苦=sầu khổ/buồn lo/lo âu/lo lắng/băn khoăn/khổ não|a
愁虑=lo lắng/lo âu|a
愁郁=u sầu/sầu muộn/ưu tư|a
愁闷=sầu muộn/lo buồn/u sầu/buồn rầu|a
愉快=vui sướng/khoái trá/vui mừng/hớn hở/vui thích/vui vẻ|a
愉悦=vui vẻ/sung sướng/vui mừng/mừng rỡ/hớn hở/vui thích|a
意外=ngoài ý muốn/bất trắc/bất ngờ/không ngờ/điều bất trắc|a
意涂=ý đồ|a
愕异=kinh ngạc|a
愕然=ngạc nhiên/kinh ngạc/lấy làm lạ|a
愕视=sửng sốt/Nhìn một cách sợ hãi, lạ lùng.|a
愚妄=ngu muội lại ngông cuồng/ngu dốt xằng bậy|a
愚意=ngu ý/như ý kẻ ngu dốt này|a
愚懦=ngu muội nhu nhược|a
愚拙=ngu dại/ngu xuẩn/ngu ngốc|a
愚昧=ngu muội/dốt nát/mù quáng/ngu dốt|a
愚笨=ngu dốt/ngu đần/đần độn|a
愚蠢=ngu xuẩn/ngu dại|a
愚见=ngu kiến|a
愚钝=ngu dốt/đần độn/ngu độn|a
愚陋=ngu muội quê mùa/ngu dốt quê mùa|a
愚顽=ngu muội ngoan cố/ngu dốt ngoan cố|a
愚鲁=ngu dốt/ngu đần/đần độn|a
愤恼=phẫn nộ|a
愤愤=tức giận/căm giận/nổi giận/tức tối/giận dữ|a
愤慨=oán giận/căm giận/tức giận/căm phẫn/phẫn nộ/phẫn khái|a
愤懑=phẫn uất/vô cùng căm phẫn|a
愤郁=tức giận|a
愤青=phẫn thanh|a
愧恨=xấu hổ và ân hận/thẹn và giận mình/rất ăn năn/rất hối hận|a
愧疚=áy náy/hổ thẹn|a
愧痛=xấu hổ day dứt/thẹn thùng day dứt|a
愧色=vẻ xấu hổ/vẻ thẹn/vẻ ngượng ngùng|a
慈悲=từ bi/nhân từ/khoan dung/miễn xá/khoan hồng|a
慌乱=bối rối/hoảng loạn/hỗn loạn/lộn xộn/rối ren/hốt hoảng|a
慌促=vội/vội vã/gấp gáp/lật đật|a
慌张=bối rối/hoảng trương/hoang mang rối loạn/luống cuống/lật đật/hoang mang/lúng túng/hoảng hốt/hốt hoảng|a
慌急=vội vã/vội vàng|a
慌恐=khủng hoảng/hoảng sợ|a
慌慌=hoang mang rối loạn/lúng túng/hoảng hốt/hoang mang|a
慌着=vội vã|a
慌神=hoảng hốt|a
慎久=Makihisa|a
慎密=cẩn thận/cẩn mật|a
慎重=thận trọng/cẩn thận|a
慧黠=thông minh/tinh ranh/láu cá/ranh ma|a
慵懒=lười biếng/dày|a
慷慨=khẳng khái/hào phóng/hùng hồn/rộng rãi/hào hiệp/vô tư/không bủn xỉn|a
憋住=đình chỉ/biệt trụ|a
憋出=biệt xuất|a
憋屈=biệt khuất/uất ức|a
憋得=kìm nén đến/đến mức/ức đến|a
憋死=nín chết/kìm nén mà chết|a
憋气=ấm ức/nín thở/ngộp/ngột ngạt/tức thở/nín hơi/tấm tức/uất ức|a
憋着=kìm nén/nín|a
憋笑=nén cười|a
憋郁=uất ức|a
憋闷=bị đè nén/ấm ức/tức anh ách/bực bội/khó chịu/biệt muộn|a
憔悴=tiều tụy/tiền tuỵ/hốc hác/võ vàng/Tiều tụy/khốn khổ|a
憨厚=chất phác/hàm hậu/thật thà phúc hậu/thật thà chất phác/mộc mạc/thật thà/thành thật|a
憨实=thật thà chất phác/thật thà phúc hậu|a
憨憨=ngu ngơ/cộc lốc/thô lỗ|a
憨直=chân chất/thật thà chất phác/mộc mạc/ngay thẳng/thật thà|a
憨笑=cười ngây ngô/cười ngây thơ/cười ngây dại|a
憨趣=hàm thú|a
懂懂=mê mê|a
懈倦=trễ nải|a
懈怠=lười biếng/giải đãi/chậm trễ/buông thả/buông lỏng|a
懈气=lơ là không hăng hái/lơ là|a
懒怠=lười biếng/lười nhác/biếng nhác/lười/nhác/làm biếng/không thích/không có hứng thú|a
懒惰=lười biếng/lười nhác/làm biếng|a
懒懒=miễn cưỡng/lười biếng|a
成功=thành công/thịnh vượng|a
成套=nguyên bộ/đầy đủ/đồng bộ/thành bộ/lắp ráp|a
成效=hiệu quả/công hiệu/tác dụng/hiệu lực/tác động/ảnh hưởng/ấn tượng|a
成活=sống được/sống/sống qua/sống sót/còn lại|a
成熟=thành thục/trưởng thành/chín muồi/thích hợp/đúng lúc/hoàn thiện/cẩn thận/chín chắn/kỹ càng/thuần thục|a
成雅=Thành Nhã|a
戒慎=cảnh giác/cảnh giác cẩn thận|a
手辣=thủ lạt/ác độc|a
扎好=đóng tốt|a
扎实=vững chắc/chắc chắn/xác thật|a
扎眼=chói mắt/gai mắt/chướng mắt/trát nhãn|a
扎稳=trầm ổn|a
扎紧=bó chặt/quấn chặt|a
扑朔=phác sóc|a
执著=cố chấp/câu nệ/kiên trì/câu nệ, chấp trước|a
扼要=nói tóm tắt/nắm điểm chính/tóm tắt/vắn tắt/ách yếu/giữ chẹn chỗ hiểm yếu|a
抑郁=hậm hực/uất ức|a
抠气=cáu giận|a
抠门=keo kiệt|a
抢功=đoạt công|a
抱憾=ân hận/thương tiếc/ôm nuối tiếc/lấy làm tiếc/hối hận/hối tiếc|a
抽挺=thẳng tắp|a
抽条=trổ cành|a
抽闲=tranh thủ thời gian/dành thời gian|a
拔俗=thoát tục/Siêu thoát thế tục. ◇Khổng Trĩ Khuê 孔稚珪: Cảnh giới bạt tục chi tiêu/tiêu sái xuất trần chi tưởng 耿介拔俗之標/蕭灑出塵之想|a
拔凉=thật lạnh|a
拖沓=kéo dài/dây dưa/lề mề/lề mề chậm chạp|a
拗劲=tính tình cố chấp|a
拘谨=câu nệ/thận trọng/cẩn trọng/chặt chẽ/cẩn thận|a
拙劣=vụng về/chuyết liệt|a
拙朴=mộc mạc/chân phương|a
拙笨=ngốc/ngốc nghếch/đần/đần độn/vụng về|a
拙见=kiến giải vụng về/thiển kiến/thiển ý|a
持久=bền bỉ/kéo dài/giữ lâu dài/sống lâu/mở rộng/bền vững/trường cữu|a
持殊=đặc thù|a
挺久=rất lâu|a
挺俏=rất thanh tú|a
挺大=rất lớn/thật lớn|a
挺好吃=ăn rất ngon|a
挺好玩=rất thú vị/chơi rất vui|a
挺好用=dùng rất tốt|a
挺差=rất sai lầm|a
挺急=rất cấp bách|a
挺挺=không cong|a
挺暗=đã tắt|a
挺深=rất sâu|a
挺熟=rất quen|a
挺秀=trội hơn/xinh đẹp/duyên dáng|a
挺缺=rất thiếu|a
挺美=đẹp vô cùng/rất đẹp|a
挺贵=thật đắt/thật quý|a
挺酷=khá hay|a
挺难=rất khó khăn/thật khó khăn|a
挺香=rất thơm|a
揪心=lo lắng/lo âu/không an tâm/sốt ruột/băn khoăn/khắc khoải/bận tâm|a
揪着=níu lấy/nhéo/bám vào|a
搞脏=làm bẩn/làm nhơ/phá rối|a
放旷=phóng khoáng/khoáng đạt|a
放诞=phóng túng/bừa bãi/ngông cuồng|a
敌特=đặc vụ của địch|a
敏佳=Mẫn Giai|a
敏儿=Mẫn nhi|a
敏华=Mẫn Hoa|a
敏思=mẫn tư|a
敏感=mẫn cảm/nhạy cảm/thính|a
敏捷=nhanh nhẹn/mẫn tiệp/bén nhạy|a
敏敏=Mẫn Mẫn|a
敏锐=nhạy cảm/nhạy bén/ sắc bén/bén nhạy|a
散慢=tán mạn/chậm lút|a
敦厚=đôn hậu/trung hậu|a
敦实=chắc nịch/đầy đặn/đậm chắc/chắc chắn/dầy dặn|a
敦朴=trung hậu thật thà|a
敦睦=hữu nghị/thân thiện/hoà thuận/hoà hợp|a
整洁=sạch sẽ/ngăn nắp sạch sẽ/gọn gàng sạch sẽ/chỉnh tề|a
整肃=nghiêm túc/nghiêm chỉnh/chỉnh đốn/chỉnh lý/thu xếp|a
新凿=mới đục|a
新宠=tân sủng|a
新贵=tân quý|a
新锐=tân duệ|a
新颖=mới lạ/mới mẻ độc đáo/mới mẻ|a
方便=thuận tiện/"giải quyết"/phương tiện/thuận lợi/làm cho thuận tiện/làm cho tiện lợi/tiện/giàu có/dồi dào/dư dật/đại tiểu tiện|a
方头不劣=cứng đầu cứng cổ|a
方始=mới|a
方显=mới hiển lộ ra/mới lộ|a
方起=vừa khởi|a
旖旎=kiều diễm/cờ bay phất phới|a
旖颖=Y Dĩnh|a
无功=vô công|a
无垠=vô ngần/bao la bát ngát/bao la/bát ngát/mênh mông/mênh mang|a
无异=không khác|a
无憾=không tiếc/không uổng|a
无懒=vô lại|a
无效=vô hiệu/không có hiệu quả/không có hiệu lực|a
无稽=vô căn cứ/vu vơ/bịa đặt/vô kê|a
无耻=vô sỉ/không biết xấu hổ/vô liêm sỉ/trơ tráo/mặt dạn mày dày|a
无聊=nhàm chán/buồn chán/buồn thiu/buồn tẻ/vô vị/tẻ nhạt|a
旺旺=tăng thêm|a
旺盛=tràn đầy/thịnh vượng/dồi dào|a
昂昂=hiên ngang/bừng bừng/cao quý/cao thượng/cao cả/dũng cảm|a
昂然=ngang nhiên/hiên ngang|a
昂贵=đắt đỏ/sang quý/mắc/đắt tiền/mắc mỏ/đắt giá/đắt giá|a
明主=minh chủ/minh quân/anh quân|a
明丽=rực rỡ/tươi đẹp/rực rở/sáng sủa|a
明亮=sáng tỏ/sáng ngời/sáng sủa/sáng rực/hiểu ra/hiểu rõ|a
明净=trong vắt/trong suốt/minh tịnh|a
明劲=minh kình|a
明哨=trạm gác công khai|a
明媚=tươi đẹp/nắng/long lanh/sáng rỡ|a
明心=Minh Tâm|a
明快=thanh thoát/dễ hiểu lưu loát/cởi mở/thẳng thắn/sáng/minh khoái|a
明昧=Minh Muội|a
明显=Rõ ràng|a
明晦=sáng tối|a
明晰=rõ ràng/sáng tỏ/rõ nét/minh tích|a
明暗=sáng tối|a
明澈=sáng/trong sáng/trong/minh triệt|a
明火=minh hỏa|a
明烈=Minh Liệt|a
明爽=minh sảng|a
明理=minh lý/Akari/hợp lý/hợp lý/một lý do rõ ràng/sự thật hoặc sự kiện/để hiểu lý do hoặc lý luận|a
明畅=rõ ràng lưu loát|a
明眼=mắt sáng|a
明纯=trong sáng|a
明艳=xinh đẹp/minh diễm/sáng rực rỡ|a
明达=thấu đáo/rõ ràng/thấu đáo rõ ràng|a
明远=Minh Viễn|a
明锐=minh mẫn|a
昏乱=mê muội/mê loạn/thần trí mê muội/xã hội đen tối/hỗn loạn/nền chính trị đen tối|a
昏庸=hồ đồ/ngu ngốc/ngu đần/dốt đặc/đần độn/dốt nát/ngu xuẩn/lẩm cẩm|a
昏昧=không hiểu lý lẽ/chính trị đen tối|a
昏暗=u ám/lờ mờ/hôn ám/mờ tối/tối/mờ mịt/lờ mờ/tối tăm|a
昏浊=mờ đục|a
昏老=hôn lão|a
昏聩=hoa mắt ù tai/mê muội/lẩm cẩm|a
易俗=dịch tục|a
易柔=Dịch Nhu|a
昭著=rõ ràng/rõ rệt/khét lên|a
显圣=hiển thánh/hiển linh|a
显微=hiển vi/vi mô|a
显著=rõ rệt/nổi bật/lồ lộ/đáng chú ý|a
显贵=hiển quý/hiển vinh/người hiển quý/hiển vinh|a
显赫=hiển hách/vinh quang lừng lẫy|a
晦明=đêm ngày/ngày đêm/sáng tối|a
晦涩=tối nghĩa/khó hiểu/tối tăm|a
普皮=Poupi|a
普适=phổ biến|a
景和=Cảnh Hòa|a
景致=cảnh trí/phong cảnh/cảnh vật/cảnh|a
晴朗=sáng sủa/nắng ráo sáng sủa/nắng ráo/trời quang/trời trong/quang đãng|a
晶亮=óng ánh/sáng trong|a
晶莹=óng ánh/trong suốt/lóng lánh/trong sáng|a
暖和=ấm áp/ấm lên/sưởi ấm|a
暖昧=ám muội|a
暖活=ấm áp|a
暗冥=Ám Minh|a
暗奇=âm thầm thấy kỳ lạ|a
暗弱=ám nhược|a
暗恼=ngầm bực/thầm buồn|a
暗昧=ám muội/mờ ám/ngu muội/đần độn/ngốc nghếch|a
暗浅=nông cạn thiển cận/ảm đạm/tối tăm/sạm/xỉn/xám xịt/mờ|a
暗涩=tối tăm ảm đạm|a
暗淡=ảm đạm/lờ mờ/tối tăm/sạm/xỉn/xám xịt/mờ|a
暗紫=tím sậm|a
暧昧=mập mờ/ái muội/tối/mờ/khuất/thâm sâu/lèm nhèm/không minh bạch/không rõ ràng/không rõ rệt/đen tối/mờ ám/nhập nhằng/quanh co/không thẳng thắn/ám muội/khả nghi/không quang minh chính đại|a
暴厉=bạo tàn/hung tợn/tàn bạo/dã man|a
暴富=phất nhanh/giàu đột ngột/người mới phất/chợt giàu|a
暴戾=ngang ngược/thô bạo/tàn nhẫn/hung ác/bạo lệ|a
暴烈=dữ dằn/hung dữ/độc ác/dữ tợn/hung ác/tàn bạo/tàn nhẫn/ác nghiệt/hung hăng|a
暴燥=hung bạo|a
暴躁=táo bạo/nóng nảy/hấp tấp/bộp chộp/cáu kỉnh/gắt gỏng|a
曲傲=Khúc Ngạo|a
曲单=danh sách bài hát|a
曲折=khúc chiết/quanh co/ngoắt ngoéo/ngoằn ngoèo/khúc khuỷu/phức tạp/rối rắm|a
曲霉=chân khuẩn gây men|a
更亮=càng sáng hơn/sáng hơn|a
更凉=lạnh hơn|a
更急=gấp hơn|a
更惨=thảm hại hơn/càng thảm hại hơn|a
更烈=càng dữ dội hơn|a
更熟=quen hơn/càng quen hơn|a
更爽=thoải mái hơn/càng thoải mái hơn|a
更狂=cuồng hơn|a
更猛=mạnh hơn/càng mạnh|a
更疼=càng đau|a
更痛=đau hơn|a
更盛=càng tăng lên|a
更贵=quý hơn/đắt hơn|a
最久=lâu nhất|a
最亮=sáng nhất|a
最低=thấp nhất|a
最信=tin nhất|a
最傻=ngu nhất|a
最冷=lạnh nhất|a
最出色=xuất sắc nhất|a
最利=sắc nhất/sắc bén nhất|a
最厚=dày nhất/sâu đậm nhất/dầy nhất|a
最受=thụ nhất/thụ...nhất|a
最合适=thích hợp nhất|a
最喜=thích nhất/hoan hỷ nhất|a
最大=lớn nhất|a
最好=tốt nhất/dễ nhất/thích nhất/hay nhất/giỏi nhất|a
最嫩=mềm nhất|a
最宠=sủng ái nhất|a
最富=giàu nhất|a
最小=nhỏ nhất|a
最差=kém cỏi nhất/kém cỏi nhất/kém cỏi nhất|a
最广=phổ biến nhất/rộng nhất/rộng nhất|a
最废=phế nhất/lởm nhất|a
最弱=yếu nhất|a
最强=mạnh nhất/tối cường/cực mạnh/mạnh nhất|a
最忠=trung nhất|a
最怒=giận nhất|a
最恨=hận nhất|a
最恶=ác nhất|a
最惨=thảm nhất|a
最慈=hiền từ nhất/hiền nhất|a
最慢=chậm nhất|a
最旺=vượng nhất|a
最易=dễ nhất|a
最暖=ấm nhất|a
最有=nhất có/cực kỳ có|a
最松=lỏng lẻo nhất|a
最毒=độc nhất|a
最满=đầy nhất|a
最火=nóng nhất/hot nhất/nóng bỏng nhất|a
最烈=mãnh liệt nhất|a
最烦=phiền nhất|a
最熟=quen thuộc nhất|a
最爱=yêu nhất/thích nhất|a
最爽=thích nhất/thoải mái nhất|a
最猛=mạnh nhất|a
最甚=tối thậm/nhất|a
最疼=thương nhất/đau nhất|a
最痛=đau nhất/thương nhất|a
最盛=thịnh nhất|a
最真=chân thật nhất|a
最矮=thấp nhất/lùn nhất|a
最窄=hẹp nhất|a
最笨=ngốc nhất/đần nhất|a
最细=nhỏ nhất|a
最缺=thiếu nhất|a
最美=đẹp nhất|a
最老=già nhất|a
最脏=bẩn nhất|a
最蠢=ngu xuẩn nhất|a
最贵=quý nhất/đắt nhất/đắt tiền nhất|a
最足=đủ nhất|a
最软=mềm nhất|a
最远=xa nhất|a
最适=vừa nhất|a
最邪=kỳ lạ nhất|a
最配=xứng nhất|a
最重=nặng nhất/nặng nhất : coi trọng nhất|a
最长=dài nhất|a
最闲=rảnh rỗi nhất|a
最香=thơm nhất|a
最高=tối cao/cao nhất|a
有佳=cực kì|a
有假=là giả/giả bộ|a
有利=có lợi/có ích|a
有功=có công/người có công|a
有劲=có lực/có sức lực/có sức khoẻ/thú vị/lý thú|a
有劳=làm phiền/nhờ/phiền|a
有名=nổi danh/có tên/có tiếng/nổi tiếng|a
有喜=có tin mừng/có thai/có mừng|a
有害=có hại/tai hại|a
有幸=may mắn/vận may/dịp may|a
有异=khác thường/có dị|a
有心=hữu tâm/cố tình/có ý/có lòng/có tâm|a
有惊=có kinh sợ|a
有愧=hổ thẹn|a
有效=hữu hiệu/hiệu quả/hiệu nghiệm|a
有显=có vẻ|a
有趣=thú vị/hứng thú/lý thú/dễ thương/đáng yêu/có duyên|a
有足=có chân|a
有错=có sai/có lỗi|a
有限=có hạn/hữu hạn/không nhiều/không cao|a
有难=gặp nạn|a
朦胧=mông lung/ánh trăng mờ/lờ mờ/mịt mù|a
朦脆=mịt mờ|a
朦面=che mặt|a
朴厚=mộc mạc đôn hậu/chất phác/hiền hậu/thuần phác|a
朴实=giản dị/chất phác/thật thà chất phác|a
朴巧=Phác Xảo|a
朴拙=chất phác/Park Vụng|a
机敏=nhạy bén/nhanh nhạy/nhanh trí/cơ mẫn|a
机诈=xảo trá/gian giảo/giảo hoạt|a
杂凑=gom lại|a
杂沓=lộn xộn/lung tung/bừa bộn|a
杂碎=tạp toái/tạp chủng/món lòng/rác rưởi|a
杰出=kiệt xuất/xuất chúng/xuất sắc/lỗi lạc/phi thường/tuyệt vời|a
杰本=Kiệt Bản|a
松动=buông lỏng/rộng/rộng rãi/dư giả/dư dật/lỏng/long/dãn ra|a
松劲=xả hơi|a
松弛=lỏng/nhão/lỏng lẻo/tùng thỉ|a
松快=khoan khoái/nhẹ nhõm/thoải mái|a
松懈=thư giãn/buông lỏng/buông lơi/lỏng lẻo/hời hợt/thư giãn|a
松松=lỏng loẹt|a
松紧=căng chùng/chặt lỏng/độ chặt lỏng/tùng khẩn|a
松缓=buông lỏng/lỏng lẻo ra|a
松软=xốp/nới lỏng ra/thả lỏng ra/mềm mại ra/tùng nhuyễn|a
极严=cực nghiêm|a
极乐=cực lạc|a
极低=cực thấp|a
极佳=cực giai/thật tốt/rất tốt|a
极俊=cực kỳ tuấn tú|a
极冷=cực lạnh/lạnh vô cùng|a
极厚=cực dày/cực hậu/thật dày/thật dầy|a
极大=cực lớn/thật lớn/cực đại/cực điểm/cực độ/rất lớn|a
极富=rất có|a
极巨=cực lớn|a
极广=cực lớn/cực kỳ rộng lớn|a
极弱=cực yếu|a
极强=cực mạnh/rất mạnh/cực cường|a
极恶=cực ác|a
极易=rất dễ/cực dễ|a
极望=nhìn xa/trông ra xa|a
极沉=cực nặng|a
极浅=cực mỏng|a
极淡=cực kì nhạt|a
极热=cực nhiệt|a
极熟=hết sức quen thuộc|a
极爽=vô cùng thoải mái|a
极瘦=cực gầy|a
极盛=cực thịnh|a
极短=rất ngắn/quá ngắn|a
极硬=rất cứng|a
极稳=vững vô cùng|a
极窄=quá hẹp|a
极美=cực đẹp|a
极薄=cực mỏng|a
极蠢=cực kỳ ngu xuẩn|a
极贵=cực quý/đắt vô cùng|a
极足=cực sung túc|a
极重=cực nặng/rất nặng|a
极锐=cực sắc|a
极限=cực hạn/cao nhất/cực độ/giới hạn/ranh giới|a
极隆=rất sâu sắc|a
极静=cực tĩnh|a
极高=cực cao|a
果松=quả thông|a
枯槁=tiều tụy/khô héo/héo/khô/tàn úa/tiều tuỵ/héo mòn/tàn tạ/khô cằn|a
枯涩=khô khan/mờ đục/xỉn/khô|a
枯燥=buồn tẻ/khô khan/đơn điệu/nhàm chán|a
枯瘠=khô cằn/cằn cỗi|a
枯躁=khô khan|a
柔亮=sáng mềm|a
柔劲=nhu kình|a
柔和=nhu hòa/dịu dàng/êm dịu/nhẹ nhàng|a
柔嘉=Nhu Gia|a
柔媚=mềm mại đáng yêu/dịu dàng êm dịu/nhu mì|a
柔嫩=non mềm/mềm mại/mơn mởn/nhu nộn|a
柔弱=yếu đuối/nhu nhược/mềm yếu/mỏng manh|a
柔情=nhu tình/thuỳ mị/tình cảm dịu dàng|a
柔意=mềm mại|a
柔慈=nhân từ|a
柔柔=nhu nhu/trầm trầm/ôn nhu|a
柔滑=mềm nhẵn/trơn mềm|a
柔然=Nhu Nhiên|a
柔白=nhu bạch|a
柔细=mềm nhỏ|a
柔美=ôn nhu/nhu mỹ|a
柔腻=mềm nhẵn/nhu nị/mềm mại|a
柔软=mềm mại/mềm dẻo/dẻo dai|a
柔静=nhu tĩnh|a
柔韧=mềm dẻo/sự mềm dẻo/dẻo dai/dai bền|a
柔顺=mềm mại/nhu thuận/dịu hiền/hiền thục|a
根劲=căn kình|a
根固=ăn sâu/cắm sâu|a
根始=căn thủy|a
根彩=sợi dây màu|a
根本=căn bản/gốc rễ/cội nguồn/hoàn toàn/triệt để/chủ yếu/trọng yếu/từ trước đến giờ/trước giờ/vốn/xưa nay/trước sau/từ đầu đến cuối/tuyệt nhiên/không hề/tận gốc|a
根条=sợi rễ|a
根特=Gent/Ghent, thành phố ở Bỉ|a
根绝=tiêu diệt triệt để/diệt tận gốc/trừ tận gốc/trừ tiệt|a
桀骜=kiệt ngạo/bướng bỉnh/cương quyết/kiệt ngao|a
棘条=cành roi|a
森美=Samy|a
模特=người mẫu|a
模糊=mơ hồ/không rõ/mờ nhạt/lẫn lộn|a
欢乐=sung sướng/vui mừng/vui vẻ/rộn rã/vui thích/vui sướng/hoan lạc|a
欢好=hoan hảo|a
欢实=hăng hái/sôi nổi|a
欢快=vui sướng/vui/khoan khoái/vui thích/vui thú/vui vẻ|a
欢悦=vui mừng/vui vẻ|a
欢愉=vui thích/vui sướng/vui mừng/vui vẻ/hoan du|a
欢欣=hân hoan/phấn khởi/vui vẻ/vui mừng/vui sướng|a
欢畅=vui vẻ/thích thú/khoái chí/vui mừng/khoái trá/khoan khoái/phấn khởi/cao hứng/vui sướng|a
欢闹=vui chơi/chơi đùa vui vẻ/huyên náo/ồn ào/rộn rã|a
欢馨=Hoan Hinh|a
欣喜=mừng rỡ/thích thú/vui vẻ|a
欣幸=hân hạnh/vui mừng may mắn|a
欣悦=vui mừng/hân duyệt|a
欣欣=vui sướng/tươi tốt/phồn thịnh|a
欣雅=Hân Nhã|a
歆羡=hâm mộ/ngưỡng mộ|a
歉然=áy náy/day dứt/ray rứt/xin lỗi/khiểm nhiên|a
歉疚=áy náy/day dứt/ray rứt|a
正亮=đang sáng|a
正劲=chính kình|a
正合适=phù hợp/chính hợp thích/là thích hợp|a
正名=chính danh/xứng danh|a
正大=chính đại/chính đáng/rộng rãi/chính đại|a
正好=vừa vặn/vừa lúc/đúng lúc/được dịp/gặp dịp/vừa đúng|a
正巧=đúng lúc/vừa vặn/vừa lúc|a
正差=đang kém/đang bết bát|a
正当=đang lúc/đứng đắn/chính đáng/giữa lúc/trong lúc/thỏa đáng/hợp lý đoan trang|a
正急=tới lúc gấp rút|a
正愁=đang lo/đang rầu|a
正本=bản chính/bản gốc/bản chính thức|a
正理=lẽ phải/đúng lẽ|a
正缺=đang cần|a
正荣=Chính Vinh|a
正要=đang muốn/chính phải|a
正规=chính quy/nề nếp/chính quy|a
正邪=chính tà/chính tà|a
死硬=ngoan cố/cứng nhắc/máy móc|a
残余=còn sót lại/tàn dư/thặng dư/thừa ra/còn lại|a
残害=giết hại/tàn hại/sát hại/làm thương tổn|a
残忍=tàn nhẫn/hung ác độc địa|a
残旧=cũ nát|a
残暴=tàn bạo/tàn nhẫn hung ác|a
残本=bản thiếu/bổn thiếu|a
残热=tàn nhiệt|a
残缺=không trọn vẹn/không đủ/không hoàn chỉnh/không trọn/thiếu/khiếm khuyết/khuyết|a
残酷=tàn khốc/hung ác khắc nghiệt|a
殷切=tha thiết/bức thiết|a
毒圣=Độc Thánh|a
毒辣=độc ác/cay độc/nham hiểm/sắc bén|a
毛躁=xúc động/hấp tấp/bộp chộp/hấp ta hấp tấp/mất bình tĩnh/không bình tĩnh/không đắn đo suy nghĩ|a
民壮=dân tráng|a
民愤=sự phẫn nộ của dân chúng/lòng căm phẫn của nhân dân|a
气促=thở gấp/khó thở/Thở gấp|a
气弱=khí nhược|a
气急=khó thở/tức giận/thở gấp|a
气恼=tức giận/buồn bực/chán/bực mình/giận dữ|a
气爆=khí bạo|a
气爽=khí sảng|a
气盛=khí thịnh|a
气笑=tức giận cười|a
气远=khí viễn|a
气闷=khí muộn/bực mình|a
气馁=nhụt chí/nổi giận/nản lòng|a
气高=khí cao|a
污浊=ô trọc/không sạch sẽ/vẩn đục/đục/đục ngầu/vật bẩn/bẩn thỉu|a
沉伟=trầm vĩ|a
沉冷=trầm lãnh|a
沉劲=trầm kình|a
沉勇=điềm tĩnh dũng cảm|a
沉厚=trầm hậu/sâu dày|a
沉哑=trầm khàn|a
沉实=trầm thực/trầm thật/rắn chắc|a
沉寂=yên lặng/vắng lặng/lặng ngắt như tờ/tĩnh mịch/phẳng lặng/biệt vô âm tín/bặt vô âm tín/bặt tin/hoàn toàn không có tin tức|a
沉思=trầm tư/suy nghĩ/cân nhắc/lặng im suy nghĩ|a
沉毅=kiên nghị/kiên cường bình tĩnh/trầm tĩnh và kiên quyết|a
沉沉=nặng nề/nặng trĩu/trầm lắng/thâm trầm/sâu sắc/bí ẩn/nặng/chứa đầy/sâu kín/trầm trầm|a
沉煌=Trầm Hoàng|a
沉猛=trầm mãnh|a
沉痛=trầm thống/đau xót/đau thương/xót xa/bi thương/thương xót/sâu sắc/nghiêm trọng|a
沉稳=trầm ổn/chín chắn/vững vàng/điềm tĩnh/bình thản/bình tĩnh/yên/an ổn/yên ổn|a
沉穆=trầm mặc|a
沉老=trầm lão|a
沉郁=ủ dột/u sầu/ảm đạm/ngã lòng/chán nản/mụ mẫm/trầm úc|a
沉重=nặng nề/trầm trọng/nặng/nặng trĩu/phiền toái/trách nhiệm/gánh nặng/nhiệm vụ|a
沉锐=trầm nhuệ|a
沉闷=ngột ngạt/nặng nề/nặng trĩu/đè nặng/trầm lắng/lặng lẽ/ trầm lắng/trầm muộn|a
沉静=trầm tĩnh/im ắng/tĩnh mịch/yên tĩnh/yên lặng/lắng dịu/bình tĩnh/bình thản/dịu dàng/hoà nhã/trầm lặng|a
沉默=trầm mặc/trầm lặng/trầm tĩnh/lặng im/lặng lẽ/yên lặng|a
没腻=không ngán|a
沮丧=uể oải/ủ rũ/chán nản/mất tinh thần/mất nhuệ khí/chán/bị uể oải/làm cho ủ rũ/làm mất tinh thần/làm tiêu tan nhuệ khí/như đưa đám|a
泼泼=ngang tàng|a
泼洒=hắt vẫy/bát sái/dội|a
泼辣=mạnh mẽ/đanh đá/chua ngoa/tai ngược/đáo để/năng nổ/tháo vát/dũng mãnh/cay cú|a
洁大=hạo đại|a
洒洒=nhiều|a
洒满=rải đầy/văng đầy/tung khắp|a
洒遍=vẩy khắp|a
洪大=lớn/to/vang dội/sang sảng|a
活便=linh hoạt/sống động/nhanh nhẹn/lanh lợi/tiện lợi/tiện/thuận lợi/thuận tiện|a
活契=văn khế cầm cố/văn khế bán đợ|a
活泛=linh hoạt/nhanh nhẹn/lanh lẹ/hoạt bát/linh lợi/lanh lợi/dư dật/dư/khá giả/kinh tế khá giả/hoạt phiếm|a
活泼=hoạt bát/sống động/nhanh nhẹn/sinh động/hồn nhiên/không cứng nhắc/dễ hoà nhập/dễ hoà hợp|a
活腻=chán sống/ngán sống/không muốn sống|a
流丽=đẹp/hay/tài hoa|a
流勇=lưu dũng|a
流畅=trôi chảy/lưu sướng/lưu loát|a
浅显=dễ hiểu/rõ ràng|a
浅浅=nhàn nhạt/nhợt nhạt/nhẹ nhàng/róc rách|a
浅薄=nông cạn/thiếu hiểu biết/thiếu kiến thức/kém|a
浅近=thiển cận/nông cạn/đơn giản dễ hiểu|a
浅陋=nông cạn/sơ sài|a
浅鲜=nhỏ bé mong manh/ít ỏi|a
浑似=giống/rất giống|a
浑厚=hùng hậu/hồn hậu/thật thà/chất phác/thật thà chất phác/thuần phác/mộc mạc/hồn nhiên/hùng hồn/trầm mạnh|a
浑如=hoàn toàn giống/rất giống|a
浑括=tóm tắt/kết luận/tổng kết|a
浑朴=chất phác/hồn nhiên/đôn hậu/hồn hậu chất phác/mộc mạc|a
浑沌=hỗn độn|a
浑沦=hỗn độn|a
浑浊=vẩn đục/đục ngầu/khàn khàn/đục|a
浓厚=nồng hậu dày đặc/nồng hậu/dày/dày đặc/thẫm/nặng nề/say mê|a
浓密=nồng đậm/rậm/dày đặc|a
浓淡=đậm nhạt|a
浓烈=nồng đậm/nồng nặc/đặc hơn/đầm đặc|a
浓热=nóng đặc|a
浓稠=đậm đặc/sền sệt|a
浓艳=đậm rực rỡ/đậm và rực rỡ/màu đậm và đẹp|a
浓郁=nồng đậm/nồng nặc/sực nức/đậm đà/ngào ngạt/dày đặc/đậm/sâu nặng/lớn|a
浓重=dày đặc/nồng nặc/sực nức/đậm đặc/nồng đậm|a
浩大=to lớn/lớn/thật lớn/hùng vĩ|a
浩广=bao la rộng lớn|a
浩森=dày đặc|a
浩气=chính khí/hào khí/ngay thẳng/cương trực/hạo khí|a
浩淼=mênh mông/bát ngát/mặt nước mênh mông|a
浩渺=mênh mông/mặt nước mênh mông|a
浩瀚=mênh mông/cuồn cuộn/biển/bát ngát/nhiều/rất nhiều|a
浩然=hạo nhiên/cuồn cuộn/trào dâng/trào/cuộn/cương trực/chính trực/ngay thẳng/Hạo Nhiên|a
浩特=làng/thôn/thành phố|a
浩繁=hạo phồn/to và nhiều/to nặng/nhiều/rất nhiều/quá nhiều|a
浩阔=rộng lớn/bao la|a
浪漫=lãng mạn/trữ tình/mơ mộng/phóng đãng/trác táng/truỵ lạc/sa ngã/sa đoạ/đồi truỵ|a
浮沉=chìm nổi/trôi nổi/thăng trầm|a
浮泛=trôi nổi/trôi trên mặt nước/lộ ra/toát lên/bề ngoài/không thực tế|a
浮燥=táo bạo|a
浮艳=loè loẹt/trống rỗng/sáo rỗng/phù phiếm|a
浮薄=xốc nổi/bộp chộp|a
浮躁=táo bạo/kiêu căng/xốc nổi/nông nổi/nóng nảy/rộn ràng|a
浮靡=hào nhoáng xa xỉ|a
消瘦=gầy gò/gầy đi/ốm đi|a
淡薄=mờ nhạt/mỏng/thưa/thưa thớt/tan/nhạt/nhạt nhẽo/phai nhạt/lợt phai/lợt lạt/đạm bạc|a
淫乐=dâm nhạc|a
淫乱=dâm loạn/tà dâm|a
淫兴=dâm hứng|a
淫后=dâm hậu|a
淫悦=dâm duyệt|a
淫猥=dâm ô|a
淫眼=dâm nhãn|a
淫秽=dâm uế/tục tĩu/dâm tà/dâm ô|a
淫笑=cười dâm/nụ cười - dâm đãng/dâm dật/dâm loạn|a
淫美=dâm mỹ|a
淫艳=dâm diễm|a
淫虎=Dâm Hổ|a
淫虐=dâm ngược|a
淫贱=dâm tiện|a
淫邪=dâm tà|a
淫靡=dâm mỹ|a
深凹=lõm sâu|a
深切=sâu sắc/thắm thiết/sâu sắc xác thực/thâm thiết|a
深厚=thâm hậu/nồng hậu/nồng nàn/thắm thiết/vững chắc/vững vàng|a
深好=thích lắm|a
深寂=thâm tịch|a
深幽=thâm u|a
深怕=rất sợ|a
深恐=rất sợ|a
深感=cảm giác sâu sắc|a
深挚=tha thiết/nồng nàn/thân mật|a
深沉=thâm trầm/sâu lắng/lắng sâu/trầm lắng/nặng nề/kín đáo/âm thầm|a
深洼=hồ sâu|a
深浅=sâu cạn/nông sâu/mức độ|a
深湛=sâu xa/điêu luyện/thâm thuý/uyên thâm/thâm trạm|a
深烈=thâm liệt|a
深爱=yêu/yêu thương - sâu sắc/yêu tha thiết|a
深窄=chật hẹp|a
深紫=tím đậm/tím sẫm|a
深远=sâu xa/sâu sắc|a
深邃=thâm thúy/sâu/sâu sắc/sâu xa|a
深重=sâu nặng/nặng nề/nghiêm trọng/trầm trọng|a
深阔=sâu rộng|a
淳厚=thuần hậu/thuần phác/lương thiện/thành thật chất phác/thật thà|a
淳朴=thuần phác/thành thật chất phác/thanh khiết/tinh khiết/giản dị/mộc mạc|a
混乱=hỗn loạn/lẫn lộn/pha trộn/lộn xộn/lung tung/rối loạn|a
混匀=trộn đều/trộn lẫn|a
混同=lẫn lộn/hoà chung/nhập chung/vơ đũa cả nắm/coi như nhau|a
混名=biệt danh/biệt hiệu|a
混得差=ra ngoài lăn lộn mà nghèo/hỗn đắc soa|a
混杂=hỗn tạp/trộn lẫn/lẫn lộn/pha tạp|a
混沌=hỗn độn/thời kỳ hỗn độn/thời kỳ hỗn mang/đần độn/ngu ngốc/vô tri vô thức/ngu đần/ngu dốt/Hỗn Độn|a
混浊=vẩn đục/bẩn/đục/nhơ nhớp/nhơ bẩn|a
混混=lưu manh/cuồn cuộn/côn đồ|a
混熟=thân quen|a
混脸熟=giả mạo người quen|a
混茫=không rõ/lờ mờ/mông muội|a
清严=thanh nghiêm|a
清丽=thanh lệ/tươi đẹp|a
清亮=trong trẻo/trong suốt/trong veo/trong vắt/thanh lượng|a
清俊=tuấn tú|a
清冷=thanh lãnh/vắng lặng/lành lạnh/trong trẻo nhưng lạnh lùng/hơi lạnh/yên lặng/trong trẻo lạnh lùng|a
清冽=mát lạnh/mát rượi/lành lạnh/thanh liệt/rét giá|a
清净=thanh tịnh|a
清凉=thanh lương/mát lạnh/mát rượi/mát mẻ|a
清单=danh sách/hoá đơn/bản liệt kê|a
清名=thanh danh|a
清喝=thanh hát/hét vang|a
清奇=thanh kỳ|a
清姿=thanh tư|a
清婉=thanh uyển/Thanh Uyển/rõ ràng và mềm mại|a
清寂=thanh tịch/im lặng|a
清寒=thanh bần/nghèo mà sạch/lạnh lẽo|a
清廉=thanh liêm/thanh bạch liêm khiết|a
清微=thanh vi|a
清心=thanh tâm|a
清怪=thanh quái|a
清恬=thanh điềm/tinh khiết và yên tĩnh|a
清愁=thanh sầu|a
清新=tươi mát/trong lành/trong sạch/mát mẻ/thanh tân|a
清明=thanh minh/trong sạch/thư thái/trấn tĩnh/thanh thản/trong sáng/sáng trong/tiết thanh minh|a
清晰=rõ ràng/rõ rệt/rõ nét|a
清朗=trong sáng/trẻo/sáng sủa/sáng trong/trong trẻo/thanh lãng|a
清楚=rõ ràng/tinh tường/rõ rệt/minh mẫn/hiểu rõ/nắm được|a
清正=thanh chính|a
清洁=sạch sẽ/vệ sinh/sạch/thanh khiết/thanh khiết|a
清洌=thanh liệt|a
清浊=thanh trọc/trong và đục|a
清涩=thanh sáp|a
清淡=thanh đạm/nhẹ/loãng/nhạt/dễ tiêu/doanh thu thấp/thanh đạm|a
清湛=trong trẻo/trong suốt/trong veo/trong vắt|a
清澈=thanh tịnh/trong suốt/trong veo|a
清灵=thanh linh|a
清热=thanh nhiệt|a
清爽=nhẹ nhàng khoan khoái/mát mẻ/trong sạch mát mẻ/thoải mái/thanh thản/khoan khoái nhẹ nhàng/sạch sẽ/ngăn nắp/rõ ràng/minh bạch/rành mạch|a
清玩=vật trang trí/thưởng ngoạn/ngắm nhìn|a
清理=thanh lý/rửa sạch/kiểm kê/dọn dẹp|a
清甜=trong veo|a
清瘦=gầy gò/gầy/yếu ớt/mảnh khảnh|a
清癯=gầy gò/võ vàng/gầy guộc/mảnh khảnh|a
清白=trong sạch/thuần khiết/rõ ràng/minh bạch|a
清真=trong sạch/chất phác/Halal|a
清福=thanh phúc|a
清秀=thanh tú/xinh đẹp|a
清纯=thanh thuần|a
清脆=thanh thúy/trong trẻo/lanh lảnh/véo von|a
清艳=thanh diễm|a
清苦=kham khổ/bần khổ/bần hàn|a
清荣=Thanh Vinh|a
清莹=Thanh Oánh|a
清虚=Thanh Hư|a
清规=thanh quy|a
清贫=nghèo khó/bần cùng/bần hàn/nghèo khốn|a
清贵=thanh quý|a
清越=réo rắt/du dương/véo von|a
清远=Thanh Viễn|a
清通=trôi chảy/suôn sẻ/rành mạch/thông suốt|a
清逸=thanh dật|a
清醒=thanh tỉnh/sáng suốt/tỉnh táo/minh mẫn/hồi tỉnh/tỉnh lại/thanh tĩnh|a
清闲=thanh nhàn/nhàn rỗi/nhàn hạ|a
清雅=thanh nhã/thanh lịch tao nhã/Thanh Nhã|a
清静=thanh tĩnh/yên tĩnh/yên lặng/thanh vắng/vắng vẻ|a
清韵=Thanh Vận|a
清馨=thơm mát/thơm dịu|a
清高=thanh cao/trong sạch cao thượng|a
渊远=sâu xa|a
温厚=ôn hoà hiền hậu/đôn hậu|a
温和=ôn hòa/ấm áp/ôn hoà/mềm mỏng/dịu dàng/nhã nhặn/điềm đạm/êm dịu/ấm/nóng|a
温妙=Ôn Diệu|a
温婉=dịu dàng/ôn uyển|a
温弱=ôn nhược|a
温彻=Wencher|a
温柔=ôn nhu/dịu dàng/thuỳ mị/mềm mại/hoà nhã/điềm đạm/Ôn Nhu|a
温湿=ấm ướt|a
温热=ấm áp|a
温软=mềm mại|a
温静=Ôn Tĩnh|a
渺小=nhỏ bé|a
渺渺=mịt mờ|a
渺然=mờ mịt|a
渺茫=xa vời/mong manh/mù mịt/mịt mù/khó dự đoán/khó liệu chừng|a
渺远=miểu viễn|a
湍急=chảy xiết/xiết|a
溷浊=đục ngầu/vẩn đục/bẩn/nhơ nhớp|a
溽热=nóng|a
滂沱=mưa lớn/giàn giụa/tầm tã/mưa to/bàng đà|a
滂湃=cuộn trào/nước cuộn trào/nước tuôn trào|a
滑爽=trơn|a
滑稽=buồn cười/hoạt kê/thấy tức cười/gây cười/chọc cười/khôi hài/hài hước/hài/tức cười|a
滑腻=trơn nhẵn/trắng nõn/trắng mịn/trắng muốt/trắng như bông bưởi/trắng như tuyết/trắng tinh/trắng trẻo|a
滑软=trơn mềm|a
漂亮=xinh đẹp/đẹp/xinh xắn/đẹp đẽ|a
漂流=phiêu lưu/lềnh bềnh/trôi nổi/phiêu bạt/lang thang/nay đây mai đó|a
漫出=tràn ra|a
漫洒=tràn ra|a
漫漫=từ từ/đằng đẵng/dài đằng đẵng/mênh mông|a
潇明=Tiêu Minh|a
潇洒=tiêu sái/tự nhiên/phóng khoáng|a
潦倒=thất vọng/chán nản/buồn chán/vất vả|a
潦草=viết ngoáy/viết ẩu/viết tháu/qua loa/qua quýt/lạo thảo|a
潮湿=ẩm ướt/ươn ướt/sền sệt/ẩm thấp/ướt át|a
潮热=triều nhiệt/nóng bừng/bốc hỏa|a
澄湛=trong suốt|a
澄澈=trong suốt|a
澄碧=xanh biếc|a
激切=bộc trực/thẳng thắn|a
激动=kích động/xúc động/làm xúc động/khuấy động/xao động|a
激怒=chọc giận/làm tức giận/làm nổi giận/chọc tức|a
激恼=chọc tức/chọc giận|a
激愤=xúc động phẫn nộ/nổi tức/công phẫn|a
激昂=sục sôi/hăng chí/mạnh mẽ/hùng dũng/kích ngang|a
激活=kích hoạt/hoạt hoá|a
激烈=kịch liệt/quyết liệt/sôi nổi/dữ dội/mạnh mẽ|a
激然=kích nhiên|a
激越=mãnh liệt/lanh lảnh/sôi nổi|a
火亮=đốm lửa/ánh lửa nhỏ|a
火劲=hỏa kình|a
火大=nổi giận/nổi nóng|a
火急=khẩn cấp/hoả tốc|a
火旺=lửa mạnh|a
火炽=hưng thịnh/gay cấn/náo nhiệt/sôi động/căng thẳng/nở rộ/nóng bỏng|a
火烈=cháy rực/cháy bừng bừng|a
火爆=nóng nảy/nóng tính/thịnh vượng/sôi động/bốc lửa|a
火稚=Hỏa Trĩ|a
火躁=nóng nảy/nóng như lửa/nóng tính|a
灵便=linh hoạt/nhanh nhẹn/tiện lợi/tiện dùng/linh lợi|a
灵动=linh động|a
灵妙=thần diệu/tuyệt diệu|a
灵寂=linh tịch|a
灵尽=linh tẫn|a
灵巧=linh xảo/khéo léo/tinh tế/linh hoạt|a
灵异=linh dị/thần quái/thần kỳ/kỳ dị/thần bí|a
灵怪=yêu quái/thần kỳ/quái dị/kỳ quái|a
灵感=linh cảm|a
灵望=Linh Vọng|a
灵活=linh hoạt/nhanh nhẹn/năng động/nhạy bén|a
灵爆=linh bạo|a
灵粹=linh túy|a
灵虚=Linh Hư/linh hư|a
灵透=linh thấu/thông minh/sáng dạ|a
灵通=linh thông/nhanh/thạo tin/linh hoạt/nhanh nhẹn/nhanh nhẩu|a
灵静=Linh Tĩnh|a
灿丽=xán lệ|a
灿亮=sáng láng/sáng bóng|a
灿烂=xán lạn/rực rỡ/sáng rực/sáng lạn|a
灿然=sáng sủa/sáng chói/sáng loá|a
灿目=chói mắt|a
灿艳=tươi sáng|a
炎凉=nóng lạnh/thất thường|a
炎寒=Viêm Hàn|a
炎少=Viêm thiếu|a
炎热=nóng bức/rất nóng/nực|a
炎爆=viêm bạo|a
炎高=Viêm Cao|a
炙热=nóng bỏng/cực nóng/nóng hầm hập/vô cùng nóng|a
炙熟=đốt chín|a
炫丽=huyễn lệ|a
炫酷=huyễn khốc/mát mẻ|a
炽亮=rực sáng/sáng rừng rực|a
炽情=tình cảm nồng nhiệt/nhiệt tình hừng hực|a
炽灼=lửa rừng rực/người nóng nảy/mạnh mẽ/hùng mạnh/có quyền lực lớn/có uy quyền lớn|a
炽烈=hừng hực/sáng chói/rừng rực/nóng rực/rực cháy/rực sáng/sí liệt|a
炽热=nóng bỏng/nóng cháy/nóng rực/nồng nhiệt/tha thiết/sôi nổi/rực cháy|a
炽燥=hầm hập/khô nóng|a
炽白=trắng lóa/màu trắng rừng rực|a
炽盛=hừng hực/rực cháy/thiết tha/mãnh liệt/kịch liệt/ghê gớm/phát đạt/thành công/thịnh vượng|a
烂熳=hồn nhiên/ngây thơ/ngờ nghệch/khờ dại/chân thật|a
烦不烦=có phiền hay không|a
烦乱=lo lắng/không yên/rối rắm/phiền hà/vừa nhiều vừa rối/phiền loạn|a
烦人=đáng ghét/chán/phiền|a
烦倦=mệt mỏi chán chường|a
烦冗=bộn bề/phức tạp/rắc rối/rườm rà/dài dòng/lê thê|a
烦劳=làm phiền/quấy rầy/nhờ/phiền|a
烦厌=chán/chán nản|a
烦嚣=phiền hiêu/lắm chuyện/lắm lời/ầm ĩ/huyên náo/om sòm|a
烦多=rườm rà|a
烦心=phiền lòng/buồn phiền/buồn rầu/buồn/lo lắng/lo nghĩ/bận tâm|a
烦恶=phiền chán|a
烦恼=phiền não/phiền muộn/buồn phiền/buồn rầu/muộn phiền|a
烦愁=lo lắng/lo nghĩ|a
烦文=hành văn rườm rà/chữ viết phức tạp/nghi thức xã giao vô vị|a
烦杂=rắc rối/phức tạp/lộn xộn|a
烦楚=khổ sở|a
烦热=oi bức/nóng|a
烦燥=buồn bực/phiền não|a
烦琐=làm phiền/phiền toái/rắc rối/phiền phức/lôi thôi/rườm rà|a
烦腻=chán/chán chường|a
烦虑=lo lắng|a
烦躁=bực bội/phiền táo/tính dễ cáu kỉnh/buồn bực/bực dọc/sốt ruột/cáu kỉnh/khó chịu/phiền não|a
烦闷=phiền muộn/buồn rầu/buồn phiền|a
烫好=hâm tốt|a
烫平=là phẳng|a
烫热=nóng bỏng|a
热冷=nóng lạnh|a
热切=nóng bỏng/sốt ruột/khẩn thiết/tha thiết/thiết tha|a
热吃=ăn nóng|a
热和=nóng hổi/nóng/thân mật/thân thiết/ấm áp|a
热孝=áo đại tang|a
热寂=nhiệt tịch|a
热望=thiết tha/mong mỏi/hi vọng tràn trề/mong mỏi|a
热烈=nhiệt liệt/sôi động/sôi nổi|a
热热=hâm nóng/hâm nóng một chút|a
热爱=yêu quý/nhiệt tình/nhiệt tình yêu/nhiệt tình yêu thương/nhiệt tâm/tha thiết/yêu|a
热诚=nhiệt thành/nhiệt tâm/tận tình/sốt sắng|a
热辣=nóng bỏng/sexy|a
热闹=náo nhiệt/tưng bừng/sôi nổi/vui vẻ/cảnh tượng náo nhiệt|a
焦急=lo lắng/nôn nóng/sốt ruột/lo âu/nóng nảy|a
焦渴=khát khô cổ|a
焦灼=cháy bỏng/cháy sáng/vô cùng lo lắng/vô cùng nóng ruột/sốt ruột/tiêu chước|a
焦烂=phỏng và lở loét|a
焦热=nóng rực/nóng như thiêu|a
焦燥=nóng vội/tiêu táo|a
焦糊=khét lẹt/khét/cháy khét|a
焦脆=vàng và giòn/nhanh và dứt khoát|a
焦虑=lo nghĩ/lo âu/lo lắng|a
焦躁=nôn nóng/nóng lòng/sốt ruột/nóng nảy|a
煊赫=lừng lẫy/hiển hách|a
煦和=hú hòa|a
熟稔=rất quen/quen thuộc|a
熟练=thuần thục/thạo/thông thạo|a
熟美=thục mỹ|a
熟雅=thục nhã|a
燠热=oi bức/nóng nực/nóng bức|a
燥动=táo động|a
燥热=khô nóng/hanh/nóng rang|a
爱吃=thích ăn|a
爱听=thích nghe|a
爱好=yêu thích/ham/thích/yêu chuộng/ưa thích/ưa chuộng/có quan hệ tốt với/ham muốn|a
爱怜=yêu thương/mê/cưng/vô cùng thương yêu/yêu tha thiết/yêu nồng nàn|a
爱悦=ái mộ/mê/thích/khoái|a
爱憎=yêu ghét/ái ố|a
爱昵=thân mật/mật thiết/thân thiết/riêng tư|a
爱腻=ái nị|a
爱辣=thích cay|a
爱重=ngưỡng mộ/hâm mộ|a
爽快=sảng khoái/dễ chịu/thẳng thắn|a
爽感=cảm giác sướng|a
爽朗=cởi mở/sang sảng/trong sáng/quang ̣đãng/thẳng thắn/sảng lãng|a
爽极=cực sướng|a
爽死=sướng chết/khoái chết|a
爽气=sảng khoái/không khí trong lành|a
爽然=ngẩn ra/thẫn thờ/thờ thẫn|a
爽爽=sung sướng|a
爽直=sáng sủa|a
爽约=lỡ hẹn/sai hẹn|a
爽脆=giòn tan/giòn/nhanh chóng|a
片集=tập phim|a
牛杂=lòng bò/bò tạp|a
牢固=kiên cố/lao cố/giam chặt/vững chắc/bền vững|a
牢守=cố thủ|a
牢稳=vững chắc/chắc ăn/an toàn/chắc chắn/đảm bảo/ổn định|a
牢靠=kiên cố/bền chắc/bền/chắc chắn/vững vàng/vững chắc/lao kháo|a
特亮=đặc lượng|a
特出=xuất chúng/nổi bật/vô cùng nổi bật|a
特大=đặc biệt lớn|a
特异=đặc dị/khác thường/xuất sắc/đặc biệt/đặc thù|a
特忍=đặc nhẫn|a
特效=đặc hiệu/hiệu quả đặc biệt/đặc trị|a
特殊=đặc thù|a
特爽=đặc sảng|a
特配=đặc phối|a
犀利=sắc bén/sắc nhọn|a
犀眼=mắt tê|a
犷悍=thô lỗ/hung hãn|a
犹大=Judas|a
犹然=vẫn cứ/giống như cũ|a
犹疑=do dự/lưỡng lự/trù trừ/phân vân|a
犹豫=do dự/lưỡng lự/phân vân/chần chừ|a
狂乱=cuồng loạn|a
狂傲=cuồng ngạo|a
狂劲=cuồng kình/cuồng kình|a
狂厉=cuồng lệ|a
狂喜=cuồng hỉ/mừng như điên/vui mừng khôn xiết/vui mừng quá đỗi/mừng rỡ/hân hoan/hoan hỉ/hớn hở/đắc chí/hả hê|a
狂妄=cuồng vọng/tự cao/kiêu ngạo/kiêu căng/ngạo mạn/ngông cuồng|a
狂暴=cuồng bạo/điên cuồng/mê loạn/điên tiết/thịnh nộ/Cuồng Bạo|a
狂横=cuồng hoành|a
狂烈=cuồng liệt|a
狂热=cuồng nhiệt/ham mê/say mê/điên cuồng|a
狂然=cuồng nhiên|a
狂燥=cuồng táo|a
狂爆=cuồng bạo|a
狂猛=cuồng mãnh|a
狂贱=Cuồng Tặc|a
狂躁=nóng nảy/luống cuống/cáu kỉnh/dễ cáu/dễ cảm ứng/không kềm chế được/hấp tấp/vội vàng/bốc/hăng/cuồng táo|a
狞厉=dữ tợn/dữ tợn|a
狞恶=nanh ác|a
狞然=vô cùng dữ tợn|a
狞皇=Nanh Hoàng|a
狞铮=dữ dằn|a
狠人=ngoan nhân/loại người hung ác|a
狠劲=chơi liều/ngoan kình/vẻ quyết tâm|a
狠大=ác liệt|a
狠戾=ngoan lệ/tàn nhẫn|a
狠烈=cứng cỏi|a
狠练=ngoan luyện|a
狠色=vẻ hung ác/ngoan sắc|a
狠辣=tàn nhẫn|a
狡捷=mẫn tiệp/linh lợi/nhạy bén|a
狡狯=xảo trá/bịp/gian xảo/gian trá/quỷ quyệt|a
狡猾=giảo hoạt/xảo quyệt/gian giảo/đạo đức giả/giả nhân giả nghĩa/giảo quyệt|a
狡诈=xảo trá/giả dối/gian xảo/xảo quyệt/quỷ quyệt|a
狡谲=xảo trá/dối trá/gian giảo|a
狡赖=chối cãi/chối bay chối biến/chối bai bải/phủ nhận|a
狡黠=giảo hoạt/giả dối/xảo quyệt/gian xảo/gian trá|a
独单=một mình/đơn độc|a
独当=độc đương/một mình chống đỡ|a
独特=đặc biệt/riêng biệt|a
独秀=siêu quần xuất chúng/siêu phàm|a
狭窄=chật hẹp/hẹp hòi/hẹp/chật/eo hẹp/không rộng rãi|a
狭道=đường hẹp|a
狭隘=nhỏ hẹp/hẹp hòi/hẹp/nhỏ hẹp;chật hẹp/hạn hẹp/chật hẹp/nhỏ mọn|a
狰然=gớm ghiếc|a
狰狞=dữ tợn/dữ tợn|a
狰猛=hung mãnh|a
狼藉=bừa bộn/đống bừa bộn/đống hỗn độn/bừa bãi/lộn xộn/bê bối/hỗn loạn/mất trật tự/tàn tạ|a
猖狂=càn rỡ/điên cuồng ngang ngược/ngông cuồng|a
猖獗=hung hăng ngang ngược/đổ/ngã/xương quyết|a
猛恶=mãnh ác|a
猛烈=mãnh liệt/mạnh mẽ/mạnh/nhanh|a
猛醒=bừng tỉnh/sực tỉnh/bỗng hiểu ra|a
猛钻=xuyên mạnh|a
玄苦=Huyền Khổ|a
玲星=Linh Tinh|a
玲珑=linh lung/lả lướt/lung linh/nhanh nhẹn/hoạt bát|a
玲秀=Linh Tú|a
玲雅=Linh Nhã|a
珍奇=quý hiếm/hiếm quý/quý và hiếm có/quý lạ|a
珍惜=trân quý/quý trọng/quý|a
珍本=sách quý/sách quý hiếm|a
珍爱=trân ái/quý yêu/yêu quý/yêu mến/quý trọng/yêu thích|a
珍玩=trân ngoạn/đồ chơi quý giá/món đồ chơi quý báu|a
珍稀=trân quý/quý hiếm|a
珍羞=món ăn quý và lạ|a
珍贵=trân quý/quý báu/quý giá/có giá trị|a
珍重=trân trọng/quý trọng/coi trọng/bảo trọng/giữ gìn sức khỏe/giữ gìn sức khoẻ|a
琐碎=vụn vặt/vặt vãnh/tỏa toái|a
琐细=tầm thường/không quan trọng/vụn vặt/nhỏ nhặt/vặt vãnh|a
瑰伟=đặc biệt/hoa lệ/lạ lùng|a
瑰玮=kỳ dị/lạ lùng/hoa lệ/hoa mỹ|a
甘脆=thơm giòn/ngọt thơm/thơm ngon/đầy hương vị|a
甜嫩=mềm ngọt|a
甜甜=ngọt ngào|a
甜笑=cười ngọt ngào/cười say mê|a
甜美=ngọt ngào/ngọt/vui vẻ/vui sướng/thoải mái/vui tươi/điềm mỹ|a
甜腻=ngọt ngào|a
甜蜜=ngọt ngào/điềm mật/hạnh phúc/vui tươi|a
生僻=ít thấy/lạ/ít gặp/hiếm có|a
生凑=gượng gạo góp thành/chắp vá/gom lại cho có lệ|a
生涩=không lưu loát/trúc trắc/lạng quạng|a
生猛=dữ dội/hùng hổ|a
生硬=cứng nhắc/đông cứng/gượng gạo/không tự nhiên/không thuần thục/cứng đờ/máy móc/cứng rắn|a
畅快=thoải mái/vui sướng/dễ chịu/hể hả/ấm cúng/sung sướng|a
畅爽=sảng khoái|a
畅达=trôi chảy/lưu loát/suôn sẻ/thông suốt|a
畅通=thông suốt/thẳng đường/tức khắc/lập tức|a
畏怖=sợ hãi|a
畏怯=khiếp sợ/nhát sợ/nhút nhát/nhát gan|a
疏冷=sơ lãnh|a
疏松=lơi lỏng/sơ tùng/tơi/xốp/làm tơi/làm xốp|a
疏狂=sơ cuồng/hoang dã/không kiềm chế|a
疏疏=thưa thớt|a
疏远=xa lánh/làm bất hòa/sơ sơ/không thân|a
疏阔=lỏng lẻo/xa lạ/xa cách/không thân/xa cách lâu|a
疯涨=căng vọt|a
疯狂=điên cuồng/điên khùng|a
疯玩=quậy|a
疯老=Phong lão|a
疲乏=mệt mỏi/mệt lả/mệt đừ/mệt nhoài/rã rời/kiệt sức/yếu sức/bị mài mòn/bị yếu|a
疲倦=rã rời/mệt mỏi/mệt mỏi rã rời|a
疲劳=mệt nhọc/mệt mỏi/mệt nhoài/mệt lả/mệt rã rời/kiệt sức/yếu sức|a
疲容=sắc mặt mệt mỏi|a
疲弱=mệt mỏi|a
疲惫=mỏi mệt/uể oải/mệt mỏi/mệt nhọc/mệt lử/làm cho mệt mỏi|a
疲懒=lười nhác|a
疲敝=kiệt sức/hao mòn/kiệt lực|a
疲竭=kiệt quệ/mệt lả/kiệt sức|a
疲累=mệt mỏi|a
疲色=vẻ mệt mỏi|a
疲软=mềm nhũn/bủn rủn/sụt giá/rớt giá|a
疲顿=mệt mỏi/mệt nhọc/mệt lử|a
病狂=bệnh cuồng|a
痒死=ngứa chết|a
痒痒=ngứa/ngứa ngáy|a
痛切=thống thiết/vô cùng đau đớn/hết sức đau khổ|a
痛快=thống khoái/vui vẻ/vui sướng/thoải mái/sướng/đã/khoái/khoái chí/sảng khoái/thẳng thắn/ngay thẳng|a
痛恶=ghét cay ghét đắng/căm ghét|a
痛感=cảm giác đau/cảm nhận sâu sắc/cảm thấy thấm thía/cảm thấy đau khổ/cảm thấy đau đớn|a
痛楚=đau đớn/khổ sở/đau khổ/chỗ đau|a
痛爱=yêu thương|a
痛痒=đau khổ/việc quan trọng/việc gấp rút|a
痛觉=cảm giác đau/cảm giác đau đớn/cảm thấy đau|a
痴狂=cuồng nhiệt/mê/đam mê/si cuồng|a
痴钝=trì độn/đần độn/dốt đặc|a
瘙痒=ngứa/ngứa ngáy|a
瘠弱=gầy yếu/Gầy còm/yếu đuối.|a
瘠瘦=gầy yếu/gầy gò|a
瘠薄=cằn cỗi/bạc màu|a
瘦削=thon gầy/gầy đét/gầy nhom/gầy còm|a
瘦弱=gầy yếu/ốm yếu|a
瘦瘠=gầy gò/ốm yếu/cằn cỗi/xấu|a
瘦脸=mặt gầy|a
瘦高=cao gầy|a
癫狂=điên cuồng/điên khùng/điên dại/điên rồ/sàm sỡ/không nghiêm túc/không đứng đắn|a
白暂=trắng trẻo/bạch tạm|a
皓然=Hạo Nhiên|a
直拗=trực ảo|a
直爽=ngay thẳng/thẳng thắn/lòng dạ ngay thẳng/trực sảng|a
相厚=tương hậu|a
相契=tương khế|a
相安=tường an/sống yên ổn với nhau|a
相异=khác nhau|a
相悦=cùng vui vẻ/cùng vui mừng/cùng hớn hở/tương duyệt|a
相感=cảm giác lẫn nhau|a
相熟=quen biết/quen nhau|a
相观=tương quan|a
省俭=tiết kiệm/dè sẻn/chắt chiu|a
真伪=thật giả|a
真俗=tục vãi|a
真傻=thật ngốc/thật khờ|a
真决=chân quyết|a
真冷=thật là lạnh|a
真切=rõ ràng/chân thành/tha thiết/rõ ràng chính xác/chân thành khẩn thiết/chân thành tha thiết/chân thiết|a
真利=thật bén|a
真功=chân công|a
真名=tên thật|a
真够=thật là/đủ/thật là đủ|a
真奇=chân kỳ|a
真好玩=chơi thật vui|a
真妙=chân diệu|a
真强=thật mạnh|a
真怒=chân nộ|a
真挚=chân thành tha thiết/chân thành|a
真热=nóng quá|a
真猛=thật là mạnh|a
真秘=chân bí|a
真笨=thực ngốc|a
真绝=thật tuyệt|a
真美=thật đẹp|a
真诚=chân thành/chân thật/thành thật|a
真高=thật cao|a
真鲜=thật tươi|a
眼大=mắt to|a
眼拙=mắt vụng về/trí nhớ tồi|a
眼熟=nhìn quen mắt/quen mắt/thấy quen|a
着凉=cảm lạnh/nhiễm lạnh/bị lạnh|a
着急=sốt ruột/lo lắng/cuống cuồng/gấp gáp|a
着恼=để ý|a
着慌=hoảng hốt/hoảng loạn/cuống lên|a
着重=cường điệu/nhấn mạnh/chú trọng/coi trọng|a
睿智=cơ trí/nhìn xa trông rộng|a
矍铄=quắc thước/khỏe mạnh|a
矜矜=cẩn trọng/thận trọng/cẩn thận/kiên cường/mạnh mẽ|a
矜贵=tự phụ/kiêu ngạo/tự cao tự đại/cao quý|a
矜重=tự trọng|a
矫情=già mồm/quái đản/sĩ diện cãi láo/khác người/già mồm cãi láo/lập dị/kiểu cách|a
矫捷=thoăn thoắt/nhanh nhẹn/kiểu tiệp|a
短促=ngắn ngủi/ngắn/cấp bách/đoản xúc/ngắn gặt|a
短折=đoản chiết/chết non cả|a
短拙=nông cạn khù khờ|a
短暂=ngắn ngủi/ngắn/nhất thời|a
短浅=thiển cận/nông cạn/hạn hẹp|a
短缺=thiếu thốn/thiếu/thiếu hụt/khuyết|a
短见=ý kiến nông cạn/ý kiến hẹp hòi/tầm nhìn hạn hẹp/tự sát/tự tử/đoản kiến|a
短足=chân ngắn|a
矮矮=lùn lùn/ngắn|a
矮胖=mập lùn/ục ịch/bị thịt/thấp bè bè/chắc mập|a
硕大=cực đại/to lớn/khổng lồ|a
硬功=ngạnh công|a
硬悍=ngạnh hãn|a
硬挨=cứng chịu|a
硬朗=cứng rắn/cường tráng/thân thể cường tráng/khoẻ mạnh/kiên cường có sức mạnh|a
硬硬=thô sáp|a
碍口=khó nói/không tiện mở miệng/ngượng miệng|a
碍眼=chướng mắt/gai mắt/khó coi/chướng/không tiện/bất tiện|a
碍难=khó lòng/lúng túng/bối rối/khó xử|a
磊落=lỗi lạc/quang minh/chính đại/ngay thẳng/chính trực/hỗn độn/lộn xộn/rối loạn|a
神似=rất giống/giống như thật/giống|a
神功=thần công|a
神奇=thần kỳ/vô cùng kì diệu/kỳ lạ/thần bí|a
神妙=thần diệu/huyền diệu/kỳ diệu|a
神怪=thần quái/thần tiên ma quái/kỳ lạ/kỳ quái|a
神效=thần hiệu/công hiệu|a
神煌=thần hoàng|a
神猛=thần mãnh|a
神福=Thần Phúc|a
神秀=Thần Tú|a
神秘=thần bí/huyền bí|a
神足=thần túc|a
祥细=tường tế|a
离奇=ly kỳ/không bình thường/khác thường/lạ lùng|a
离常=lạ thường|a
秀丽=tú lệ/thanh tú đẹp đẽ/xinh đẹp|a
秀俏=tú lệ|a
秀出=xuất sắc|a
秀媚=xinh đẹp duyên dáng|a
秀真=Tú Chân|a
秀秀=tú tú|a
秀美=tú mỹ/thanh tú đẹp đẽ/xinh đẹp tuyệt trần|a
秀致=tú trí/lớn lên|a
秀荣=Tú Vinh|a
秀足=chân đẹp|a
秀逸=tú dật|a
秀雅=xinh đẹp nho nhã|a
私利=tư lợi|a
私募=tư mộ|a
私密=tư mật|a
私愤=hận thù cá nhân/thù riêng/tư thù|a
私淑=lòng kính trọng/sự kính trọng|a
私聊=nói chuyện riêng/private chat|a
私见=thành kiến cá nhân/ý kiến cá nhân|a
私通=tư thông/thông đồng lén lút qua lại/thông dâm|a
秽乱=dâm loạn|a
秽多=Eta|a
秽浊=dơ bẩn/bẩn thỉu|a
稀乱=hi loạn|a
稀奇=hiếm lạ/kỳ lạ quý hiếm/ngạc nhiên/ly kỳ|a
稀少=thưa thớt/rất thưa thớt/ít ỏi|a
稀朗=thưa mà sáng|a
稀松=lơ lỏng/lơ là/cẩu thả/qua quít/không hệ trọng/không đâu/chẳng can hệ gì/lơ là|a
稀烂=nát nhừ/nấu nhừ/nát bét|a
稀疏=thưa thớt/lơ thơ/lác đác/lưa thưa|a
稀稀=lưa thưa|a
稀缺=khan hiếm|a
稀罕=hiếm có/yêu thích/hiếm/hiếm lạ/việc lạ/của hiếm/hiếm có : yêu thích|a
稀薄=mỏng manh/loãng/lơ thơ|a
稚嫩=non nớt/non trẻ/trẻ con/trĩ nộn|a
稚意=tính trẻ con|a
稚美=trĩ mỹ|a
稠密=đông đúc/nhiều/dầy đặc/rậm rạp/thân mật/mật thiết/thân tình/thân thiết/riêng tư|a
稠度=độ đặc/độ chắc|a
稠稠=đặc/sền sệt|a
稠糊=đặc/sền sệt/dày/mập/to|a
稳便=yên ổn/tiện lợi/an toàn/chắc chắn/tuỳ ý/tuỳ tiện/như ý/tuỳ thích|a
稳健=vững vàng/thận trọng/ổn kiện|a
稳固=vững chắc/củng cố/làm cho vững chắc|a
稳如=vững như|a
稳妥=ổn thỏa/ổn thoả/đáng tin cậy/vững vàng/vững chắc|a
稳婉=ổn uyển|a
稳定=ổn định/làm cho ổn định/không thay đổi|a
稳当=ổn định/thoả đáng/ổn thoả/vững chắc/chắc chắn|a
稳晦=ổn hối|a
稳稳=vững vàng/ổn ổn|a
稳稳当当=vững vững vàng vàng|a
稳练=vững vàng thành thạo|a
稳重=ổn trọng/chững chạc/thận trọng/vững vàng|a
穷乏=bần cùng/nghèo khó/cùng kiệt|a
穷困=khốn cùng/nghèo khổ/nghèo túng|a
穷富=giàu nghèo/người giàu và người nghèo|a
穷尽=cuối cùng/cùng tận/vô tận|a
穷忙=bận bịu kiếm ăn/rắc rối/phức tạp|a
穷愁=nỗi sầu nghèo khổ|a
穷穷=cùng cùng|a
穷苦=cùng khổ/bần cùng khốn khổ/nghèo khổ|a
空冥=không minh|a
空净=không tịnh|a
空寂=trống vắng/vắng vẻ/hoang vắng/không tịch|a
空当=lỗ hổng/lúc rảnh rỗi/chỗ trống|a
空敞=không sưởng|a
空泛=trống rỗng/rỗng tuếch/không đâu vào đâu/phù phiếm/không sát với thực tế|a
空爆=không bạo|a
空缺=trống chỗ/khe hở/ghế trống/chức vị trống/chỗ trống/lỗ hổng/khoảng không/khoảng trống/thiếu/khuyết/chỗ khuyết|a
空阔=khoảng không/không khoát|a
突奇=Đột Kỳ|a
突显=đột hiển|a
突盛=đột nhiên nhiều hơn|a
窄狭=chật hẹp|a
窈窕=yểu điệu/duyên dáng/sâu thẳm tĩnh mịch|a
窘促=quẫn bách/túng quẫn|a
窘困=túng quẫn khốn khó|a
窘急=quẫn cấp/quẫn bách|a
窘迫=quẫn bách/ngượng ngùng/khó khăn/khốn cùng/vô cùng khó khăn|a
端严=đoan nghiêm|a
端丽=đoan chính thanh nhã/đoan chính xinh đẹp/đoan trang xinh đẹp/giản dị thanh nhã/ngay ngắn|a
端和=đoan hòa|a
端好=cho chặt/cho chặt|a
端彩=hào quang kì dị|a
端急=đoan cấp|a
端整=đoan trang ngay thẳng|a
端由=nguyên nhân/nguyên do/căn nguyên|a
端雅=đoan trang tao nhã|a
端静=đoan trang trầm tĩnh/điềm tĩnh|a
笃厚=trung hậu/ngay thẳng|a
笃诚=chân chất/chân thành/chân thật|a
笨拙=vụng về/ngốc/kém thông minh/vụng dại/đần/vụng|a
笨笨=ngây ngốc|a
笨重=cồng kềnh/thô nặng/nặng nề cồng kềnh/kềnh càng/to lớn/đồ sộ/dềnh dàng/nặng nhọc/nặng trĩu/nặng nề/kịch cợm|a
简体=giản thể|a
简便=giản tiện/đơn giản/giản lược|a
简傲=kiêu căng|a
简则=qui tắc tóm tắt|a
简单=đơn giản/giản đơn/bình thường/qua quýt/qua loa/không cẩn thận|a
简帖=thư tín/thư từ|a
简心=Giản Tâm|a
简慢=tuỳ tiện vô lễ|a
简捷=nói thẳng/dứt khoát/giản đơn dứt khoát|a
简明=giản lược/đơn giản rõ ràng/rõ ràng dễ hiểu/giản minh|a
简易=giản dị/giản đơn/thô sơ/mộc mạc/đơn giản|a
简本=bản tóm lược/giản bổn|a
简朴=đơn giản/mộc mạc/chất phác/giản dị|a
简柔=Giản Nhu|a
简洁=ngắn gọn/trong sáng/đơn giản|a
简爱=Jane Eyre|a
简练=ngắn gọn/súc tích/giản luyện|a
简要=giản yếu/vắn tắt/giản đơn/khái quát/tóm tắt/đơn giản|a
简谱=giản phổ/nhạc số/nhạc giản phổ/nhạc số|a
简陋=đơn sơ/sơ sài/thô sơ|a
粗俗=thô tục/thô bỉ/lỗ mãng/thô lỗ|a
粗劣=kém/thô/xấu/xoàng/thứ phẩm|a
粗卑=thô tục ti tiện|a
粗厚=thô dày|a
粗哑=thô khàn|a
粗壮=tráng kiện/to khoẻ/cường tráng/khoẻ mạnh/sung sức/thô chắc/to thô và chắc chắn/cứng cáp/vững chắc/vai u thịt bắp|a
粗大=thô to/vừa thô vừa to/thô/to/lớn/đậm/mập mạp/chắc/khoẻ/bền/ầm ĩ/om sòm/inh ỏi/ầm ầm/to lớn|a
粗实=chắc chắn/vững chãi/rắn chắc/chắc nịch/vạm vỡ|a
粗心=sơ ý/không cẩn thận/liều lĩnh/khinh suất/thờ ơ/hờ hững/cẩu thả/sao lãng/thô tâm|a
粗旷=thô khoáng|a
粗暴=thô bạo/lỗ mãng/cộc cằn/khắt nghiệt/khe khắt/gắt gỏng|a
粗活=việc nặng/công việc nặng nhọc/lao động chân tay/lao động thủ công|a
粗浅=thô thiển/đơn giản/nông cạn/hời hợt/thiển cận|a
粗犷=thô kệch/tục tằng/thô lỗ/cục mịch/quê mùa/hào phóng/thẳng thắn/trực tính/cởi mở|a
粗狂=thô cuồng|a
粗猛=thô mãnh|a
粗疏=qua loa/không cẩn thận/cẩu thả/sơ suất/lơ đễnh/lơ là|a
粗笨=thô kệch/không nhanh nhẹn/vụng về/lóng ngóng/nặng nề/nặng trịch/kềnh càng/cồng kềnh|a
粗粗=thô thô|a
粗糙=thô ráp/thô/ráp/xù xì/gồ ghề/lởm chởm/sần sùi/nổi hột/ẩu/bừa/cẩu thả/không cẩn thận/thô sơ|a
粗细=phẩm chất/độ dầy/độ mịn/độ lớn/quy mô/kích thước/khổ/cỡ/số/khéo vụng/vẽ đẹp đẽ/tính tế nhị/tính tinh vi/tính cao thượng/vị ngon/sự đủ tuổi/lớn bằng|a
粗舌=lưỡi thô|a
粗莽=thô mãng|a
粗蛮=thô man|a
粗豪=thô hào/hào phóng/hào sảng/cởi mở/thẳng thắn/dõng dạc/chối tai/kịch cợm|a
粗通=hơi biết|a
粗鄙=thô bỉ/thô tục/tục tĩu/khiếm nhã/không tao nhã/tầm thường|a
粗重=thô trọng/to khoẻ/ồ ồ/ồm ồm/to/nặng nề/thô/to đậm/đậm/sậm/dầy/rậm/nặng nhọc|a
粗陋=thô lậu/thô kệch/xấu xí/vụng về|a
粗鲁=thô lỗ/lỗ mãng/tục tằn/thô bỉ/thô bạo|a
粘稠=sền sệt/sềnh sệch/sền sệt|a
粘糊=hồ dính|a
粲然=tươi sáng/toả sáng/rõ ràng/rõ rệt/minh bạch/cười hở răng/cười toét miệng/cười nhe răng|a
精壮=cường tráng/tinh tráng/cường tráng/khỏe/tráng kiện/khoẻ|a
精妙=tinh diệu/đẹp đẽ/kỳ diệu/tuyệt diệu/tuyệt vời/tinh xảo|a
精密=tinh vi/tỉ mỉ tinh vi/tỉ mỉ chính xác|a
精巧=tinh xảo/khéo léo/tinh vi|a
精当=xác đáng/chính xác thoả đáng|a
精微=tinh vi/uyên bác/tinh thâm/huyền diệu/vi diệu|a
精忍=Tinh Nhẫn|a
精忠=tinh trung/thuần chất trung thành|a
精怪=tinh quái/yêu ma tinh quái/ranh ma quỷ quái|a
精悍=điêu luyện/tháo vát/xốc vác/sắc bén/tinh hãn|a
精明=khôn khéo/thông minh lanh lợi/tháo vát/nhanh trí|a
精洁=tinh khiết|a
精深=tinh thâm/sâu sắc/uyên bác/uyên thâm/thâm thuý|a
精湛=tinh xảo/kỹ càng/tỉ mỉ|a
精满=tinh mãn|a
精熟=tinh thục|a
精瘦=gầy gò|a
精确=chính xác/chuẩn xác|a
精穷=cực nghèo|a
精粹=tinh túy/tinh tuý/ngắn gọn/cô đọng|a
精纯=tinh thuần/tinh khiết|a
精练=chặt chẽ/ngắn gọn/gọn/súc tích|a
精细=tinh tế/thấu đáo/tinh vi/chính xác|a
精美=tinh mỹ/đẹp đẽ/tinh xảo/tuyệt đẹp|a
精致=tinh xảo/đẹp đẽ/tinh tế/khéo léo/tinh sảo|a
精良=tinh lương/tốt/hoàn mỹ/đẹp đẽ/hoàn hảo/tinh xảo|a
精要=tinh yếu|a
精诚=chân thành/lòng thành/lòng chân thành|a
精贵=tinh quý|a
精进=tinh tiến|a
精通=tinh thông/thông thạo|a
精锐=tinh nhuệ|a
糊涂=hồ đồ/không rõ/mơ hồ/lơ mơ/lung tung/bừa bộn/hỗn loạn/vớ vẩn/không rõ ràng|a
糊糊=cháo|a
糟乱=tao loạn|a
糟害=giày xéo/phá hoại|a
糟心=bực mình/sốt ruột/nóng ruột/phiền lòng/lo lắng|a
糟糕=hỏng bét/không xong/hỏng/gay go|a
紊乱=hỗn loạn/rối loạn/hỗn độn/rối beng/náo động|a
素净=mộc mạc/tố tịnh/trắng trong thuần khiết/màu trắng mộc mạc|a
素朴=mộc mạc/manh nha/sơ kì/thô sơ|a
素淡=mộc mạc/thanh đạm|a
素雅=thanh lịch/tao nhã/trang nhã/tố nhã|a
紧促=gấp gáp|a
紧俏=hút hàng/hàng bán chạy/đắt hàng/cung không đủ cầu|a
紧凑=chặt chẽ/ngắn gọn/chắc nịch/rắn chắc/cô đọng/súc tích/khẩn thấu|a
紧密=chặt chẽ/dày đặc/liên tục/liên hồi/chặt chẽ|a
紧巴=khó khăn/túng thiếu/túng bấn|a
紧张=hồi hộp/khẩn trương/căng thẳng/eo hẹp/túng thiếu|a
紧急=khẩn cấp/cấp bách/hiểm nghèo|a
紧挨=gần sát/khẩn ai|a
紧捏=nắm chặt|a
紧窄=chặt khít|a
紧结=kết chặt|a
紧缺=khan hiếm/cung cấp không đủ/thiếu/thiếu thốn/thiếu hụt|a
紧要=khẩn yếu/quan trọng/nguy cấp/nguy ngập|a
紧贴=kề sát/kế/kề/sát/dán chặt|a
紧靠=nương tựa/tiếp giáp/nằm sát/giáp với|a
繁丽=phong phú/hoa mỹ|a
繁乱=bề bộn/lộn xộn|a
繁体=phồn thể/nguyên thể/chữ phồn thể|a
繁冗=phiền phức/phiền hà/phức tạp/rườm rà|a
繁华=phồn hoa/sầm uất/phồn thịnh|a
繁博=phồn bác/phổ biến/nhiều và rộng rãi|a
繁多=phong phú/đa dạng/phồn đa/nhiều/nhiều loại|a
繁奥=rườm rà|a
繁密=rậm rạp/dày đặc/râm ran/đông đúc|a
繁忙=bận rộn/bộn bề/phồn mang|a
繁思=nhiều mối suy tư|a
繁本=nguyên tác/bản gốc|a
繁杂=phức tạp/rắc rối/rắc rối phức tạp|a
繁琐=rườm rà/lộn xộn/nhiều hạn chế|a
繁盛=phồn thịnh/thịnh vượng/um tùm/sum suê/tươi tốt|a
繁缛=rườm rà/nhiều và vụn vặt|a
繁芜=dày đặc/rậm rịt/chi chít|a
繁茂=um tùm/sum xuê/xanh tươi/sum suê/phồn vinh|a
繁荣=phồn vinh/phát triển mạnh/phồn thịnh/làm cho phồn vinh/làm phồn thịnh/làm cho phát triển|a
繁重=nặng nề/nặng nhọc/nhiều và nặng nề/phồn trọng|a
繁错=rối rắm|a
繁闹=nhộn nhịp/phồn vinh náo nhiệt/phồn thịnh/sầm uất|a
繁难=phức tạp khó khăn/khó khăn phức tạp|a
红遍=hồng biến|a
纤丽=tinh tế hoa lệ|a
纤弱=nhỏ yếu/nhỏ bé và yếu ớt/nhỏ nhắn và yếu ớt|a
纤柔=nhỏ nhắn mềm mại/nhỏ bé mềm mại|a
纤瘦=mảnh mai/gầy gò|a
纤秀=tiêm tú/thon nhỏ tú lệ|a
纤细=tinh tế/hết sức nhỏ/mảnh/tiêm tế|a
纯亮=thuần lượng|a
纯净=tinh khiết/tinh thuần/nguyên chất/trong veo/trong trẻo/trong lành/thuần chủng/trong sạch/thuần khiết|a
纯利=lãi ròng|a
纯厚=thuần hậu/chân thật/ngay thẳng|a
纯均=Thuần Quân|a
纯朴=chất phác/ngây thơ/giản dị/tự nhiên/thuần phác|a
纯洁=thuần khiết/trong sạch/trong sáng/thanh khiết/trong trắng/trinh bạch/đức hạnh/gạn/lọc/lọc trong/tinh chế/làm trong sạch/rửa sạch/gột sạch/tẩy uế|a
纯熟=thuần thục/thành thạo/khéo léo/thành thục|a
纯爱=thuần ái/tình yêu thuần khiết|a
纯白=thuần trắng/thuần màu trắng/trắng tuyền|a
纯真=thuần chân/hồn nhiên/trong sáng chân thật/ngờ nghệch/khờ dại/ngây thơ/chất phác|a
纯粹=thuần túy/thuần chất/tinh khiết/ròng/nguyên chất/đơn thuần/thuần tuý/duy nhất/đơn độc|a
纯纯=tinh khiết|a
纯美=thuần mỹ/thanh khiết đẹp đẽ/thuần khiết đẹp đẽ|a
纯良=thuần lương|a
纷杂=hỗn loạn/lộn xộn/rối loạn|a
纷沓=nườm nượp|a
纷洒=bắn tung|a
纷繁=khó phân/rối ren/rối rắm/phức tạp/lộn xộn|a
细嫩=non mịn/mịn màng/mềm mại/tế nộn|a
细密=tinh mịn/rậm rạp/tỉ mỉ/không sơ suất qua loa/kỹ càng/mịn|a
细巧=tinh vi/tinh xảo|a
细弱=nhỏ bé yếu ớt/tế nhược/nhỏ bé|a
细微=nhỏ bé/rất nhỏ/nhỏ nhặt/nhỏ xíu/nhỏ bé|a
细挑=cao nhồng/mảnh khảnh|a
细活=việc tinh tế|a
细琐=nhỏ bé|a
细碎=nhỏ vụn/vụn vặt/tế toái|a
细窄=nhỏ hẹp|a
细细=tinh tế|a
细腻=tinh tế/tinh tế tỉ mỉ/nhẵn nhụi/mịn/nhẵn/tinh tế tỉ mỉ|a
细致=tỉ mỉ/cẩn thận/tinh tế tỉ mỉ/kỹ càng chu đáo|a
细软=tế nhuyễn/đồ trâu báu nữ trang/đồ tế nhuyễn/đồ châu báu/đồ nữ trang|a
细辛=cây tế tân/tế tân|a
细锐=tế duệ|a
绚丽=lộng lẫy/rực rỡ tươi đẹp/huyến lệ/rực rỡ/sáng đẹp|a
绚烂=chói lọi/sáng lạn/rực rỡ/sáng lạng/xán lạn|a
绝大=tuyệt đại|a
绝妙=tuyệt diệu/tuyệt hay/tuyệt vời/tài tình|a
绝密=tuyệt mật/tối mật/tuyệt đối giữ bí mật/cực kỳ bí mật|a
绝美=tuyệt mỹ|a
绝艳=tuyệt diễm|a
绮丽=tươi đẹp/xinh đẹp/khỉ lệ|a
绵薄=non nớt/non yếu|a
缓不济急=không kịp/chậm chạp không cứu vãn được công việc cấp bách|a
缓劲=làm dịu/thanh thản|a
缓和=hòa hoãn/dịu/hoà dịu/xoa dịu/làm dịu|a
缓急=hoãn gấp/thong thả và cấp bách/việc gấp/việc khó/việc cấp bách/việc khó khăn|a
缓气=hồi sức/phục hồi/lấy lại sức/thở lại bình thường/hồi phục|a
缓限=kéo dài thời gian/hoãn lại/hoãn thời gian/trì hoãn|a
缜密=kín đáo/kỹ càng/tinh tế/tỉ mỉ/đâu ra đó|a
缠人=quấn người|a
缠绵=triền miên/dằng dai/dây dưa/uyển chuyển/du dương|a
缠足=quấn chân/bó chân|a
缥缈=mờ mịt/lúc ẩn lúc hiện/lúc có lúc không/như có như không/mờ mờ/mù mịt|a
缱绻=lưu luyến/bịn rịn/quyến luyến|a
罕有=hãn hữu/hiếm có/ít có|a
罕缺=càng thiếu|a
罕见=hiếm thấy/ít/ít thấy|a
罕闻=hiếm có|a
罗唣=cãi cọ rách việc|a
罗淑=La Thục|a
美好=mỹ hảo/tốt đẹp/đẹp|a
美妙=mỹ diệu/tuyệt vời/tươi đẹp|a
美娱=giải trí Mỹ|a
美淑=Mỹ Thục|a
美满=mỹ mãn/mĩ mãn/đầm ấm/cuộc sống đầy đủ|a
美睦=mỹ mục/~|a
美艳=xinh đẹp|a
羞不羞=xấu hổ hay không|a
羞怯=e lệ/rụt rè/e lệ rụt rè|a
羞恥=cảm thấy thẹn|a
羞恶=xấu hổ và căm giận|a
羞恼=xấu hổ|a
羞惭=xấu hổ/hổ thẹn|a
羞愤=xấu hổ giận dữ/xấu hổ và giận dữ/xấu hỗ/giận dữ và xấu hổ|a
羞愧=xấu hổ/cảm thấy nhục nhã hổ thẹn|a
羞涩=ngượng ngùng/khó xử/thái độ không tự nhiên|a
羞窘=xấu hổ|a
羞羞=xấu hổ/tu tu|a
羞耻=xấu hổ/nhục nhã/cảm thấy thẹn/không có thể diện|a
羞臊=ngượng|a
羞赧=ngượng ngùng/thẹn đỏ mặt/xấu hổ đỏ mặt|a
翔儿=Tường nhi|a
翔实=tỉ mỉ xác thực|a
翔空=tường không|a
耀明=Diệu Minh|a
耀白=diệu bạch|a
耀眼=loá mắt/chói mắt|a
老大=lão đại/về già/lúc già/khi già/anh cả/người chèo đò/người đưa đò/rất/vô cùng|a
老弱=già yếu|a
老辣=cay độc/đanh đá chua ngoa/cay nghiệt/lão lạt|a
耐久=bền bỉ/bền lâu/bền|a
耐劳=chịu được vất vả/chịu khó|a
耐受=chịu đựng/nại thụ|a
耐寒=chịu rét/chịu lạnh|a
耐心=kiên nhẫn/kiên trì/nhẫn nại/bền bỉ|a
耐火=chịu lửa|a
耐烦=kiên nhẫn/bình tĩnh/chịu khó/bền chí|a
耐热=chịu nhiệt|a
耐用=dùng bền|a
耐看=nén lòng mà nhìn/nén lòng mà nhìn xem lần hai|a
耐磨=chịu mài mòn|a
耳熟=quen tai|a
聒噪=ồn ào/om sòm/tiếng huyên náo|a
聒耳=đinh tai nhức óc/điếc tai|a
聪悟=thông ngộ|a
聪慧=thông minh/thông tuệ/sáng suốt/trí tuệ/sáng sủa|a
聪敏=thông minh/minh mẫn/khôn ngoan/sắc sảo/thông mẫn|a
聪明=thông minh/nhạy bén/minh mẫn/khôn ngoan/sắc sảo|a
聪颖=thông minh/sáng suốt/sáng trí/minh mẫn/thông dĩnh|a
肃容=nghiêm túc/vẻ mặt - nghiêm túc/cung kính/trang nghiêm/nghiêm mặt|a
肃然=nghiêm nghị/cảm thấy kính nể|a
肃穆=túc mục/trang nghiêm/nghiêm túc và trang trọng/nghiêm túc và trang trọng/nghiêm túc|a
肃静=yên lặng|a
肃顺=Túc Thuận|a
肉坦=tank trâu|a
肉嫩=thịt mềm|a
肉疼=thịt đau/nhức nhối|a
肉碎=thịt vụn|a
肉糙=thịt thô|a
肉贵=thịt mắc|a
肤泛=nông cạn/thiển cận|a
肤浅=nông cạn/hạn hẹp/phu thiển|a
肥厚=đầy đặn/to mà dày đặc/to/lớn/sưng tấy/phình/màu mỡ/phì nhiêu/nhiều/tốt/đáng kể|a
肥壮=béo tốt/béo khoẻ|a
肥大=to béo/dài rộng/rộng/to/đẫy đà/lớn/sưng tấy/phình to/béo mập|a
肥嫩=mập mạp/phì nộn|a
肥实=mập/béo/béo tốt/mập mạp/chất béo/mỡ/giàu có/có tiền|a
肥差=công việc béo bở/phì soa/công việc béo bở|a
肥强=to khỏe|a
肥沃=phì nhiêu/màu mỡ|a
肥瘦=béo gầy|a
肥矮=béo lùn|a
肥硕=to mọng/mẩy/to mập/to/phì thạc|a
肥缺=chức quan béo bở/chỗ kiếm được nhiều tiền|a
肥美=màu mỡ/béo khoẻ/phì nhiêu/dồi dào tươi tốt/ngon thơm/thơm ngon/phì mỹ|a
肥胖=mập mạp/mập/béo/béo phì/to béo|a
肥腻=béo ngậy/béo|a
肥鲜=tươi rói/tươi ngon|a
肮脏=dơ bẩn/dơ đáy/cáu bẩn/bẩn thỉu/bỉ ổi/hèn nhát/hèn hạ/thấp hèn/đê tiện/dơ/bẩn/dơ dáy/thối nát|a
胆壮=can đảm/gan dạ/dũng cảm/đảm tráng|a
胆大=gan lớn|a
胆寒=sợ hãi/sợ/sợ sệt/khiếp sợ/đảm hàn|a
胆小=nhát gan|a
胆怯=khiếp đảm/nhát gan/nhút nhát/sợ sệt|a
胆敢=dám can đảm/cả gan/dám cả gan/liều lĩnh/dám to gan|a
胆虚=nhút nhát/sợ sệt|a
背挺=ưỡn lưng|a
脆弱=yếu ớt/yếu đuối/mỏng manh/mảnh khảnh/không kiên cường/mảnh dẻ/dễ vỡ|a
脆快=dứt khoát/ngắn gọn/thẳng thắn/quả quyết/không dây dưa|a
脆皮=da giòn|a
脆笑=cười duyên|a
脆胧=thúy lông|a
脆脆=giòn giòn/trong vắt|a
脸嫩=mặt mỏng|a
腐恶=hung ác/hủ bại gian ác|a
腐旧=cũ kỹ/lỗi thời|a
腐朽=mục nát/mục/hủ bại/sa đoạ/đồi bại/thối nát|a
腐烂=rữa nát/hư thối/thối rữa/thối nát/mục nát/hủ bại/đồi bại/sa đoạ/hư hỏng/hỗn loạn/đen tối/suy bại|a
腐熟=ủ phân xanh|a
腥甜=ngai ngái|a
腥膻=tanh nồng|a
腥臊=tanh tưởi/mùi tanh tưởi|a
腥臭=tanh hôi|a
腻烦=nhàm chán/ngấy/chán ghét/ghét/nhàm/chán|a
腻腻=nhơn nhớt|a
腼腆=ngại ngùng/thẹn thùng/xấu hổ/e lệ/mắc cỡ|a
臃肿=cồng kềnh/mập mạp/béo phì/béo phệ/cồng kềnh khó điều khiển/sưng vù|a
自乐=tự nhạc|a
自傲=tự ngạo/tự kiêu/kiêu ngạo|a
自净=lọc/tự tịnh/tự làm sạch/tự thanh lọc|a
自利=tự lợi/tự lợi ích/Lo lợi ích cho chính mình.|a
自大=tự đại/kiêu căng/kiêu ngạo/ngạo mạng/từ đại|a
自娱=tự tiêu khiển/tự giải trí|a
自惭=xấu hổ/hổ thẹn/lấy làm xấu hổ/cảm thấy xấu hổ|a
自晦=tự hối|a
自洁=tự khiết|a
自满=tự mãn|a
自爆=tự bạo|a
自狂=tự cuồng|a
自由=tự do|a
自疚=ray rứt trong lòng/áy náy trong lòng|a
自矜=khoe khoang/khoa trương|a
自私=tự tư/ích kỷ|a
自足=tự mãn/hài lòng/thoả mãn/vừa ý/tự túc|a
自适=thanh thản/thoải mái|a
自重=tự trọng/đề cao/nâng cao/trọng lượng/nặng|a
致密=tỉ mỉ/tinh vi/chặt chẽ|a
致富=làm giàu/trí phú|a
致柔=trí nhu|a
致远=trí viễn|a
致郁=uất ức|a
舒乏=giải mệt|a
舒坦=thoải mái/dễ chịu|a
舒尽=được xả hết/được dãn hết ra|a
舒张=thư giãn|a
舒心=thư thái/hài lòng/thoải mái/thư tâm|a
舒懒=thư lại|a
舒散=hoạt động gân cốt/hoạt động thư giãn/giảm bớt/nguôi ngoai/bớt đi|a
舒服=dễ chịu/thoải mái/khoan khoái|a
舒柔=Thư Nhu|a
舒爽=sảng khoái|a
舒畅=thư sướng/khoan khoái/dễ chịu/nhẹ nhàng/thoải mái/khoan khoái dễ chịu|a
舒缓=thư giãn/ung dung|a
舒适=thoải mái dễ chịu/thư thích/thư thái/dễ chịu/thoải mái/khoan khoái|a
舒醒=thức tỉnh|a
舒默=Thư Mặc|a
般定=đóng chặt|a
般配=xứng/hợp/tiện/môn đăng hộ đối/xứng đôi|a
般重=nặng như/nặng|a
良主=lương chủ|a
良久=thật lâu/một lúc lâu/rất lâu/hồi lâu|a
良伟=Lương Vĩ|a
良善=lương thiện|a
良好=tốt đẹp/hài lòng/tốt/tốt lành/lương hảo|a
良心=lương tâm|a
良薄=lương bạc|a
良配=lương phối|a
艰危=gian nguy/gian nan và nguy hiểm/khó khăn và hiểm nghèo|a
艰困=khó khăn gian khổ/gian khốn|a
艰巨=gian khổ/nặng nề/khó khăn/gay go/gian cự|a
艰涩=không lưu loát/tối nghĩa/gian sáp|a
艰深=thâm thuý/khó hiểu|a
艰苦=gian khổ/khó khăn gian khổ/gian nan khổ cực|a
艰辛=gian khổ/vất vả/khó khăn|a
艰险=gian nguy/nguy nan/khó khăn nguy hiểm/gian hiểm|a
艰难=gian nan/khó khăn/gian khổ/khốn khổ/chật vật|a
艳丽=diễm lệ/tươi đẹp/xinh đẹp|a
艳俗=diễm tục|a
艳名=diễm danh/tên đẹp|a
艳后=diễm hậu|a
艳媚=diễm mị|a
艳满=diễm mãn|a
艳福=diễm phúc|a
艳美=diễm mỹ|a
艳艳=diễm diễm|a
节俭=tiết kiệm/khổ hạnh/căn cơ/thanh đạm|a
节烈=tiết liệt|a
芜劣=rối rắm/rườm rà|a
芜杂=rườm rà/rối rắm|a
芜秽=rậm rạp/um tùm|a
苍冥=Thương Minh|a
苍凉=thê lương/im lìm vắng vẻ|a
苍劲=cứng cáp/rắn rỏi/già dặn/mạnh mẽ/thẳng đứng/cao vút|a
苍哑=thương ách|a
苍松=thương tùng|a
苍梧=Thương Ngô/Quận Cangwu ở Wuzhou 梧州 [Wu2 zhou1], Quảng Tây|a
苍老=già nua/già cỗi/già/cứng cáp/rắn rỏi/già dặn/mạnh mẽ/chắc khoẻ|a
苍郁=um tùm/rậm rạp/sum suê/xanh tốt/xanh ngát|a
苛刻=hà khắc/ngặt nghèo/khắc nghiệt/xét nghiệt ngã|a
苛杂=sưu cao thuế nặng/thuế má nặng nề|a
苛细=tủn mủn/vụn vặt|a
苦功=khổ công/gắng sức/chịu khó|a
苦劳=khổ lao|a
苦恼=buồn rầu/khổ não/khổ/phiền não|a
苦慈=Khổ Từ|a
苦挨=khổ ải/cố nhịn|a
苦楚=khổ sở/đau đớn/đau khổ|a
苦活=khổ hoạt|a
苦涩=đắng chát/khổ sáp/cay đắng/đắng chát/khổ tâm/đau khổ/nỗi khổ trong lòng/khổ sở|a
苦熬=chịu khổ/khổ cực|a
苦痛=đau khổ/sự chua cay/sự cay độc/dày vò/dằn vặt|a
苦练=khổ luyện|a
苦苦=đau khổ/khổ sở/khốn khổ/hết lời/hết sức/tận lực/khổ khổ|a
苦闷=buồn khổ|a
苦难=cực khổ/gian khổ/khổ nạn|a
英烈=anh liệt/anh dũng/oanh liệt/liệt sĩ anh dũng hy sinh|a
茁壮=khỏe mạnh/khoẻ/chắc nịch/mập mạp/truất tráng|a
茁实=vạm vỡ/to lớn mạnh khoẻ/tráng kiện|a
茁长=phát triển mạnh/mọc khoẻ/tươi tốt/rậm rạp|a
茂公=Mậu Công|a
茂密=rậm rạp/tươi tốt/um tùm|a
茂才=Mậu Tài|a
茂盛=tươi tốt/xanh tươi|a
荏弱=yếu đuối/mềm yếu/nhu nhược|a
荒僻=hoang vắng/hoang vu/hiu quạnh/quạnh quẽ/hoang tích/nơi hoang hủy hẹp hòi/văn chương dùng chữ điển tích quái quỷ người ta ít biết|a
荒凉=hoang vu/hoang vắng/hoang liêu/vắng lạnh|a
荒唐=hoang đường/vô lý/phóng đãng/hoang đàng/bừa bãi|a
荒寂=hoang vắng/hoang liêu/hoang sơ vắng vẻ|a
荒寒=hoang vắng lặng lẽo/hoang vắng lạnh lẽo|a
荒废=hoang phế/hoang hoá/bỏ hoang/xao lãng/xao nhãng/bỏ bê/lãng phí/bỏ phí/phí|a
荒惊=hoang vu|a
荒旱=hạn hán đói kém|a
荒歉=mất mùa|a
荒淫=hoang dâm/dâm đãng|a
荒疏=xao nhãng/xao lãng|a
荒瘠=hoang vu cằn cỗi|a
荒老=hoang lão|a
荒芜=hoang vu/hoang vắng|a
荒茫=hoang vắng mờ mịt/hoang vu mênh mang|a
荒莽=hoang mãng|a
荒蛮=hoang man|a
荒诞=hoang đường/vô cùng hoang đường/vô lý|a
荒谬=hoang đường/vớ vẩn/sai lầm/vô lý/vô cùng sai lầm/xằng bậy|a
荣重=vinh trọng|a
荧惑=mê hoặc/sao hoả/hoả tinh|a
荫凉=mát mẻ/râm mát|a
荫蔽=che lấp/che phủ/ẩn nấp/ẩn náu|a
莹然=oánh nhiên|a
莹莹=oánh oánh/trong suốt|a
萧和=tiêu hòa|a
萧怒=Tiêu Nộ|a
萧杀=tiêu sát|a
萧条=tiêu điều/đìu hiu/không có sinh khí/suy thoái|a
落俗=tục tĩu/thể hiện hương vị kém|a
落单=lạc đàn|a
落后=lạc hậu/rớt lại phía sau/chậm hơn kế hoạch/rơi ở phía sau|a
落套=cũ rích/rập khuôn/không có sáng tạo mới|a
落实=chứng thực/chắc chắn/đầy đủ/chu đáo/làm cho chắc chắn, đầy đủ chu đáo/yên ổn/thanh thản/lạc thật|a
落寞=cô đơn/vắng vẻ/vắng tanh/hiu quạnh/tẻ ngắt/tịch mịch|a
落差=chênh lệch/mức nước chênh lệch của lòng sông so với mặt biển/lạc soa|a
落难=gặp rủi ro/mắc nạn/gặp nạn/lâm vào cảnh khó khăn|a
落魄=nghèo túng/chán nản/tinh thần sa sút/phóng khoáng/tự nhiên/lạc phách|a
著名=trứ danh/nổi tiếng/có tiếng/nổi danh|a
著急=lo lắng/sốt ruột/cuống cuồng|a
著称=trứ danh/nổi tiếng/nổi danh|a
葳儿=Uy Nhi|a
葳蕤=sum sê/tươi tốt|a
蒙胧=lờ mờ|a
蒙蔽=che đậy/giấu kín/mông tế/che mờ|a
蓬乱=rối tung/bù xù|a
蓬松=xoã tung/rối bù|a
薄利=ít lời lãi/ít lời/ít lãi|a
薄厚=độ dày/dày mỏng/độ dầy/dầy mỏng|a
薄名=chút danh mỏng|a
薄幸=phụ bạc/phụ lòng phụ bạc/bạc hạnh/bạc tình bạc bẽo/phụ lòng/bạc tình/bạc bẽo|a
薄弱=yếu kém/bạc nhược/không hùng hậu/thất bại/không kiên cường/dao động|a
薄暗=chạng vạng/nhá nhem/gần/sắp tối/gần tối|a
薄脆=bánh quế/bánh rán giòn|a
薄薄=hơi mỏng/thật mỏng/mỏng manh|a
虔信=ngoan đạo/tin vào/sự tận tâm|a
虔心=kiền tâm/lòng sùng đạo|a
虔敬=cung kính/kính cẩn|a
虔诚=thành kính/ngoan đạo|a
虚伪=dối trá/không thật/giả dối/đạo đức giả|a
虚假=hư giả/giả tạo/giả dối|a
虚名=hư danh|a
虚套=giả dối|a
虚妄=hư ảo/vô căn cứ/không có căn cứ/hư vọng|a
虚实=hư thực/hư thật/hư và thực|a
虚张=hư trương|a
虚弱=suy yếu/yếu ớt/yếu|a
虚惊=sợ bóng sợ gió/sợ chuyện không đâu/hư kinh|a
虚淡=phai mờ|a
虚热=hư nhiệt|a
虚眼=hư nhãn|a
虚胖=mập giả tạo/mập giả|a
虚荣=hư vinh|a
蛮低=rất thấp|a
蛮劲=man kình|a
蛮勇=liều lĩnh|a
蛮圣=Man thánh|a
蛮多=rất nhiều|a
蛮大=rất lớn/quá lớn|a
蛮好=rất tốt|a
蛮横=ngang ngược/xúc phạm/thô bạo/ngang như cua/cậy mạnh|a
蛮蛮=thô bạo/man rợ|a
蠢笨=vụng về/lù đù/lóng ngóng/ngu xuẩn|a
蠢蠢=ngo ngoe/chậm chạp/nhích từng bước/uể oải/thẫn thờ/lộn xộn/hỗn loạn/bất an/náo động/uốn éo|a
蠢钝=xuẩn độn|a
血勇=huyết dũng|a
血厉=Huyết Lệ|a
血壮=huyết tráng|a
血爆=huyết bạo|a
血狂=huyết cuồng|a
血腥=huyết tinh/máu tanh/tanh mùi máu/đẫm máu|a
血般=như máu|a
衝力=thúc đẩy|a
衰劲=suy kình|a
衰弱=suy yếu/suy nhược|a
衰微=suy vi/suy bại|a
衰朽=suy sụp/già yếu/suy hủ|a
衰老=già yếu|a
衰飒=suy yếu/suy bại/lụn bại/sa sút/sút kém|a
被单=cái chăn/bị đơn/drap trải giường/chăn đơn/tấm đệm/ra/drap trải giường/tấm phủ chăn/cái mền|a
被吃=bị ăn/được ăn|a
被困=bị nhốt/bị kẹt|a
被外=bị ngoại/ngoài chăn|a
被套=vỏ chăn/túi chữ nhật/ruột chăn bông/bị lừa|a
被废=bị phế|a
被缛=chăn mền lộn xộn|a
被骇=bị kinh hãi|a
褊急=nóng nảy/hấp tấp/hẹp hòi|a
褊狭=chật hẹp/hẹp hòi/nhỏ hẹp/eo hẹp/nhỏ nhen/nghèo nàn|a
褊窄=hẹp/chật hẹp/hẹp hòi/thiển cận/ích kỷ|a
要功=tranh công|a
要好=muốn tốt/có quan hệ tốt/tốt/hay/thân nhau/cầu tiến/tốt hơn/muốn xịn/thân thiết|a
要好看=muốn trông tốt/bắt làm trò hề|a
要忙=phải bận rộn|a
要急=phải gấp|a
要挺=muốn ủng hộ|a
要闹=muốn ồn ào|a
讨巧=gặp may/được hời|a
识微=thức vi|a
诙谐=khôi hài/hài hước|a
诚实=thành thật/thành thực/không giả dối/trung thực/chính xác/đúng đắn|a
诚心=thành tâm/lòng thành/sự thật lòng/thật tâm/chân tình/thành khẩn|a
诚恳=thành khẩn/chân thành/trung thực/tận tuỵ|a
诚惊=thành kính|a
诚意=thành ý/lòng thành/thành tâm/ngay thật/thật thà|a
诚挚=chân thành/thân ái/đứng đắn/nghiêm chỉnh/sốt sắng/tha thiết/thành khẩn|a
诚敬=thành kính|a
诚服=tâm phục khẩu phục/phục lăn/thần phục|a
诚朴=thành thật/chất phác/thật thà/lương thiện/chân thật|a
诚笃=chân chất/chân thực/chân thành/lương thiện/thật thà|a
诡奇=kỳ dị/kỳ lạ/kỳ quái|a
诡幻=dị thường|a
诡异=quỷ dị/kỳ dị/kỳ lạ|a
诡怪=quái dị/quái đản|a
诡秘=quỷ bí/bí hiểm|a
诡称=ngụy tạo/giả dối/phịa ra|a
诡笑=nụ cười quỷ quyệt/nụ cười giả tạo/quỷ tiếu|a
诡诈=giảo quyệt/xảo quyệt/lừa bịp/gian trá/gian xảo/quỷ trá|a
诡诞=hoang đường/vô lý|a
诡谲=quỷ quyệt/biến hoá kỳ lạ/cổ quái/kỳ quái/giảo quyệt/gian trá/gian xảo/gian lận/xảo quyệt|a
诡辣=quỷ lạt|a
诡辩=quỷ biện/nguỵ biện/cãi bướng/cãi chầy cãi cối|a
详和=tường hòa|a
详密=tỉ mỉ chặt chẽ|a
详尽=tường tận/đầy đủ|a
详情=tường tình/tình hình cụ thể và tỉ mỉ|a
详明=tỉ mỉ rõ ràng|a
详详=tường tận|a
诧事=việc lạ|a
诧叹=tán thưởng|a
诧异=kinh ngạc/vô cùng kinh ngạc/rất ngạc nhiên|a
诧愕=sửng sốt|a
诧然=ngạc nhiên|a
诧讶=ngạc nhiên|a
诧道=lấy làm lạ hỏi|a
诱耳=dụ tai|a
调谐=hài hoà/điều chỉnh sóng|a
谐和=hài hoà/cân đối|a
谐美=hài hoà đẹp đẽ|a
谙熟=thông thạo|a
谙练=lành nghề/thành thạo/thuần thục/lão luyện/rành/sành sỏi/giàu kinh nghiệm|a
谦儿=Khiêm Nhi/Khiêm nhi|a
谦卑=khiêm tốn/khiêm nhường/nhún nhường|a
谦和=khiêm tốn/hòa nhã/khiêm tốn nhã nhặn|a
谦恭=khiêm cung/khiêm tốn/khiêm nhường|a
谦虚=khiêm tốn/khiêm nhường/nhã nhặn/lời khiêm tốn/lời khiêm nhường|a
谦逊=khiêm tốn/nhũn nhặn|a
谨严=nghiêm chỉnh/chặt chẽ/nghiêm ngặt|a
谨听=xin nghe|a
谨守=cẩn thủ/tuân thủ nghiêm ngặt|a
谨密=cẩn thận/thận trọng/tỉ mỉ|a
谨慎=cẩn thận/thận trọng/dè dặt|a
豁亮=rộng rãi/sáng sủa/trong trẻo|a
豁朗=rộng mở/rộng rãi|a
豁达=rộng rãi/rộng lượng/độ lượng/khoát đạt|a
豪兴=hào hứng/hứng thú/thích thú|a
豪勇=hào dũng|a
豪华=xa hoa/phô trương/xa xỉ/hoang phí/lộng lẫy/rực rỡ/tráng lệ/sang trọng|a
豪壮=hùng tráng/hào hùng/hào tráng|a
豪奢=hào hoa xa xỉ|a
豪富=hào phú/kẻ giàu có quyền thế/kẻ giàu có/kẻ quyền thế|a
豪强=hào cường/ngang ngược/ngang tàng/cường hào/cậy thế nạt người/cường hào ác bá|a
豪朗=Roland|a
豪横=ngang tàng/dùng quyền hiếp đáp người/cậy thế nạt người|a
豪爽=hào sảng/hào phóng/rộng rãi/thẳng thắn/ngay thẳng phóng khoáng/phóng khoáng|a
豪迈=phóng khoáng/dũng cảm/khí phách hào hùng/hào hùng/hào phóng/hào mại|a
豪阔=hào phóng/phóng khoáng|a
贞淑=Trinh Thục|a
贤劳=cần cù chăm chỉ|a
贤契=hiền khế/bạn hiền|a
贤惠=hiền lành/tốt/hoà nhã lịch sự/phụ nữ có đức hạnh/hiền huệ|a
贤淑=hiền thục/ hiền lành|a
贤良=hiền lương/có tài đức/người có tài đức|a
贤达=hiển đạt/người tài đức, người có danh vọng/người có địa vị|a
贪利=tham lợi|a
贪功=tham công|a
贪吃=tham ăn|a
贪名=tham danh|a
贪多=ham hố/ham nhiều|a
贪婪=tham lam/lòng tham không đáy/không biết chán|a
贪小=ham món lợi nhỏ/ham của rẻ|a
贪楚=tham lam|a
贪鄙=tham lam hèn hạ|a
贫乏=bần cùng/nghèo túng/túng quẫn/túng/túng thiếu/thiếu hụt/thiếu thốn|a
贫困=nghèo khó/bần cùng/nghèo túng/túng quẫn/nghèo khốn|a
贫富=giàu nghèo|a
贫寒=bần hàn/đói rét|a
贫弱=nghèo nàn/kém phát triển|a
贫瘠=cằn cỗi/thiếu dinh dưỡng/bạc màu|a
贫穷=nghèo khó/bần cùng/nghèo túng/nghèo khổ/cùng khổ|a
贫贱=nghèo hèn/nghèo khổ/bần tiện|a
贴切=chuẩn xác/xác đáng/chắc chắn/thích hợp/thoả đáng/khít khao|a
贴耳=áp tai|a
贵秀=quý tú|a
费劲=tốn sức/lao lực/gay go/vất vả|a
赤贫=nghèo rớt mùng tơi/nghèo rớt/nghèo nàn cơ cực|a
超厚=siêu dày|a
超巨=vô cùng lớn|a
超薄=siêu mỏng/mỏng dính|a
跋扈=ương ngạnh/bướng bỉnh/ngang ngược/tàn ác/độc đoán/hống hách/bạt hỗ|a
跷蹊=kì quái/kì quặc/đáng ngờ|a
踏实=an tâm/kiên định/thực tế/chân thật|a
踏平=san bằng/đạp bằng|a
踏足=đặt chân|a
蹊跷=kỳ quặc/kỳ hoặc/kỳ lạ|a
蹩眉=nhíu mày|a
蹩脚=sứt sẹo/xấu/tồi/kém chất lượng/kém bản lĩnh|a
蹭撞=mài va|a
蹭蹬=lận đận/lao đao/long đong/vấp váp/trắc trở/ba chìm bẩy nổi/bị cọ sát nhiều/khó khăn|a
躁动不安=bồn chồn bất an/bồn chồn|a
躁急=nóng gấp|a
躁热=sốt nóng/nóng khô/nóng nực|a
躁狂=táo cuồng/hưng cảm/phấn khích|a
软功=nhuyễn công|a
软弱=mềm yếu/yếu đuối/yếu ớt|a
软柔=mềm mại|a
软硬=cứng mềm|a
软软=mềm mềm/mềm nhũn/mềm/mềm mại/êm dịu/êm ái/yếu đuối/nhu nhược/yếu ớt|a
轻伤=vết thương nhẹ/bị thương nhẹ|a
轻佻=ngả ngớn/không nghiêm túc/lẳng lơ/khinh bạc|a
轻便=nhẹ nhàng/nhẹ nhàng tiện lợi/nhẹ/tiện/dễ dàng/khinh tiện|a
轻功=khinh công|a
轻匀=khinh quân|a
轻喝=quát nhẹ|a
轻壮=khinh tráng|a
轻巧=nhẹ nhàng linh hoạt/nhẹ/nhẹ nhàng/đơn giản dễ dàng|a
轻怠=khinh đãi|a
轻捷=nhanh nhẹn/thoăn thoắt/lanh lẹ|a
轻易=tuỳ tiện/dễ dàng/đơn giản|a
轻曼=khinh mạn|a
轻松=nhẹ nhõm/dễ dàng/ung dung/thoải mái|a
轻柔=nhu hòa/mềm nhẹ/mềm mại/dịu dàng/nhẹ nhàng/êm ái|a
轻活=công việc nhẹ|a
轻浮=lỗ mãng/lỗ mảng/nói năng tuỳ tiện/bạ đâu nói đấy/khinh phù/tùy tiện|a
轻灵=nhẹ nhàng/linh hoạt/thoải mái/khinh linh|a
轻熟=khinh thục|a
轻狂=khinh cuồng/hết sức lông bông/ngông cuồng|a
轻看=xem nhẹ/coi thường|a
轻薄=khinh bạc/mỏng manh/cợt nhả/chớt nhả|a
轻贱=coi khinh/hèn hạ/đê tiện/coi thường/coi rẻ|a
轻进=khinh tiến|a
轻重=nặng nhẹ/mức độ nặng nhẹ/chừng mực/mức độ thoả đáng|a
轻饶=khinh xuất tha thứ/dễ tha|a
较低=khá thấp/hơi thấp/thấp hơn|a
较劲=phân cao thấp/tranh/so/khăng khăng/cố chấp/giữ ý mình/so tài|a
较大=khá lớn/lớn hơn/trọng đại/chủ yếu/nhiều hơn|a
较小=nhỏ bé/nhỏ lại/hơn/nhỏ hơn/khá nhỏ|a
较差=độ chênh lệch/độ sai lệnh/hơi kém|a
较广=rộng hơn|a
较弱=yếu kém/yếu hơn|a
较强=khá mạnh/mạnh hơn|a
较慢=chậm chạp|a
较气=tranh hơi|a
较浅=kém cỏi/kém cỏi|a
较深=sâu hơn/đậm hơn/khá sâu|a
较热=hơi nóng|a
较熟=khá quen/giác thục|a
较白=hơi trắng|a
较真=chăm chỉ/đánh nhau/tích cực|a
较短=hơi ngắn|a
较矮=hơi lùn|a
较细=nhỏ|a
较胖=hơi mập|a
较色=nhân vật|a
较薄=khá mỏng|a
较近=khá gần/hơi gần|a
较重=khá nặng/nặng hơn|a
较长=dài/khá lâu/khá dài|a
较高=tương đối cao/khá cao/cao hơn|a
辉下=chiếu xuống|a
辉少=Huy thiếu|a
辉明=Huy Minh|a
辉煌=huy hoàng/xán lạn/rực rỡ|a
辉耀=huy diệu/chiếu sáng/soi sáng/tỏa sáng|a
辛烈=Tân Liệt|a
辛苦=vất vả/khổ cực/cực nhọc|a
辽阔=bao la/mở mang/bát ngát/mênh mông|a
迂拙=xuẩn ngốc/ngu dại/vụng về|a
迂阔=viển vông/không tưởng/không thiết thực/không thực tế|a
迅急=cấp tốc/rất nhanh|a
迅捷=mau lẹ/nhạy bén/nhanh chóng|a
迅达=Tấn Đạt|a
过严=quá nghiêm khắc|a
过巨=quá lớn|a
过熟=chín muồi/quá chín/qua giai đoạn sinh trưởng|a
过硬=quá cứng/vượt qua thử thách/vững vàng/vượt trội/nổi trội/trình độ vững vàng|a
近似=xấp xỉ/gần như/gần giống/na ná/từa tựa/giống nhau|a
近便=gần dễ đi|a
近利=cận lợi|a
近观=xem gần/nhìn gần|a
连体=liên thể|a
连切=liên tục cắt|a
连动=liên động/động liên tục/ngay cả động|a
连同=tính cả/kể cả/gộp lại|a
连挑=đâm liền|a
连捷=liên tiệp|a
连敬=liên tiếp mời|a
连横=liên hoành|a
连爆=liên tiếp nổ tung|a
连理=liền cành/tình vợ chồng/tình nghĩa vợ chồng|a
连累=liên lụy/liên luỵ/liên quan/dính líu/dính dáng|a
连结=liên kết/kết hợp|a
连续=liên tục/liên tiếp|a
连绵=liên miên/liên tục/không ngớt/liền nhau/không ngớt|a
连蹬=liên đạp|a
连通=liên thông/liền và thông nhau|a
迟则=chậm thì|a
迟恐=chậm sợ|a
迟滞=trì trệ/chậm chạp/lờ đờ/lững lờ/uể oải/lờ phờ/không hoạt bát/không nhanh nhẹn|a
迟笨=chậm chạp|a
迟钝=trì độn/chậm chạp/ì/trì trệ/không nhạy bén/không lanh lợi/chậm lụt|a
迥异=khác lạ/huýnh dị/khác biệt|a
迫切=bức thiết/cấp bách/khẩn cấp|a
迷乱=mê loạn|a
迷幻=mê huyễn|a
迷彩=ngụy trang/ngụy trang (*đổi màu)/nhiều màu sắc|a
迷惘=mê võng/không biết giải quyết thế nào/hoang mang/bối rối|a
迷漫=lan tràn/bao phủ|a
迷糊=mơ hồ/mơ mơ màng màng/lơ mơ|a
适好=thích hợp/vừa tốt|a
适宜=thích hợp/vừa phải/vừa tầm/vừa sức|a
适度=vừa phải/thích hợp|a
适当=thích hợp/thoả đáng/thích ứng|a
逍遥=tiêu dao/ung dung tự tại/thong dong/không bị ràng buộc|a
透亮=trong suốt/hiểu rõ/sáng/sáng sủa/rõ/thấu lượng|a
透湿=thấm ướt|a
透澈=thấu triệt|a
逗乐=chọc cười|a
逗趣=giải trí/pha trò|a
通畅=thông suốt/thông/lưu loát/trôi chảy|a
逼狭=hẹp/chật hẹp|a
遒劲=mạnh mẽ/khoẻ khoắn|a
遗憾=tiếc nuối/di hận/mối hận suốt đời/đáng tiếc/lấy làm tiếc|a
遗爱=Di Ái|a
遗缺=khuyết/bỏ trống|a
遥感=dao cảm/cảm ứng từ xa|a
遥见=ngóng thấy|a
遥远=xa xôi/rất xa/cách xa|a
遥遥=xa xa/xa/cách xa|a
遥阔=xa rộng|a
邈视=xem thường|a
邋遢=lôi thôi/lếch thếch/lề mề/nhếch nhác/dơ dáy|a
邪主=Tà chủ|a
邪乎=tà dị/quá tà dị/tà hồ/quỷ quái|a
邪功=tà công|a
邪厉=Tà Lệ|a
邪名=tà danh|a
邪异=tà dị|a
邪恶=tà ác/gian ác|a
邪正=tà chính|a
邪淫=tà dâm|a
邪眼=Tà Nhãn|a
邪祟=tà ma/tai hoạ|a
邪笑=cười tà/cười khẩy|a
邪邪=tà tà/không đàng hoàng/kỳ lạ/tà ma|a
郁悒=u sầu/buồn bực/đau khổ/uất ức|a
郁愤=buồn giận/tức giận|a
郁热=oi bức/oi ả|a
郁结=tích tụ/ứ đọng|a
郁郁=buồn bực/bóng bẩy/đẹp đẽ bóng bẩy/thơm nồng/ngào ngạt/xanh tươi/u tùm/buồn bực sầu não/um tùm|a
郁闷=phiền muộn/buồn bực/sầu não/buồn rầu/u sầu|a
郑重=trịnh trọng/nghiêm túc|a
鄙俗=thô tục/dung tục|a
鄙俚=quê mùa/quê kệch/dung tục|a
鄙薄=xem thường/xem nhẹ/xem khinh/khinh miệt/thiển lậu/hèn mọn|a
鄙贱=hèn mọn/thấp kém/ti tiện/đê hèn|a
鄙陋=quê mùa/bỉ lậu/hẹp hòi/thô lậu/kiến thức cạn nông|a
配单=phối đan|a
配套=nguyên bộ/đồng bộ/làm đồng bộ/làm cho hoàn chỉnh/phối sáo|a
配齐=phối tề|a
酣甜=nồng/say|a
酣畅=nhẹ nhàng vui vẻ/say sưa/sảng khoái/thoả thích/thích thú/hả hê/thoả chí/thoả thuê/say/hàm sướng|a
酣适=vui sướng dễ chịu|a
酥嫩=tô nộn|a
酥松=tơi xốp|a
酥柔=yếu mềm|a
酥脆=xốp giòn|a
酥软=mềm nhũn/rã rời/mềm yếu/yếu mềm/mềm mại|a
酷俏=tương tự|a
酷烈=khốc liệt/tàn khốc/tàn bạo/ác liệt/nồng/nồng nặc/nồng nàn/sực nức/rừng rực/dữ dội/mãnh liệt|a
酷热=khốc nhiệt/rất nóng/cực nóng/nóng như thiêu/thiêu đốt/khô nóng|a
酷酷=lạnh lùng|a
酸乏=đau mỏi|a
酸懒=mệt mỏi/uể oải|a
酸昧=hơi chua|a
酸楚=chua xót/chua xót khổ sở|a
酸涩=chua xót|a
酸甜=chua ngọt/chua ngọt|a
酸疼=đau buốt nhức/đau xót|a
酸苦=chua xót/đau xót|a
酸软=bủn rủn/mỏi nhừ|a
酸辛=đau xót/chua cay|a
醇厚=thuần hậu/nồng/đậm/đậm đà/thuần phát/thành thật chất phác|a
醇朴=chân thật/ngay thẳng/chất phác|a
醇烈=đậm|a
醒眼=rõ ràng/dễ thấy|a
醒豁=rõ ràng/sáng rõ|a
重不重=có nặng hay không|a
重伤=trọng thương/bị thương nặng|a
重似=nặng như|a
重利=lợi lớn/lãi nặng/lợi tức lớn/lợi nhuận cao/lợi nhuận nhiều/trọng tiền bạc/coi trọng tiền tài/trọng lợi|a
重名=trùng tên|a
重听=lảng tai/nặng tai/nghễnh ngãng/lãng tai|a
重坦=xe tăng hạng nặng|a
重大=trọng đại/to lớn/lớn lao/quan trọng|a
重孝=quần áo tang/quần áo đại tang|a
重定=bình định lại/trọng định|a
重建=trùng kiến/xây lại/xây dựng lại|a
重张=mở cửa trở lại|a
重彩=màu đậm|a
重心=trọng tâm/chủ yếu/cốt nặng|a
重振=trọng chấn/chấn chỉnh lại|a
重新=một lần nữa/lần nữa/lại lần nữa/từ đầu/làm lại từ đầu|a
重登=lại lên|a
重耍=trọng sái|a
重要=trọng yếu/quan trọng|a
重见=gặp lại/lần nữa thấy|a
重达=nặng đến|a
重重=trùng điệp/trùng trùng điệp điệp/trọng trọng/tầng tầng lớp lớp/chồng chất/ngổn ngang trăm mối/xứng đáng/nặng nề/tầng tầng|a
野蛮=dã man/không văn minh/không có văn hoá/ngang tàng bạo ngược|a
铮亮=sáng bóng|a
铮铮=tranh tranh/boong boong/leng keng|a
铿然=rào rào/róc rách/leng keng/lanh lảnh|a
锋利=sắc bén/sắn bén/sắc sảo|a
锋寒=phong hàn|a
锋快=sắc/nhọn/sâu sắc/sắc sảo|a
锋狂=phong cuồng|a
锋锐=sắc bén/phong duệ/sắc nhọn/sắc/nhọn/sắc sảo/tinh/dũng cảm tiến lên/tiến công khí thế/lao nhanh về trước/bén|a
锐利=sắc bén/lợi hại/sắc nhọn/sắc sảo|a
锐敏=nhạy bén/sắc bén/sắc sảo|a
错愕=kinh ngạc/hoảng hốt/giật mình/thảng thốt/ngạc nhiên|a
错杂=lẫn lộn/pha tạp/hỗn loạn/pha trộn/ô hợp/hỗn tạp/không đồng nhất|a
错谬=sai sót/sai lầm|a
镇痛=giảm đau|a
镇远=Trấn Viễn|a
镇静=trấn tĩnh/bình tĩnh/điềm tĩnh/giữ bình tĩnh|a
长劲=trường kình|a
长满=mọc đầy/dài khắp|a
长笑=cười dài|a
长胖=béo lên|a
长足=nhảy vọt/bước tiến dài/trường túc|a
闲杂=tạp vụ|a
闲适=thanh thản/thảnh thơi/nhàn hạ/thanh nhàn|a
闲雅=thanh tao lịch sự|a
闷倦=buồn bực mệt mỏi/buồn bã mệt mỏi|a
闷热=oi bức/ngột ngạt/oi ả/hầm hơi/nóng bức|a
闷笑=buồn cười|a
闷闷=rầu rĩ/buồn buồn|a
阔大=khoát đại/rộng lớn/bao la|a
阔绰=xa xỉ/khoát xước/rộng rãi/hào phóng/xa hoa|a
阔达=rộng đến|a
阴丧=âm tang|a
阴功=âm công/âm đức|a
阴劲=âm kình|a
阴挚=âm u|a
阴晦=u ám/âm hối|a
阴暗=âm u/tối tăm/u ám|a
阴柔=âm nhu|a
阴沉=âm trầm/u ám/âm u|a
阴涩=âm sáp|a
阴湿=ẩm thấp|a
阴诈=âm trá|a
阴郁=u ám/tối tăm phiền muộn/tối tăm/buồn rầu/u sầu/phiền muộn/âm úc|a
阴鸷=hung ác nham hiểm/âm chí/nham hiểm|a
陡削=vách đá/dốc đứng|a
陡峭=dốc đứng/đẩu tiễu/chót vót/dốc ngược/dốc/cao chót vót|a
陡峻=cao và dốc|a
陡盛=đẩu thịnh|a
险峻=hiểm trở/nguy hiểm|a
险恶=hiểm ác/hiểm ác đáng sợ|a
险要=hiểm yếu|a
险诈=nham hiểm thâm độc xảo trá|a
险隘=cửa ải hiểm yếu|a
隆情=tình cảm sâu đậm/tình sâu nghĩa nặng|a
隆重=long trọng/linh đình/trọng thể|a
随扈=tùy tùng|a
隐僻=hẻo lánh/xa xôi/khó hiểu mà hiếm thấy|a
隐妙=Ẩn Diệu|a
隐密=ẩn mật/kín đáo|a
隐晦=mịt mờ/khó hiểu/không rõ ràng|a
隐痛=nỗi khổ riêng/đau ngầm ngầm|a
隐秘=bí ẩn/che giấu/che giấu/giấu kín/việc bí mật/việc cơ mật|a
隐蔽=ẩn nấp/bí mật/ẩn náu/che phủ/che khuất/ẩn núp|a
隽永=sâu sắc/sâu xa/đầy ý nghĩa/có ý nghĩa/tuyển vĩnh|a
难吃=khó ăn|a
难宁=khó yên|a
难安=khó có thể bình an/khó an/bất an|a
难忍=khó nhịn|a
难懂=khó hiểu|a
难挨=khó chịu|a
难易=khó dễ|a
难混=khó lăn lộn|a
难熬=gian nan|a
难练=khó luyện|a
难饶=khó thể tha|a
雄伟=hùng vĩ/to lớn mạnh mẽ|a
雄健=khoẻ mạnh/chắc khoẻ|a
雄劲=hùng tráng khoẻ khoắn|a
雄厚=hùng hậu|a
雄壮=hùng tráng/to lớn mạnh mẽ|a
雄大=mạnh mẽ|a
雄奇=hùng kỳ/hùng vĩ|a
雄姿=oai hùng/tư thế hào hùng/tư thế oai hùng|a
雄武=Hùng Vũ|a
雄烈=Hùng Liệt|a
雄辩=hùng biện/biện luận vững vàng/có sức thuyết phục|a
雄阔=hùng khoát|a
雅俗=nhã tục|a
雅致=lịch sự tao nhã/nhã trí|a
雅趣=nhã thú/thú tao nhã/thú vui tao nhã|a
零乱=lộn xộn/thất thần/mất trật tự|a
零碎=vụn vặt/vặt vãnh/việc vặt vãnh/việc linh tinh/việc cỏn con/lẻ tẻ|a
露富=tỏ vẻ giàu có/khoe của|a
露怯=rụt rè/sợ hãi/ăn nói vụng về/lộ ra cái dốt, gây trò cười/lòi dốt ra|a
青涩=ngây ngô/trẻ trung/thanh sáp|a
青脆=giòn|a
靓丽=tịnh lệ/mỹ lệ|a
静松=Tĩnh Tùng|a
靠后=dựa vào sau/kháo hậu/thấp|a
靡丽=xa hoa/hoa lệ|a
靡靡=lả lướt|a
靦腆=thẹn thùng|a
顶大=rất to|a
顶好=rất tốt|a
顺畅=thông thuận/trót lọt/trôi chảy/thuận sướng|a
顽健=khoẻ dai/tráng kiện|a
顽劣=ngang bướng/bất hảo|a
顽固=ngoan cố/bảo thủ/gàn dở/lập trường phản động/không chịu thay đổi|a
顽强=ương ngạnh/ngoan cường|a
顽皮=tinh nghịch/bướng bỉnh/tinh quái/ranh mãnh|a
顽钝=ngu đần/ngu dốt/hèn nhát/cùn/lụt|a
频繁=tấp nập/nhiều lần/tới tấp/thường xuyên|a
颓丧=sa sút tinh thần/suy sụp tinh thần/mất tinh thần/đồi tang|a
颓唐=suy sụp tinh thần/mất tinh thần/chán nản/uể oải|a
颓废=đồi phế/chán chường/suy sụp tinh thần/sa sút tinh thần|a
颓靡=mất tinh thần/chán nản/buồn nản|a
颖异=thông minh hơn người/mới mẻ khác thường|a
颖颖=Dĩnh Dĩnh|a
颟顸=mù mờ/lơ mơ|a
颠沛=khốn cùng/nghiêng ngửa/hoạn nạn/nghèo khổ/khốn khó/bị vùi dập/điên phái|a
颠狂=điên cuồng/điên khùng|a
风凉=gió mát/thoáng mát/mát mẻ/phong lương|a
风大=gió lớn/to|a
风媚=phong mị|a
风烈=Phong Liệt|a
风靡=vang dội/thịnh hành/phổ biến|a
飘渺=phiêu miểu/mờ ảo/lúc ẩn lúc hiện/lúc có lúc không/như có như không|a
飘缈=phiêu miểu|a
饱和=bão hòa/bão hoà/no/chán ngấy/thoả mãn/đạt đến cực điểm/làm bão hoà|a
饱富=bão phú|a
香脆=thơm giòn/giòn|a
驯熟=hiền lành/biết phục tùng/thuần thục|a
驯良=hiền lương/hiền lành|a
驳杂=hỗn tạp/pha tạp/khác thể không đồng nhất/khác thể/không đồng nhất/bác tạp|a
驽钝=tối dạ/nô độn|a
驽顿=đần độn/chậm chạp|a
骁勇=dũng mãnh/kiêu dũng|a
骁悍=kiêu hãn|a
骄傲=kiêu ngạo/hãnh/kiêu căng/tự cao tự đại/ngạo mạn/tự hào/kiêu hãnh/niềm tự hào/niềm kiêu hãnh|a
骄固=kiêu ngạo ngoan cố/kiêu ngạo ngang bướng|a
骄奢=kiêu xa|a
骄慢=kiêu căng/ngạo mạn|a
骄横=kiêu hoành/ngang tàng/ngang ngược kiêu ngạo/hung hăng|a
骄气=kiêu ngạo tự mãn/vẻ kiêu căng/kiêu khí|a
骄狂=kiêu ngạo/không coi ai ra gì/xem thường người khác/kiêu căng|a
骄矜=kiêu căng/ngạo mạn|a
骄纵=kiêu căng/ngạo nghễ/xấc láo|a
骄躁=tự cao/cuồng vọng/tự cao tự đại|a
骇俗=hãi tục|a
骇怕=sợ hãi/sợ sệt|a
骇怪=kinh ngạc/kỳ lạ/quái lạ|a
骇惧=kinh sợ/sợ hãi/sợ sệt|a
高亢=cao vút/cao vang/vang vang/vang vọng/ngân vang/cao/cao ngạo/kiêu ngạo/kiêu căng|a
高低=cao thấp/độ cao/chiều cao/bề cao/hơn kém/nặng nhẹ/nông sâu/bất luận thế nào/dù sao/thế nào/cuối cùng/rốt cuộc|a
高傲=cao ngạo/kiêu ngạo/kiêu căng|a
高大=cao lớn/cao to/đồ sộ/lớn/cao|a
高妙=tuyệt diệu/tuyệt vời/điêu luyện/bậc thầy/khéo léo/tài tình/mưu trí|a
高峻=cao tuấn/cao và dốc|a
高忍=Cao Nhẫn|a
高挑=cao gầy|a
高效=hiệu suất cao/hiệu năng cao/hiệu quả cao/cao hiệu|a
高敞=cao lớn/cao to|a
高松=Cao Tùng|a
高洁=cao khiết/cao thượng/cao cả/trong sạch/cao quý/thanh cao/cao nhã/hào hiệp|a
高热=nhiệt độ cao/sốt cao/sốt|a
高爆=cao bạo|a
高爽=xanh trong|a
高瘦=cao gầy|a
高矮=chiều cao/bề cao/độ cao thấp/cao thấp|a
高笑=cười lớn|a
高老=Cao lão|a
高胖=cao mập|a
高贵=cao quý/cao cả/cao sang/quý phái/sang trọng|a
高足=cao túc/học trò giỏi|a
高跷=cà kheo/đi cà kheo/vểnh cao|a
高重=cao trọng|a
高难=yêu cầu cao/kỹ thuật cao/kỹ thuật khó|a
高高=cao cao/thật cao|a
高鼻=mũi cao|a
鬼秘=quỷ bí|a
鬼黠=xảo quyệt/xảo trá/gian xảo|a
魁伟=khôi vĩ/khôi ngô/to lớn/cao lớn/vạm vỡ/cường tráng|a
魁宏=rộng lớn|a
魁梧=khôi ngô/to lớn/cường tráng/vạm vỡ/lực lưỡng|a
魁硕=vạm vỡ|a
鲁钝=đần độn/ngu si|a
鲜亮=sáng rõ|a
鲜嫩=tươi non/tươi mới/tiên nộn|a
鲜少=hiếm khi|a
鲜明=tươi sáng/rõ ràng/tươi sáng rõ nét/tiên minh/tươi đẹp/rực rỡ/sáng rõ/rõ ràng dứt khoát/rõ nét|a
鲜活=tươi sống/tiên hoạt|a
鲜美=tươi ngon/tươi đẹp/ngon|a
鲜艳=tiên diễm/tươi đẹp|a
鲜见=biết trước/hiếm|a
鲠直=ngay thẳng/bộc trực/chính trực|a
麻大=ma đại|a
麻贵=Ma Quý|a
黏满=dính đầy|a
黏稠=đặc dính/niêm trù/sền sệt|a
黏糊=dính/quánh/sánh/chậm chạp/khờ khờ|a
黏结=dính vào nhau/kết lại với nhau|a
黏软=dính mềm|a
黑霉=nấm đen|a
默哀=mặc niệm|a
黯恶=đen đúa xấu xí|a
鼓燥=cổ táo|a
齐名=nổi danh/tên tuổi ngang nhau/nổi tiếng ngang nhau/cùng nổi danh|a
齐心=đồng lòng/đồng tâm/một lòng một dạ|a
齐整=chỉnh tề/gọn gàng/ngay ngắn/tề chỉnh|a
齐楚=chỉnh tề/nghiêm chỉnh/gọn gàng|a
齐活=đầy đủ/tề hoạt|a
齐爆=cùng nổ|a
齐警=Tề Cảnh|a
齐集=tụ tập đầy đủ/tập hợp đầy đủ/tập trung tất cả|a
龌蹉=dơ bẩn/bẽo|a
龌龊=bẩn thỉu/xấu xa/không sạch sẽ/nhơ nhớp/bẩn/đê hèn/bỉ ổi/hẹp hòi/câu nệ tiểu tiết|a
