严厉=nghiêm khắc/nghiêm nghị|ad
严实=chặt chẽ/kín/kín đáo|ad
严格=nghiêm ngặt/nghiêm khắc/chặt chẽ|ad
仓促=vội vàng/thương xúc/hấp tấp/nóng nảy/hối hả/vội vã/gấp gáp|ad
仓惶=hoảng hốt/thảng thốt/thương hoàng/thoảng thốt|ad
仔细=cẩn thận/tỉ mỉ/kỹ lưỡng/kỹ càng/thận trọng/tiết kiệm/tằn tiện|ad
侥侥=nghiêu nghiêu|ad
侥天=nghiêu thiên|ad
充分=đầy đủ/chu đáo/trọn vẹn/phong phú/dư dật/dồi dào/hết mức/hết sức/dốc sức|ad
充实=phong phú/đầy đủ/dư dật/dạt dào/tăng cường/bổ sung cho đủ/nâng cao chất lượng/làm phong phú|ad
全善=toàn thiện/toàn mỹ|ad
全开=toàn bộ triển khai/toàn bộ khai hỏa/cả trang in/toàn khai|ad
全接=sẵn sàng nghênh tiếp|ad
全然=hoàn toàn/đầy đủ/trọn vẹn|ad
全真=Toàn Chân/toàn chân|ad
全速=tốc độ cao nhất/hết tốc lực|ad
公决=cùng quyết định|ad
公开=công khai/đưa ra công khai|ad
公然=công nhiên/ngang nhiên/thẳng thắn/không kiêng nể gì/công khai|ad
切切=nhất thiết/phải/chú ý/nhớ/khẩn thiết/bức thiết/khe khẽ/thì thầm/thì thào|ad
切实=thiết thực/thực sự/thiết thật|ad
切开=mở ra/cắt ra|ad
切面=thiết diện/mì thái/mì sợi/mặt cắt/tiết diện/mặt phẳng tiếp xúc/mặt phẳng (mì)/mặt cắt|ad
努力=cố gắng/nỗ lực/gắng sức|ad
努心=gắng sức|ad
勤勉=cần cù/chăm chỉ/siêng năng|ad
及格=đạt tiêu chuẩn/hợp cách/hợp thức/hợp lệ/đạt yêu cầu/đạt chất lượng/cập cách|ad
坚决=kiên quyết/cương quyết|ad
坚实=kiên cố/vững chắc/vững vàng/khỏe mạnh/rắn chắc/cường tráng/khoẻ mạnh/kiên thật|ad
坦然=thản nhiên|ad
壮胆=tăng thêm lòng dũng cảm/đánh bạo/thêm can đảm|ad
大全=bách khoa toàn thư|ad
妥便=ổn thoả thuận tiện/thoả đáng tiện lợi|ad
妥实=thoả đáng/chắc chắn/ổn thoả|ad
完全=hoàn toàn/đầy đủ/trọn vẹn|ad
密切=mật thiết/làm cho gắn bó/làm cho gần gũi/cặn kẽ/tỉ mỉ/thấu đáo|ad
密实=kỹ càng/dày đặc/chặt chẽ|ad
密密=dày đặc/dầy đặc|ad
密接=sát gần nhau/áp sát|ad
彻底=triệt để/đến cùng/thẳng thắn/thẳng thừng/hoàn toàn/hệt như/rốt ráo|ad
慌忙=cuống quít/vội vàng/lật đật/cuống quýt/hấp tấp/vội vã/hoảng mang/vội vàng hấp tấp|ad
慌然=hoảng sợ/ luống cuống/luống cuống|ad
慷然=hùng hồn|ad
懦弱=nhu nhược/hèn yếu/hèn nhát/nhát gan|ad
明确=minh xác/rõ ràng/đúng đắn/làm sáng tỏ/xác định rõ/sáng tỏ|ad
明细=rõ ràng chi tiết|ad
显然=hiển nhiên/rõ ràng/dễ nhận thấy|ad
显目=rõ ràng/nổi bật/đập vào mắt|ad
显真=hiển chân/Hiển Chân|ad
普利=Phổ Lợi|ad
普遍=phổ biến/rộng rãi/rộng khắp|ad
果决=quả quyết/quả đoán|ad
正切=tang|ad
正式=chính thức|ad
正极=cực dương|ad
正确=chính xác/đúng đắn|ad
正面=chính diện/mặt trước/mặt chính/mặt ngoài/mặt phải/mặt tốt/mặt tích cực/bên ngoài/bề ngoài/trực tiếp/ngay mặt|ad
独胆=anh dũng/đơn độc tranh đấu|ad
狼式=hình sói|ad
狼格=lang cách|ad
狼皇=Lang Hoàng|ad
盲动=manh động|ad
直接=trực tiếp/thẳng|ad
直面=trực diện/nhìn thẳng vào/đối mặt|ad
确切=xác thực/chuẩn xác/xác đáng/chính xác/chắc chắn|ad
确实=xác thực/quả thực/chính xác/đích xác/thực sự/quả thật|ad
确然=chắc chắn|ad
确确实实=quả thật/xác xác thật thật/xác xác thực thực|ad
积久=tích luỹ lâu ngày/tích luỹ/tích trữ|ad
积分=điểm tích lũy/vi tích phân/tích phân học/tích phân/điểm|ad
积劳=vất vả lâu ngày/lao lực quá sức/lao lực lâu ngày|ad
积善=tích thiện/tích đức|ad
积弱=suy yếu lâu ngày/suy nhược lâu ngày|ad
积愤=cơn giận dồn nén|ad
积极=tích cực/hăng hái/tiến thủ/nhiệt tâm|ad
突然=đột nhiên/bỗng nhiên/bất thình lình/chợt|ad
紧接=tiếp theo|ad
草遍=thảo khắp|ad
认真=nghiêm túc/chăm chú/tưởng thật/tin thật/chăm chỉ/hẳn hoi|ad
详实=tỉ mỉ xác thực/tường thật|ad
详细=kỹ càng/kể lại/kỹ càng tỉ mỉ/cặn kẽ/tỉ mỉ|ad
踊跃=nô nức tấp nập/dũng dược/hăng hái/nhiệt tình/nhảy nhót/nhảy lên/nô nức/tấp nập|ad
迅猛=tấn mãnh/rất mạnh/nhanh chóng nhưng mãnh liệt/mạnh mẽ/mãnh liệt|ad
迅速=cấp tốc/nhanh chóng|ad
过细=cẩn thận/tỉ mỉ|ad
适时=hợp thời/đúng lúc|ad
顺便=thuận tiện/tiện thể/nhân tiện|ad
顺利=thuận lợi/suôn sẻ|ad
顺心=hài lòng/vừa ý/thuận tâm|ad
