冷暖=ấm lạnh/lạnh ấm|an
凶狈=Hung Bái|an
凶险=hung hiểm/nguy hiểm đáng sợ/hung ác nham hiểm|an
刚愎=bảo thủ/cố chấp/ngoan cố/ương ngạnh|an
卫生=vệ sinh/hợp vệ sinh|an
危惧=lo lắng/sợ hãi/lo sợ|an
危险=nguy hiểm/nguy cơ/có khả năng thất bại/tổn thất/mối nguy|an
危难=nguy nan/nguy hiểm và tai hoạ/nguy hiểm khó khăn|an
哀哀=buồn bã|an
困乏=mệt mỏi/mệt nhọc/khó khăn|an
困厄=khốn khó/khốn đốn/khốn cùng/túng quẫn|an
困恼=hãm cáu/buồn ngủ|an
困苦=khốn khổ/gian khổ/nghèo khổ/cực khổ/gian nan khổ cực/gian nan khốn khổ|an
困难=khó khăn/trắc trở/trở ngại/nỗi gay go/điều cản trở/điều trở ngại|an
安全=an toàn|an
安生=sống yên ổn/an định/yên/không sinh chuyện/an sinh|an
恐惧=sợ hãi/sợ sệt/hoảng hốt/hoảng sợ|an
恐慌=khủng hoảng/hoang mang/sợ hãi/hoảng sợ|an
悲苦=đau khổ/buồn đau/bi ai thống khổ|an
晦气=xúi quẩy/xui/không may/xui xẻo/đen đủi/vận đen/cú rũ/ủ rũ|an
温暖=ấm áp/ôn hòa/ấm/ấm cúng/sưởi ấm/làm ấm|an
烦苦=phiền não|an
烦难=khó khăn phức tạp|an
狠毒=ngoan độc/hung ác/ác độc/độc địa/độc ác/ác nghiệt|an
狼狈=chật vật/nhếch nhác/chẳng ra sao/thảm hại/bối rối/tán loạn/hỗn loạn|an
猥琐=hèn mọn/dung tục/hèn mọn bỉ ổi/bỉ ổi/bủn xỉn/hèn hạ/thô tục/thô bỉ|an
痛苦=thống khổ/đau khổ/đau đớn|an
矛盾=mâu thuẫn/mâu/phán đoán mâu thuẫn/mâu thuẫn nhau/đối lập nhau|an
累赘=vướng víu/trói buộc/gánh nặng/rườm rà/phiền toái/ thừa/rườn rà/lỉnh kỉnh|an
耐苦=chịu khổ|an
腐毒=hủ độc|an
腐气=hủ khí|an
腐生=hủ sinh/ăn rỗng|an
腐败=mục nát/hủ bại/thối rữa/hỏng/mục/ôi/thiu/cổ hủ/sa đoạ/hỗn loạn/đen tối|an
负疚=bứt rứt/áy náy/đau đớn trong lòng|an
贫苦=nghèo khổ/nghèo khó/túng quẫn|an
闲烦=nhàn phiền|an
零败=0 bại|an
麻烦=phiền phức/phiền toái/phiền hà/rầy rà/lôi thôi/phiền lòng|an
