一年生=nhất niên sinh/sống một năm/cây hàng năm/cây ngắn ngày|b
一年级=năm nhất/một năm|b
一接=vừa tiếp xúc với|b
一有=vừa có/có cái|b
一甲=một giáp|b
一等一=nhất đẳng/số một/cao cấp nhất|b
一线生机=một chút hi vọng sống|b
七型=Version 7|b
万红=Vạn Hồng|b
三兴=tam hưng|b
三合一=ba hợp một/gấp ba|b
三型=tam hình|b
三寒=Tam Hàn|b
三年生=tam niên sinh|b
三年级=năm ba/năm thứ ba|b
三星级=tam tinh cấp/cấp tam tinh/cấp ba sao|b
三栖=tam tê|b
三棱=ba cạnh/ba mặt|b
三点式=bikini|b
三生=tam sinh/ba đời|b
三甲=tam giáp/ba vị trí đầu|b
三级=cấp ba/ba cấp/ba bậc/Tam cấp|b
三营=Tam doanh|b
上下级=thượng hạ cấp/cấp trên cấp dưới|b
上层=thượng tầng/tầng trên/tầng lớp trên/cấp trên/bậc trên/cao tầng|b
上座率=tỉ lệ ngồi/tỷ lệ chỗ ngồi trên|b
上星期=tuần lễ trước/cuối tuần trước|b
上档次=cao cấp|b
上流=thượng lưu/thượng du|b
上篇=thượng thiên/ trang trước/trang trước/bản thượng|b
上级=thượng cấp/cấp trên|b
上述=kể trên/nói trên|b
下个=hạ cái/sau/tới/xuống cái|b
下中农=trung nông lớp dưới|b
下等人=người hạ đẳng/hạ đẳng người|b
下篇=hạ thiên/bản hạ|b
下级=hạ cấp/cấp dưới/cấp thấp|b
不正派=không chính phái|b
专一=một lòng/chuyên nhất/dốc lòng/không phân tâm|b
专列=xe riêng/xe chuyên dùng|b
专家级=chuyên gia cấp/cấp Expert-chuyên gia|b
专有=đặc biệt/độc đáo/duy nhất|b
专营=độc quyền bán hàng|b
丝甲=áo giáp tơ tằm|b
两强=lưỡng cường|b
两抵=triệt tiêu lẫn nhau/ngang nhau|b
两栖=lưỡng cư/lưỡng thê/công tác ở hai lĩnh vực/sinh hoạt trong hai lĩnh vực|b
两清=thanh toán xong|b
两立=cả hai cùng tồn tại|b
两腮=hai má|b
两造=hai bên/hai bên nguyên và bị|b
中低档=cấp trung kém|b
中低级=trung đê cấp|b
中型=cỡ trung/cỡ vừa/hạng vừa/trung hình/hạng trung|b
中小型=cỡ trung tiểu|b
中层阶级=tầng lớp trung lưu|b
中常=trung bình/bình thường/không tốt không xấu|b
中档=cấp trung/trung đương/chất lượng thường/chất lượng trung bình/giá cả trung bình|b
中立=trung lập|b
中等=trung đẳng/bên trong chờ|b
中篇=trung thiên/bản trung|b
中级=trung cấp|b
中途=nửa đường/trên đường/giữa đường/trung đồ|b
中频=trung tần/tần số trung tần|b
中高层=trung cao tầng|b
中高档=cao cấp xa hoa|b
中高级=trung cao cấp|b
临产=sắp sinh/trở dạ/sắp đẻ/sắp sinh|b
临头=trước mắt/ập lên đầu/gặp phải/xảy ra|b
临官=Lâm Quan|b
临时=lâm thời/tạm thời/đến lúc/đến khi|b
临时性=mang tính tạm thời/tạm thời|b
临机=gặp thời/nắm thời cơ|b
临清=Lâm Thanh/thành phố cấp quận Linqing ở Liaocheng 聊城 [Liao2 cheng2], Sơn Đông|b
临界=giới hạn/tới hạn|b
临走前=trước khi đi|b
临走时=lúc gần đi|b
临难=lâm nạn|b
主任=chủ nhiệm|b
主副=chủ phó|b
主办=chủ sự/người chịu trách nhiệm chính/người đứng ra tổ chức/làm chủ|b
主动=chủ động|b
主审=chủ thẩm|b
主导=chủ đạo|b
主役=nhân vật chính|b
主战=chủ chiến/phái chủ chiến/chủ trương phát động chiến tranh|b
主控=chủ điều khiển/chủ khống|b
主推=đẩy chính|b
主日=ngày của chúa/Ngày Chủ Nhật/Ngày sabát|b
主机=máy chủ/trưởng máy/máy bay dẫn đầu/máy chính/chủ cơ|b
主次=chủ thứ/chủ yếu và thứ yếu|b
主流=chủ lưu/dòng chính/chủ yếu/xu hướng chính/bản chất/trào lưu chủ yếu|b
主编=chủ biên/tổng biên tập/chủ bút|b
主营=chủ doanh/kinh doanh chủ yếu|b
主薄=chủ bạc|b
主要=chủ yếu/chính|b
乙等=Ất đẳng|b
二击=hai đòn|b
二合一=hai hợp một|b
二型=nhị hình/Version 2|b
二尖瓣=van hai lá/hai cánh nhọn|b
二年生=nhị niên sinh/học sinh năm hai/học sinh năm 2/cây trồng hai năm|b
二年级=năm hai/năm thứ hai|b
二强=nhị cường|b
二有=hai có/không có|b
二期=kì hai/giai đoạn 2|b
二流=nhị lưu|b
二环=nhị hoàn/vòng hai|b
二甲=nhị giáp|b
二等=nhị đẳng|b
二级=cấp hai/hai cấp/nhị cấp|b
二营=nhị doanh/hai doanh|b
二黄=Nhị Hoàng/nhị hoàng|b
五型=Version 5|b
五年级=ngũ niên cấp|b
五星级=cấp năm sao|b
五级=cấp năm/năm cấp/ngũ cấp|b
仿宋=phỏng Tống|b
优优=Ưu Ưu|b
优生=ưu sinh/đứa bé được nuôi dưỡng tốt|b
优等=ưu đẳng/loại ưu/hạng tốt/thượng đẳng/ưu hạng|b
优等生=học sinh xuất sắc|b
优越感=cảm giác ưu việt/cảm giác về sự ưu việt|b
伸缩性=thân súc tính|b
低层次=cấp độ thấp/cấp bậc thấp/tầng thấp|b
低年级=cấp thấp/lớp dưới|b
低档=cấp thấp/loại kém/đê đương|b
低等=cấp thấp/đê đẳng/bậc thấp/đẳng cấp thấp|b
低级=cấp thấp/cấp thấp/bậc thấp/đơn giản/cấp dưới/thấp hèn/thấp kém/không lành mạnh|b
低频=thấp tần/tần suất thấp/tần số thấp|b
便携=loại xách tay/tiện huề|b
便携式=xách tay/loại đơn giản/dạng đơn giản|b
便携性=tính tiện lợi|b
候补=dự khuyết/trừ bị/dự bị|b
假正经=giả vờ chính đáng|b
偌大=to lớn/to như vậy/to như thế/nhạ đại/lớn như thế|b
偶有=chợt có|b
先遣=tiền trạm/đi trước/tiên khiển|b
全天然=toàn thiên nhiên|b
八珍=Bát Trân|b
公共=công cộng/phổ biến/bình dân/cộng đồng|b
公推=cùng đề cử|b
公有=công hữu|b
六型=Version 6|b
六年级=năm lớp sáu/lớp sáu|b
共栖=cộng thê/ký sinh/hội sinh/cộng kí sinh|b
内在=nội tại/bên trong|b
冬歇期=kỳ nghỉ đông|b
出其=đưa ra|b
刀削=đao tước|b
分档=sắp xếp hồ sơ|b
刑事=hình sự|b
刑期=thời hạn thi hành án|b
划一=đồng dạng/nhất trí/nhất loạt/đồng loạt/đồng đều/đồng nhất/thống nhất/làm nhất trí|b
划时代=vượt thời đại/mở ra thời đại mới/đánh dấu thời đại mới|b
初交=sơ giao/mới quen/bạn sơ giao/người mới quen|b
初生=mới sinh/sơ sinh|b
初等=sơ đẳng/sơ cấp/cơ sở/cơ bản/ở giai đoạn đầu/nguyên thuỷ/đầu tiên|b
初级=sơ cấp|b
别墅式=kiểu biệt thự|b
前倾=nghiêng về phía trước/nghiêng về trước/nghiêng về phía trước|b
副厅级=phó thính cấp|b
副厅长=Phó thính trưởng|b
副县级=cấp phó huyện|b
副处级=phó xử cấp/cấp phó|b
副级=phó cấp|b
劣等=loại kém/hạng yếu|b
劣等生=học sinh kém/liệt đẳng sinh|b
劣级=cấp 28|b
助你=giúp ngươi|b
助兴=trợ hứng/giúp vui|b
助其=giúp đỡ|b
助燃=chất dẫn cháy|b
北纬=vĩ độ Bắc|b
半小时=nửa giờ|b
半锈=nửa rỉ|b
单一=đơn nhất/chỉ một/một loại/duy nhất/đơn độc|b
单个=một cái/một mình|b
单传=đơn truyền/con một mấy đời/dòng độc đinh/độc truyền|b
单列=viết ra từng điều/từng hạng mục|b
单反=máy ảnh DSL|b
单寒=phong phanh/hàn vi/nghèo hèn|b
单机版=phiên bản máy cá nhân|b
单篇=bài lẻ|b
单轨=đường sắt đơn tuyến|b
单选=đơn tuyển|b
单项=đơn hạng/thi đơn/môn thi cá nhân|b
即兴=ngẫu hứng/hứng/cao hứng/tức hưng|b
卵黄=lòng đỏ trứng|b
厅级=thính cấp|b
历届=kỳ trước/khoá trước/nhiệm kỳ trước/lịch giới|b
县处级=huyện xử cấp|b
县级=huyện cấp/cấp huyện|b
双击=song kích/double-click|b
双腮=hai má|b
双轨=đường sắt đôi|b
叫你=gọi ngươi/bảo ngươi|b
叫我=gọi ta/bảo ta/gọi|b
右倾=hữu khuynh/tư tưởng bảo thủ|b
合共=tổng cộng/gộp chung|b
同一=cùng một/đồng nhất/cùng/chung/thống nhất/nhất trí|b
同列=đồng liệt|b
同年级=cùng khối|b
同年龄=cùng tuổi|b
同期=cùng thời kỳ/đồng kỳ/cùng thời/cùng thời gian/cùng khoá|b
同等=ngang nhau/bằng nhau/như nhau/ngang hàng|b
同级=đồng cấp|b
后倾=nghiêng về phía sau/nghiêng về sau|b
吨级=tính bằng tấn|b
吨重=tấn nặng|b
唯一=duy nhất|b
唯二=duy nhị|b
唯心=duy tâm|b
唯我=duy ta/duy ngã|b
唯有=chỉ có|b
唯等=duy chờ|b
喷气孔=lỗ phun khí|b
喷薄=dâng lên/mọc lên/nhô lên/phún bạc|b
四型=Version 4|b
四年级=năm thứ tư/lớp bốn|b
固有=cố hữu/vốn có/sẵn có|b
国家级=quốc gia cấp/cấp quốc gia|b
国有=quốc hữu/sở hữu quốc gia/thuộc nhà nước/thuộc sở hữu nhà nước|b
国立=quốc lập/công lập/do nhà nước lập ra|b
在线=online/tại tuyến/sợi|b
填鸭式=nhồi vịt ăn/kiểu nhồi vịt/nhồi cho vịt ăn|b
外型=ngoại hình|b
外篇=ngoại thiên|b
多功能=nhiều chức năng|b
多寡=nhiều ít|b
多年生=cây lâu năm/cây nhiều năm|b
多彩=nhiều màu/nhiều màu sắc|b
多星期=nhiều tuần lễ|b
多有=có nhiều/có bao nhiêu|b
多用=dùng nhiều/đa dụng/hữu dụng/nhiều mục đích|b
多线程=đa luồng|b
大专生=sinh viên đại học|b
大中型=cỡ lớn cỡ trung/lớn và vừa|b
大中小=đại trung tiểu|b
大兴=đại hưng/rầm rộ/mạnh mẽ/hăng hái/hưng thịnh|b
大典=đại điển/lễ lớn/lễ mừng/lễ kỷ niệm/lễ|b
大型=cỡ lớn/đại hình/kiểu to/lớn/khổng lồ/loại cỡ lớn|b
大大=đại đại/thật to/sâu sắc/rất/quá/cực kỳ|b
大天级=Đại Thiên Cấp|b
大寒=đại hàn|b
大小=lớn nhỏ/đại tiểu/khổ/cỡ/cao thấp/lớn bé/người lớn và trẻ em/hoặc lớn hoặc nhỏ/lớn và nhỏ/to nhỏ|b
大小写=chữ hoa hay thường|b
大师级=đại sư cấp/cấp đại sư/đại sư cấp/cấp đại sư (cấp Master)|b
大年夜=giao thừa/đêm giao thừa|b
大接=đại tiếp|b
大清=Đại Thanh|b
大红=đỏ chót/đỏ thẫm/đại hồng|b
大营=đại doanh/doanh trại lớn/đại dinh|b
大葱=hành tây|b
大规模=đại quy mô/quy mô lớn|b
大黄=Đại Hoàng/đại hoàng/cây đại hoàng|b
天一=Thiên Nhất|b
天倾=trời nghiêng/họa trời|b
天寒=trời giá rét|b
天摇=thiên diêu|b
天然=thiên nhiên/tự nhiên|b
天蓝=màu xanh da trời/màu xanh biển|b
天遣=thiên khiển|b
头等=hạng nhất/hàng đầu/bậc nhất|b
奇珍=kỳ trân|b
嫡传=đích truyền/chính thống/nối dòng chính|b
嫣然=yên nhiên/thản nhiên/xinh đẹp|b
嫣红=đỏ bừng/đỏ tươi|b
嫩红=nộn hồng|b
嫩绿=xanh nhạt|b
嫩黄=vàng nhạt|b
孪生=sinh đôi/song sinh/sinh đôi|b
定个=định vị|b
定型=định hình/hình thức cố định|b
定级=xác định đẳng cấp/định bậc|b
家贫=nhà nghèo|b
对你=đối với ngươi|b
将你=đưa ngươi|b
小型=cỡ nhỏ/tiểu hình/loại nhỏ/mô hình nhỏ|b
小小=nho nhỏ|b
小抄=tài liệu/(chép bài)|b
小葱=hành lá/hành giống|b
小要=tiểu yếu|b
小规模=quy mô nhỏ/tiểu quy mô|b
履带式=kiểu bánh xích|b
崭亮=toả sáng|b
崭新=mới tinh/mới toanh/hoàn toàn mới|b
崭然=trội hẳn/cao vọt|b
巨型=cự hình/khổng lồ/to lớn/dáng vóc to|b
巨额=kếch xù/lớn/cự ngạch/lượng lớn|b
巾帼=cân quắc/phụ nữ/khăn trùm/nữ/khăn trùm|b
常用=thường dùng|b
常绿=thường xanh/xanh quanh năm|b
常规化=biến thành thủ tục quen thuộc|b
常轨=quỹ đạo thông thường/cách thông thường/con đường thông thường|b
年级=niên cấp/lớp|b
年载=năm tháng|b
广交=quảng giao/giao tiếp rộng|b
广寒=Quảng Hàn|b
广式=kiểu Quảng|b
广然=Quảng Nhiên|b
广甲=phổ biến giáp|b
废然=thất vọng/chán nản/chán chường/tiu nghỉu/buồn nản|b
开个=mở|b
异型=dị hình/dị dạng|b
弱档=nhược đương|b
弱的=yếu/yếu đích|b
强档=cường đương|b
彪形=cường tráng/lực lưỡng/vạm vỡ|b
往届=giới trước/vãng giới|b
御寒=chống lạnh/chống rét|b
微倾=hơi nghiêng|b
微型=vi hình/cỡ nhỏ/mini/mi ni/bỏ túi/loại nhỏ|b
微寒=lạnh xuống/hơi rét/hơi lạnh lẽo|b
微小=nhỏ bé/nhỏ li ti/nhỏ nhặt/bé nhỏ/bé tí/rất nhỏ/li ti/nhỏ xíu|b
微黄=hơi vàng|b
忘年交=bạn vong niên|b
忘性=bệnh hay quên/tính hay quên|b
快了=nhanh/sắp rồi/nhanh hơn|b
总共=tổng cộng/tất cả/cả thảy|b
恶寒=ác hàn/phát tởm|b
恶补=bù lại|b
惟一=duy nhất/độc nhất vô nhị/có một không hai|b
惟有=duy có/chỉ có/riêng có|b
慢性=mãn tính/mạn tính/tính chậm chạp/tính chậm|b
慢慢来=từ từ sẽ đến/từ từ đi|b
慢热型=mạn nhiệt hình|b
所困=vây khốn/khó khăn|b
所在=chỗ/nơi/chỗ tồn tại/ở chỗ đó/vị trí|b
所属=sở thuộc/tương ứng/thuộc quyền/sở tại/địa phương mình|b
所有=tất cả/sở hữu/hết thảy/vật sở hữu/toàn bộ/sở hữu tất cả|b
所用=sở dụng/sử dụng|b
所短=sở đoản|b
所谓=cái gọi là/vị/điều mà họ gọi là/nếu nói|b
所述=thuật|b
所重=coi trọng/giai tầng|b
手动档=hộp số sàn/số tay|b
手扶=tay vịn|b
手携手=tay cầm tay/tay trong tay/tay dắt tay|b
手摇=tay cầm|b
授时=đài thiên văn báo giờ/báo cáo thời gian chuẩn/lịch của chính phủ ban hành|b
教你=dạy ngươi|b
敞开式=kiểu mở rộng|b
敞篷=xe mở mui/sưởng bồng|b
整个=toàn bộ/cả/tất cả/cả thảy|b
整你=chỉnh ngươi/chơi ngươi|b
整型=chỉnh hình/toàn bộ hình dạng/số nguyên|b
整备=chỉnh bị/chỉnh đốn trang bị/chỉnh đốn và sắp đặt|b
整夜=cả đêm|b
整套=trọn bộ/cả bộ|b
整式=chỉnh thức|b
整形=chỉnh hình/tạo hình|b
整我=chơi ta|b
整日=cả ngày|b
整流=chỉnh lưu/điều chỉnh dòng điện từ điện AC ra điện DC|b
整篇=cả bản|b
整补=chỉnh đốn bổ sung|b
整装=chuẩn bị/chỉnh trang|b
断档=bán hết hàng/bán hết hàng hoá/đoạn đương|b
新一任=tân nhiệm/bổ nhiệm mới|b
新一届=khóa mới|b
新一期=một thời kì mới|b
新兴=mới phát/mới trỗi dậy/mới xuất hiện/tân hưng|b
新型=kiểu mới/loại mới/tân hình|b
新版=bản mới|b
新篇=phần mới|b
新绿=xanh mới|b
无中生有=từ không sinh có/vô trung sinh hữu/bịa đặt/từ không nói có/bịa đặt hoàn toàn/tự dưng dựng chuyện/ăn không nói có|b
无余=hoàn toàn/đầy đủ/trọn vẹn/không sót lại gì/không dư/không dư thừa/vô dư|b
无形=vô hình/không trông thấy/vô hình trung|b
无性=vô tính|b
无期=vô hạn/không hẹn/không vời|b
无氧=không dưỡng khí/không có oxy/một môi trường không có oxy|b
无私=vô tư/không vụ lợi/không cầu lợi|b
无类=không loại|b
无线电=vô tuyến điện/thiết bị truyền tin vô tuyến/máy thu thanh/ra-đi-ô|b
无色=không màu/vô sắc|b
无轨=không dấu vết|b
既定=cố định/trước/về trước/đã định/lúc trước|b
既成=đã thành/trở thành|b
日级=nhật cấp|b
旧交=bạn cũ|b
旧型=kiểu cũ|b
旧有=có từ lâu|b
旧爱=cựu ái|b
星等=độ sáng tinh thể|b
昧心=trái lương tâm/dối lòng|b
昧爽=trời sắp sáng|b
暂任=tạm đảm nhiệm|b
暂时性=tính tạm thời|b
暗甲=ám giáp|b
暗红=đỏ sậm|b
暗绿=ám lục|b
暗金级=Ám Kim cấp|b
最新型=kiểu mới nhất|b
最新版=phiên bản mới nhất|b
最高级=cao cấp nhất|b
最高额=kếch xù nhất|b
有初=hữu sơ|b
有栖=Arisu/Alice|b
木有=không có/mộc hữu|b
木梳=cây lược gỗ|b
木然=đờ đẫn/thẫn thờ/ngây ra/thật thà|b
朱批=châu phê/lời phê bằng bút đỏ|b
机要=cơ yếu/cơ mật/trọng yếu/bí mật/chính|b
机载=không vận/cơ tái|b
杏红=màu đỏ quả hạnh|b
杏黄=màu vàng hơi đỏ/hạnh hoàng|b
枣红=đỏ thẫm/màu mận chín/tảo hồng|b
桔红=quất hồng|b
桶装水=thùng đựng nước|b
桶边=bên thùng|b
桶面=mì ly|b
棕红=nâu đỏ/màu nâu đỏ|b
棕黄=nâu nhạt/màu nâu nhạt|b
模棱=ba phải/mập mờ/lấp lửng/nước đôi/mô lăng|b
横档=chặn ngang/ngang|b
橘红=vỏ quýt/trần bì/vỏ quýt/màu vỏ quýt/đỏ như trái quất|b
橘黄=màu da cam|b
橙红=chanh hồng|b
橙级=Chanh cấp|b
橙黄=màu da cam|b
次一等=kém hơn một bậc|b
次生=tái sinh/bắt nguồn từ/chuyển hoá từ/rút ra từ/gián tiếp tạo thành|b
次等=thứ đẳng/hạng nhì/hạng thứ/thấp kém hơn|b
次级=thứ cấp|b
次要=thứ yếu/không quan trọng/kém hơn/lệ thuộc|b
次贫=cùng đinh/nghèo rớt|b
次重=thứ trọng|b
正典=chính điển|b
正副=chính phó|b
正厅级=chính thính cấp/chính thính cấp|b
正处级=chính xử cấp/chính xử cấp|b
正规战=chiến tranh chính quy|b
正轨=quỹ đạo/con đường phát triển đúng đắn/nề nếp/chính quỹ/con đường đúng đắn|b
民营=dân doanh|b
水栖=Thủy Tê|b
水洗=nước rửa|b
水绿=xanh nhạt|b
水葱=thủy thông|b
水锈=cầu nước/ngấn nước|b
永无=vĩnh viễn không/mãi mãi không có|b
永生=vĩnh sinh/sống mãi/bất tử/bất hủ/bất diệt/cả đời/suốt đời|b
沿途=ven đường/dọc đường|b
法清=Pháp Thanh|b
洲际=xuyên lục địa|b
活个=sống|b
流线型=hình giọt nước/dáng thuôn/dáng khí động/lưu tuyến hình|b
浅红=đỏ nhạt/thiển hồng/hồng nhạt|b
浅绿=xanh nhạt|b
浅蓝=lam nhạt/xanh nhạt|b
浅黄=vàng nhạt|b
淡紫=tím nhạt|b
深层次=cấp độ sâu|b
深深=thật sâu/sâu sắc|b
深红=đỏ thẫm/đỏ thẫm/đỏ sẫm|b
深绿=xanh lục|b
深蓝=xanh đậm/lam đậm|b
混交=hỗn giao/hỗn hợp/chung|b
混纺=dệt pha/pha trộn/hàng dệt pha|b
游兴=hứng thú đi chơi|b
满篇=hoàn toàn|b
满级=max cấp|b
烫的=nóng/bị phỏng|b
烫红=nóng đỏ|b
烫面=bột nhào bằng nước nóng|b
片时=khoảng cách/phút chốc/khoảnh khắc/giây phút|b
片甲=mảnh giáp/mảnh giáp|b
特典=ưu đãi|b
特大型=cỡ rất lớn|b
特异功能=đặc dị công năng/công năng đặc dị|b
特有=đặc thù/chỉ mỗi hắn có/đặc biệt|b
特混=đặc hỗn|b
特等=hạng nhất/hạng đặc biệt/số một|b
特级=đặc cấp/đặc biệt cấp cho|b
特遣=đặc khiển|b
独一=độc nhất|b
狭义=nghĩa hẹp|b
狭小=nhỏ hẹp/hẹp hòi|b
现有=hiện hữu|b
甚妙=rất hay|b
甚密=rất thân|b
甲一=Giáp nhất|b
甲等=Giáp đẳng/loại A|b
甲紫=thuốc tím|b
甲级=hạng A/Giáp cấp/ngoại hạng/hạng nhất|b
盛典=thịnh điển/buổi lễ long trọng/buổi lễ trọng thể|b
盛大=long trọng/trọng thể|b
盥=quán|b
盥洗=rửa mặt/rửa tay|b
省察=tự kiểm điểm bản thân|b
省级=cấp tỉnh|b
短传=đường chuyền ngắn/chuyền bóng ngắn|b
短信息=tin nhắn/tin tức ngắn|b
短发=tóc ngắn|b
短号=kèn cóc-nê/số ngắn/kèn cócnê|b
短命=đoản mệnh/chết sớm/vắn số|b
短小=ngắn nhỏ/thấp bé/nhỏ bé/ngắn/nhỏ|b
短弓=đoản cung/cung ngắn|b
短时=thời gian ngắn|b
短期=ngắn hạn/thời gian ngắn|b
短程=hành trình ngắn/tầm/tầm ngắn|b
短篇=đoản văn/ngắn|b
短篷=thuyền buồm nhỏ|b
短线=đoản tuyến/cung không đủ cầu/thiếu hụt/hút hàng/hàng không đủ cung ứng/sản xuất không đủ đáp ứng nhu cầu/đường ngắn|b
短袖=ngắn tay/tay lỡ/tay ngắn|b
短装=ăn mặc gọn gàng/mặc quần áo ngắn/trang phục ngắn/đoản trang|b
短视=thiển cận/cận thị/tầm mắt hạn hẹp/tầm nhìn hạn hẹp/đoản thị|b
短途=khoảng cách ngắn/đường ngắn|b
短针=đoản châm|b
矮个=dáng lùn|b
私交=quan hệ cá nhân/tư giao|b
私有=tư hữu/sở hữu tư nhân|b
私立=tư nhân/tư/của tư nhân/tư lập|b
私营=tư doanh/kinh doanh cá thể|b
空接=liên kết trống|b
空档=đứng không/trống rỗng/không đương|b
穿甲=xuyên giáp|b
立交=đan xen|b
立项=lập hạng/đã được duyệt|b
等一等=Chờ một hồi|b
等你=chờ ngươi|b
等我=chờ ta|b
等等等等=Vân vân vân vân|b
等级=đẳng cấp/cấp/bậc/thứ bậc/tôn ti trật tự/đẳng cấp xã hội/cấp bậc|b
粉红=phấn hồng/màu hồng nhạt/hồng phấn/hồng|b
粗纺=kéo sợi thô/kéo sợi to/xe sợi/xe chỉ len|b
紫外=tử ngoại|b
纯一=thuần nhất/đơn nhất/đơn lẻ/riêng rẽ|b
纯天然=thuần thiên nhiên|b
纯清=thuần thanh|b
绛=giáng|b
绩优=tích ưu|b
绩效=thành tích hiệu quả/hiệu suất/Đánh giá|b
育龄=độ tuổi sinh đẻ|b
胶粘=dẻo/dính|b
自动档=hộp số tự động/số tự động|b
舰载=tàu mẹ/hạm tái|b
舰载机=hạm tái cơ|b
良夜=đêm/buổi tối -thú vị/đêm dài|b
良等=lương đẳng|b
草拟=phác thảo/khởi thảo/thiết kế sơ bộ/nháp/dự thảo/thảo nghĩ|b
草绿=xanh lá mạ|b
藏有=có giấu/ẩn giấu|b
藏私=tàng tư/giấu giếm/giấu của riêng/giấu làm của riêng|b
藤甲=Đằng Giáp|b
虚拟机=máy ảo|b
虹吸=hồng hấp/dẫn bằng xi-phông/hút bằng xi-phông|b
袖珍=bỏ túi|b
袖珍版=phiên bản bỏ túi|b
装有=chứa/trang bị|b
装甲=bọc thép/thiết giáp/tấm chắn đạn/tấm giáp che đạn/trang giáp|b
装载=trang bị/chuyên chở/vận chuyển|b
装载机=máy chuyên chở/bộ nạp/Máy vận chuyển|b
裸的=trắng trợn/khỏa thân|b
裸线=dây cáp/cáp trần|b
说你=nói ngươi|b
超大型=loại cực lớn|b
超巨型=siêu cự hình/khổng lồ/Siêu Khổng Lồ|b
超常=vượt xa bình thường/vượt xa người thường/hơn hẳn/hơn bình thường|b
超常规=siêu thường quy|b
超时=quá thời gian|b
超模=siêu mẫu|b
超然=siêu nhiên/xa rời/cách biệt/lánh xa/đứng ngoài/rời ra/đứng riêng ra|b
超级=siêu cấp/siêu|b
超自然=siêu tự nhiên/siêu nhiên/dị thường|b
超远=cực xa|b
超重击=siêu trọng kích|b
超频=siêu tần/overclocking (siêu tần)|b
超额=vượt mức/số lượng hơn/dôi ra/dư ra/siêu ngạch|b
超高压=siêu cao áp/áp lực siêu cao/siêu cao thế|b
超高频=siêu cao tần/UHF/tần số siêu cao|b
超龄=quá tuổi|b
跳级=nhảy lớp/vượt cấp|b
跳跃性=tính chất nhảy nhót|b
轮的=vòng/tua|b
轻型=hạng nhẹ/loại nhẹ|b
轻推=khẽ đẩy/đẩy nhẹ|b
轻生=phí hoài bản thân mình/coi thường mạng sống của mình/không biết thương xót bản thân/coi thường mạng sống bản thân|b
轻甲=giáp nhẹ|b
轻装=khinh trang/quần áo nhẹ/gọn nhẹ/trang bị nhẹ nhàng|b
轻视=khinh thị/khinh thường/coi thường/xem thường|b
轻轨=khinh quỹ/đường sắt nhẹ/Xe điện ngầm/tàu điện|b
轻量级=hạng nhẹ/trọng lượng nhẹ/nhẹ|b
载有=có ghi/chứa|b
载重=tải trọng/trọng tải|b
较高级=tốt hơn/khá hơn|b
边等=vừa chờ|b
近的=gần|b
远大=rộng lớn/cao xa/thật xa|b
连携=liên kết|b
连篇=hết bài này đến bài khác/cả bài viết/bài văn nọ tiếp bài văn kia/liên thiên|b
迷你=mini|b
迷你型=kiểu mini/mê nhĩ hình|b
迷途=lạc đường/sai đường/con đường sai lầm|b
逆天级=nghịch thiên cấp|b
重型=hạng nặng/trọng hình/cỡ lớn|b
重砌=trọng thế|b
重述=thuật lại/kể lại chi tiết|b
重量级=trọng lượng cấp/cấp quan trọng|b
野性=dã tính/ngỗ ngược/ngang bướng|b
野生=hoang dại/mọc hoang|b
野种=con hoang|b
野营=cắm trại dã ngoại/cắm trại|b
鎏金=mạ vàng|b
键控=ấn/nhấn/bấm|b
镭射=tia laser|b
镭射光=tia sáng laser|b
长有=mọc ra/chiều dài|b
长篇=trường thiên|b
闲篇=chuyện tào lao/chuyện phiếm|b
间接=gián tiếp|b
间杂=phức tạp/pha tạp/không đồng nhất/hỗn tạp/lẫn lộn|b
间歇期=gián đoạn kỳ|b
间色=màu phối hợp/màu sắc sặc sỡ|b
附小=trường tiểu học phụ thuộc|b
附属=phụ thuộc/lệ thuộc/quy thuộc/thuộc/chi nhánh|b
附有=có kèm theo|b
附白=kèm theo bảng đính chính|b
附载=ghi chú thêm/ghi thêm|b
随你=tùy ngươi/theo ngươi|b
随我=theo ta|b
随控=tùy khống|b
隐私=tư ẩn/việc riêng tư/lý lịch|b
隔夜=cách đêm/cách đêm cách hôm/qua đêm|b
隔日=cách một ngày/cách nhật/cách ngày/ngày kế|b
雄视=hùng thị|b
雄黄=hùng hoàng|b
集中营=trại tập trung|b
雌黄=thư hoàng/dùng để tẩy xoá chữ viết|b
雕砌=gọt giũa/trau chuốt|b
青葱=xanh thẳm/xanh miết/xanh rì/xanh tươi/xanh um/thanh thông|b
靛蓝=màu chàm|b
靛青=màu chàm/xanh đậm/chàm|b
非人=không phải người/không thuộc mình/không phải của mình/phi nhân|b
非典=SARS|b
非官方=không chính thức/không thuộc chính phủ/không được nhà nước phê chuẩn hoặc thừa nhận|b
非常规=phi thường quy|b
非常高兴=cao hứng phi thường/cao hứng vô cùng|b
非正式=không chính thức/không nghi thức/không chính quy/bán chính thức|b
非武装=phi vũ trang|b
非法=phi pháp/không hợp pháp/trái phép/trái luật|b
非礼=phi lễ/vô lễ/không lễ phép/bất lịch sự/khiếm nhã/vô lễ với|b
非线性=phi tuyến tính|b
非金属=phi kim loại/á kim|b
额外=ngoài định mức/thêm vào/ngoài mức quy định/quá mức/quá đáng/số thừa/ngạch ngoại/ngoài ngạch|b
额定=ngạch định/số quy định/hạn định/định mức|b
首级=thủ cấp/đầu người|b
首要=hàng đầu/quan trọng nhất/đầu não/lãnh đạo cấp cao/thiết yếu|b
高一=lớp mười/cao nhất/cấp một/cao nhất (*)/lớp 10/cao một|b
高一层=cao hơn một tầng|b
高个=người cao|b
高中低=cao trung đê|b
高兴=cao hứng/vui vẻ/vui mừng/phấn chấn/thích|b
高寒=cao hàn/địa thế cao mà rét|b
高层次=cấp độ cao/cao tầng thứ|b
高年级=cấp cao/lớp lớn|b
高有=cao có/chiều cao|b
高档=cấp cao/cao đương/giá cao/sa hoa/hàng tốt/giá cao/hạng sang/xa hoa|b
高档次=đẳng cấp cao|b
高深=cao thâm/uyên thâm/cao xa/sâu xa/thâm thuý/nông sâu|b
高等=cao đẳng/cao cấp/bậc cao|b
高等级=đẳng cấp cao|b
高级=cao cấp/cấp cao/bậc cao/hảo hạng/thượng đẳng|b
高频=cao tần/tần số cao|b
鹅黄=vàng nhạt/vàng tơ/nga hoàng|b
麻纺=dùng gai kéo thành sợi|b
