一如=giống như/giống nhau|c
不下于=không dưới/không thua/không thua kém/không thấp hơn/không ít hơn/hơn/ít nhất là|c
不仅=không chỉ có/không chỉ/không phải chỉ thế/không những/chẳng những|c
不但=chẳng những/không chỉ/không những|c
不便=không tiện/bất tiện/không thuận tiện/không tiện lợi/không vừa/phiền phức/thiếu tiền xài/thiếu tiền tiêu/kẹt tiền|c
不光=không riêng/không chỉ/không những/chẳng những|c
不免=không khỏi/không tránh được/sao khỏi|c
不及=không kịp/không bằng/thua/không bì kịp/chưa kịp|c
不同于=không giống với|c
不如=không bằng/thua kém hơn|c
不就管=không muốn nhúng tay vào|c
不怕=không sợ/dù cho/bất kể/dù/cho dù|c
不惟=không những/chẳng những/không chỉ|c
不接话=không tiếp lời/không tiếp lời|c
不时=thỉnh thoảng/đôi khi/bất cứ lúc nào/bất thường/bất ngờ/một khi|c
不是=không phải/không được/không đúng/điều không phải/chỗ sai/lỗi/thất lễ/người có lỗi/không phải là|c
不来管=không đến quản|c
不然=không phải/bằng không thì/không phải vậy/không phải đâu/không đâu/không/nếu không/không thì/bất nhiên/chẳng thế|c
不相及=không liên quan|c
不管=mặc kệ/bất kể/cho dù/bất luận/không quản|c
不至于=không đến mức/chưa đến nỗi/không đến nỗi/không đến nỗi|c
不致=không đến nỗi/bất trí/không đến mức/đâu đến nỗi|c
不论=bất luận/dù/cho dù/bất kỳ/bất cứ/miễn bàn/không tranh cãi/không bàn|c
不过=bất quá/không qua/cực kỳ/hết mức/nhất trên đời/hơn hết/vừa mới/vừa/chỉ/chẳng qua/chỉ vì/chỉ có/nhưng/nhưng mà/có điều là/song/chỉ có điều/có điều/không quá|c
不过如此=không gì hơn cái này/chỉ đến như thế|c
与之=tới/cùng với|c
与其=cùng nó|c
与及=cùng/cùng gần|c
与此同时=cùng lúc đó|c
且为=lại là/mà là|c
且当=mà nên|c
且说=lại nói|c
为的是=vì/làm như vậy là để|c
乃为=chính là|c
乃是=chính là|c
乃至=thậm chí/cả đến/ngay cả/thậm chí còn|c
乃至于=thậm chí cả/thậm chí còn|c
之之=chi chi/trong đó|c
之于=đối với|c
之便=chi tiện|c
之光=chi quang/ánh sáng|c
之则=chi tắc|c
之同=chi đồng|c
之所为=việc làm|c
之所以=sở dĩ|c
之所至=chi sở chí|c
之要=chi yếu|c
之论=chi luận|c
之说=mà nói/nói đến/câu chuyện|c
之过=chi tội|c
二为=hai là|c
二乎=rụt lại/co lại/chùn/chùn bước/băn khoăn/không có triển vọng|c
二使=nhị sứ|c
二则=thứ hai|c
二是=hai là|c
于于=lờ mờ|c
于后=ở phía sau|c
于是=thế là/tại là/vì vậy/Vì vậy/ngay sau đó/liền/bèn|c
于是乎=kết quả là|c
于此=nơi này/hơn thế/không sai|c
于至=cho tới|c
从此=từ đây/từ đó/từ nay về sau/từ nay|c
从而=từ đó/do đó/vì vậy/cho nên/nên/vì thế|c
以为=coi là/cho rằng/cho là/tưởng là/tưởng rằng|c
以便=để/nhằm/ngõ hầu|c
以免=để tránh/để tránh khỏi/để khỏi phải|c
以及=cùng/cùng với/và|c
以外=bên ngoài/ngoài ra/ngoài đó/ngoài/trở ra|c
以此=dùng cái này|c
以為=tưởng/cho rằng/là/cho là|c
以至=cứ thế/đến nỗi/cho đến/đến mức|c
以至于=đến mức/thế cho nên/cho tới|c
以致=cho nên/đến nỗi/khiến|c
但仅=nhưng chỉ|c
但因=nhưng bởi|c
但当=nhưng khi/nhưng làm/nhưng lúc|c
但是=nhưng là/thế nhưng/nhưng/mà/nhưng mà|c
但若=nhưng nếu|c
但见=nhưng thấy|c
何为=như thế nào/thế nào|c
何以=làm sao/lấy gì/dùng cái gì|c
何其=sao mà/quá/lắm/biết bao/làm sao/xiết bao/hà kỳ|c
何况=huống chi/huống/hơn nữa/vả lại/huống hồ|c
何如=thế nào/ra sao/được không/như thế nào/không bằng/chi bằng|c
何所不为=không từ bất cứ việc gì|c
何时=khi nào/bao thuở/lúc nào|c
何至于=làm sao đến mức/hà chí vu|c
何若=sao/thế nào|c
倘使=nếu/nếu như/giả như/thảng sử/ví khiến|c
倘或=nếu/nếu như/giả sử|c
倘然=nếu/nếu như/giả sử|c
倘若=nếu như/nếu/giả sử|c
假使=giả sử/nếu như/giả như/ví khiến|c
假如=nếu/giả như/giá như/nếu như/giả dụ|c
假当=giả làm|c
假果=quả giả|c
假而=nếu/nếu như|c
假若=nếu như/giả như/giả sử|c
假说=giả thuyết|c
假面=mặt nạ/mặt giả hiệu/mạng che mặt/mặt giả|c
其后=phía sau/sau đó|c
其所言=lời nói|c
再使=dùng lại|c
再则=vả lại/thêm nữa/tái tắc|c
再管=lại quản/xen vào nữa|c
再者=còn nữa/vả lại/thêm nữa|c
再论=lại bàn về|c
再说=lại nói/nói sau/hơn nữa/rồi hãy nói/sẽ giải quyết/sẽ bàn/vả lại|c
况且=huống hồ/hơn nữa/vả lại/ngoài ra/vả chăng/huống chi|c
別管=mặc kệ|c
别怕=đừng sợ|c
别是=hẳn là/hay là/chẳng lẽ là|c
别管=đừng quản/bất kể/đừng động/bất luận/cho dù/bất cứ/dù/đừng để ý|c
别说=đừng nói|c
别过=quay qua/sau khi từ biệt|c
加之=thêm nữa|c
即为=tức là/được gọi là|c
即令=cho dù/dù cho/dù|c
即使=dù cho/cho dù/tức làm|c
即便=cho dù/mặc dù/dù cho/dù/dù có|c
即如=như/theo như/giống như|c
即或=cho dù/dù cho|c
即时=tức thời/lập tức/tức thì|c
即管=cho dù/mặc dù/bất luận/bất kể/vừa quản|c
即而=rồi|c
即若=cho dù/dù cho|c
即过=liền qua|c
及其=cùng với/cực kỳ/cập kỳ|c
及时=kịp thời/đúng lúc/kịp lúc/đúng thời vụ/lập tức/ngay|c
及此=đến đây/điểm/điều này|c
及至=cho đến/mãi đến/chờ đến|c
反之=trái lại/phản chi/mặt khác/ngược lại/làm ngược lại|c
反而=ngược lại/trái lại|c
另一只=một cái khác/một con khác|c
另一方面=một phương diện khác/về phương diện khác/mặt khác|c
另一面=mặt khác|c
另外=mặt khác/ngoài ra/ngoài/việc khác/khác|c
另有=có khác/có...khác|c
只不过=chỉ bất quá/chỉ có điều|c
只及=chỉ bằng|c
只因=chỉ vì|c
只如=giống như/chỉ như|c
只怕=chỉ sợ/chỉ sợ|c
只是=chỉ là/chẳng qua là/chỉ/nhưng/nhưng mà|c
只有=chỉ có|c
只管=một mực/chỉ để ý/cứ|c
只要=chỉ cần/miễn là|c
只说=chỉ nói|c
只过=chỉ qua|c
可不=cũng không/không phải/phải/ừ/đúng vậy|c
可不可以=có thể hay không/được hay không được/cũng không thể được|c
可不是=cũng không phải/nhưng không phải|c
可以=có thể/còn được/nhưng lấy|c
可怕=đáng sợ/nhưng sợ|c
可时=khả thi|c
可是=thế nhưng là/có thể là|c
可说是=có thể nói là/nhưng nói là|c
同于=cùng với/đồng ý với|c
同时=đồng thời/song song/trong khi/cùng lúc/hơn nữa|c
同時=đồng thời|c
否则=nếu không/bằng không/nếu không thì|c
哪一只=con nào/con kia/cái nào|c
哪一方面=phương diện nào|c
哪怕=dù là/dù cho/cho dù|c
哪是=không phải|c
哪管=đâu thèm/đâu để ý/sao quan tâm|c
因为=bởi vì/bởi rằng|c
因之=bởi đó|c
因于=vì tại|c
因其=bởi vì|c
因是果=nhân là quả|c
因果=nhân quả/nguyên nhân và kết quả|c
因此=bởi vậy/bởi vì/do đó/vì vậy|c
因為=bởi vì|c
因而=cho nên/vì vậy mà/bởi thế|c
固然=cố nhiên/tuy/tất nhiên/dĩ nhiên/cố nhiên|c
固着=cố định|c
固若=vững như/cố nhược|c
如其=như/nếu như/nếu/ví như/nếu như không muốn|c
如是=như là/như thế|c
如是说=nói như vậy|c
如果=nếu như/nếu mà/ví bằng|c
如果说=nếu như nói|c
如此=như thế/thế nào/như vậy|c
如此一来=kể từ đó/như vậy/như thế thứ nhất/đã như thế|c
如此说来=như thế nói đến/nói như thế|c
如若=nếu như/nếu/ví như|c
尔后=về sau/sau đó/từ nay về sau|c
尔时=lúc đó|c
尚且=còn/thượng thả|c
就是说=nói đúng là/tức là/nói cách khác/đó là, chính là nói|c
就管=liền quản/muốn nhúng tay vào|c
尽然=tự nhiên/tẫn nhiên|c
尽管=cứ việc/cho dù/mặc dù|c
尽致=tới tận cùng/đến mức tận cùng/tẫn trí|c
尽说=nói hết|c
岂但=đâu chỉ|c
并且=đồng thời/hơn nữa/và/vả/mà còn/còn|c
并使=cùng làm|c
并而=ngay cả|c
并要=cũng muốn|c
并非=cũng không phải là|c
庶乎=để mà/ngõ hầu|c
庶着=thứ|c
怎奈=tiếc rằng/không biết làm sao được|c
总之=tóm lại/nói chung|c
总体而言=tổng thể mà nói/nhìn chung|c
总是=luôn luôn/dù sao là/luôn/lúc nào cũng/bao giờ cũng/luôn là/đều là|c
总的来说=nói tóm lại|c
总管=tổng quản/quản lý chung/quản lý toàn bộ/người quản lý/người quản lý chung|c
总而言之=nói tóm lại/nói ngắn lại/tóm lại/nói chung|c
恰如=giống như/đúng là|c
恰恰相反=hoàn toàn khác biệt/ngược lại/hoàn toàn trái ngược|c
惟其=vì/bởi vì|c
或则=hoặc/hoặc là/hay là|c
或是=hoặc là/có thể là/hay là|c
或曰=hoặc nói/có người nói rằng/người ta nói rằng/hoặc viết/hoặc có kẻ nói rằng|c
或有=có lẽ có/hoặc có|c
或然=có thể|c
或者=hoặc là/có lẽ/có thể/chắc là/hoặc|c
或者说=hoặc là nói|c
所不为=sẽ không làm|c
所令=ra lệnh|c
所以=cho nên/nguyên cớ/sở dĩ/đó là lí do mà/vì sao/nguyên do/vì lẽ đó|c
所及=đi tới/có thể đạt được|c
所有者=người sở hữu|c
所致=bố trí/sở trí/gây nên|c
所说=nói tới/theo như lời|c
抑或=hay là/hoặc|c
换下来=đổi lại/bị thay thế|c
换句话=thay lời khác|c
换句话说=nói một cách khác/nói cách khác|c
换言之=nói cách khác|c
接单=nhận đơn đặt hàng/Nhận đơn|c
接着=tiếp lấy/tiếp theo/đón/đỡ lấy/đón lấy/bắt lấy/chụp lấy/tiếp lời/tiếp tục|c
接管=tiếp quản|c
接过=tiếp nhận/nhận lấy|c
故曰=đồn rằng/nên gọi|c
故此=vì vậy/vì thế/bởi vậy/cho nên|c
故而=cho nên/vì vậy/vì thế/bởi vậy|c
无一不是=không có chỗ nào mà không phải là|c
无为=vô vi/tuỳ theo tự nhiên không có chí tiến thủ|c
无以=không thể|c
无几=không có mấy/lơ thơ/lác đác/chẳng có mấy/chẳng có bao nhiêu/không bao nhiêu|c
无所不为=không từ bất cứ việc xấu nào/không có việc xấu gì không làm/không từ việc xấu nào|c
无所不至=bằng mọi cách/CHÍ/không trừ một nơi nào/bằng mọi cách/không từ bất cứ việc gì|c
无果=không có kết quả/vô quả|c
无言=không nói gì/không nói|c
无论=vô luận/bất kể/bất luận/không nói/không phải nói/không cần nói|c
无非=đơn giản/chỉ/chẳng qua/không ngoài|c
既是=đã là/vừa là/đã/cũng là|c
既来之=đã đến nơi này|c
既然=đã/tất nhiên/nếu|c
既然如此=đã như vậy/đã như vầy|c
既而=sau này/lát sau/một lát sau/về sau/rồi thì|c
是因为=là bởi vì/là vì|c
更有甚者=thậm chí|c
果然如此=quả là thế/quả thế/quả nhiên như thế/quả đúng như thế|c
果若=nếu/nếu như|c
此一着=nước cờ/kế sách/thủ đoạn/mưu kế/chước - này|c
此为=đây là|c
此后=sau đó/từ nay về sau/sau lần đó|c
此外=ngoài ra/bên cạnh đó/hơn nữa/vả lại/vả chăng/mặt khác|c
此时=lúc này|c
此言=lời ấy|c
此面=mì này|c
然则=thế nhưng/trong trường hợp đó/vậy thì/thế thì|c
然后=sau đó/tiếp đó|c
然而=nhưng mà/thế mà/song/vậy mà|c
然说=nhưng nói|c
甚且=thậm chí|c
甭管=không quan tâm/cần biết/không cần biết|c
由一至=từ một tới|c
由下=từ dưới|c
由于=bởi vì/bởi/do|c
由其=do nó|c
由因=từ nhân|c
由此=bởi vậy/như vậy|c
由此可见=bởi vậy có thể thấy/vì vậy nó có thể được nhìn thấy/từ đó có thể thấy rằng ...|c
由此看来=theo như cái này thì|c
由着=tùy theo/từ nào đó/tùy|c
相若=tương đương/so sánh|c
紧接着=ngay sau đó/sát theo đó|c
纵使=cho dù/dù cho/dù rằng/mặc cho/mặc dù|c
纵然=cho dù/mặc dù/dung túng/ngay cả/dù cho/dầu rằng|c
纵论=nói thoải mái/nói tự do|c
继而=tiếp theo/tiện đà/theo/tiếp đó/nối tiếp|c
综上所述=từ trên tổng hợp lại/nói tóm lại|c
而下=xuống/mà xuống|c
而下至=mà cho tới|c
而且=mà lại/hơn nữa/mà còn/với lại|c
而为=mà vì/mà làm/làm|c
而以=mà lấy/mà thôi|c
而光=quét sạch/mà chỉ|c
而况=huống hồ/huống chi/không kể đến/chưa nói đến|c
而后=sau đó/rồi sau đó|c
而当=mà khi|c
而或=đôi lúc|c
而是=mà là|c
而来使=mà lai sứ|c
而来是=mà tới là|c
而来此=mà tới đây|c
而来过=mà đã tới|c
而至=mà tới/tới|c
而言=mà nói|c
而论=mà nói|c
而说者=mà người nói|c
而过=mà qua/mà quá|c
若不然=nếu không|c
若为=nếu vì|c
若使=nếu như|c
若是=nếu là/nếu như/nếu như là|c
若果=nhược quả/nếu như cương quyết|c
若然=nếu như|c
若要=nếu muốn/như muốn|c
若论=nếu bàn về|c
若说=nếu nói/nếu nói là|c
若非=nếu không phải/nếu không có/nếu không/bằng không|c
莫管=không quản|c
虽不为=tuy không làm|c
虽为=tuy là/tuy là vì|c
虽则=tuy là/tuy rằng|c
虽只=tuy chỉ|c
虽可=mặc dù có thể/tuy có thể|c
虽是=tuy là|c
虽有=tuy có|c
虽然=mặc dù/cho dù/tuy rằng/tuy là/TUYỆT ĐỐI KHÔNG MANG NGHĨA "TUY NHIÊN"|c
虽说=tuy nói/tuy/tuy rằng|c
虽非=tuy không phải|c
要不是=nếu không phải/nếu không/nếu không phải là|c
要不然=bằng không|c
要么=hoặc là/sẽ/muốn sao|c
要是=nếu là/nếu/nếu như/muốn là|c
要说=muốn nói/như cho|c
设若=giả như/ví như/giả sử|c
转管=xoay nòng|c
转而=ngược lại|c
还之=hoàn lại|c
还是=vẫn là/hay là/còn là/|c
还来及=còn tới kịp/tới còn kịp|c
还要=còn muốn/còn phải|c
还说=còn nói/hay nói|c
进而=tiến tới/triển khai bước kế tiếp|c
那句话=câu nói kia|c
除以=chia cho|c
除外=ngoại trừ/trừ/không tính/trừ ra/không kể|c
除此之外=trừ cái đó ra/trừ lần đó ra/trừ đó ra/ngoài ra|c
除此外=trừ đó ra/ngoại trừ|c
除非=trừ phi/trừ khi/nếu không/chỉ có/chỉ với điều kiện là/ngoài ra/trừ ra/trừ/loại ra/không kể|c
非但=không những/nếu không/chẳng những|c
非惟=không những/không chỉ/chẳng những|c
