一个劲=hung hăng|d
一个劲儿=không ngừng/liên tiếp|d
一举=nhất cử/một lần hành động/một lần|d
一住=ở một cái/ở lại|d
一倒=khẽ đảo/đổ ra|d
一偏=lệch ra/lệch lạc/phiến diện/thiên vị|d
一停=dừng lại|d
一再=nhiều lần/lần nữa/năm lần bảy lượt|d
一刚=một cương|d
一别=từ biệt|d
一力=dốc hết sức/ráng hết sức|d
一动=khẽ động/vừa động/hở ra thì/động một cái/hơi động|d
一同=cùng nhau/đang/cùng/chung|d
一向=luôn luôn/ gần đây/gần đây/thời gian qua|d
一块儿=cùng một chỗ/cùng nơi/cùng một thể/cùng/cùng nhau|d
一块块=từng khối/từng cục/từng khối từng khối|d
一定=nhất định/chính xác/quy định/tất nhiên/cần phải/chắc chắn/riêng|d
一尝=thưởng thức|d
一就=một là|d
一已=bản thân|d
一幅=một bức|d
一幅幅=một vài bức|d
一并=cùng nhau/nhất tịnh/đồng|d
一应=tất cả/mọi ý|d
一律=hết thảy/giống nhau/như nhau/nhất loạt/nhất luật|d
一心=một lòng/nhất tâm/chuyên tâm/toàn tâm toàn ý/đồng tâm|d
一意=một ý/nhất ý|d
一抵=một chống/chống đỡ một chút|d
一整=nguyên một/nghiêm chỉnh|d
一断=vừa đứt/một đoạn|d
一新=đổi mới hoàn toàn/một mới|d
一旦=một khi/một ngày/chốc lát/có một ngày/nhất đán/một mai|d
一早=trước kia/sáng sớm/sớm tinh mơ/trước đây/trời vừa sáng|d
一时=nhất thời/một thời/một lúc/tạm thời/trong chốc lát/trong một lúc/lúc thì|d
一时一刻=không bao giờ/luôn luôn|d
一期=đồng thời/một kỳ|d
一本正经=chững chạc đàng hoàng/nghiêm trang/trịnh trọng/trang nghiêm/đàng hoàng trịnh trọng|d
一条心=một lòng/đồng lòng|d
一来=vừa đến/thứ nhất/đến một lần|d
一来一往=có qua có lại|d
一来二往=thường xuyên qua lại|d
一栏=một cột|d
一概=một mực/hết thảy/nhất loạt/nhất khái/một mực như thế cả|d
一次性=dùng một lần/duy nhất/duy nhất một lần/một lần|d
一正=nghiêm/nghiêm lại|d
一溜儿=một hàng/vùng lân cận/một dãy/vùng phụ cận|d
一溜烟=nhanh như chớp/vụt đi/như một làn khói|d
一疑=nghi hoặc|d
一直=một mực/vẫn/thẳng/thẳng tuốt/luôn luôn/suốt/liên tục/từ|d
一睁=vừa mở/trợn mắt/mở một cái|d
一窝蜂=như ong vỡ tổ/ồn ào náo nhiệt|d
一竖=dựng lên/dựng đứng|d
一经=một khi/qua|d
一至=một tới/vừa tới/|d
一致=nhất trí/không chia rẽ/cùng/đều/nhất tề|d
一踏=đạp mạnh/một bước/đạp một cái/đạp xuống|d
一转眼=chỉ chớp mắt|d
一轻=chợt nhẹ/nhẹ một chút/nhẹ đi|d
一较=ganh đua|d
一边=một bên/vừa/mặt bên/một mặt/bên cạnh/đồng dạng/như nhau|d
一连=liên tiếp/một liền/không ngừng|d
一都=một đô|d
一面倒=nghiêng về một bên/nghiêng về đúng một bên/nghiêng về - một bên/một phía|d
一面面=từng mặt|d
一骨碌=trở mình một cái|d
一齐=đồng loạt/nhất tề/đồng thời|d
不也=không phải cũng/cũng không|d
不仅仅=không chỉ/không chỉ có|d
不停=không ngừng/liên tục/suốt/luôn/luôn tay/liên tiếp|d
不偷=không ăn trộm|d
不再=không còn/không hề/không nữa/không có nữa/lại không/không tại|d
不凡=bất phàm/phi phàm/siêu đẳng/siêu phàm/không tầm thường/tài giỏi|d
不则声=không lên tiếng/im hơi lặng tiếng|d
不啻=đâu chỉ/giống như/không chỉ/khác nào/không chỉ có/như/bất thí/chẳng những|d
不多加=không nhiều hơn|d
不多时=không bao lâu/không lâu lắm|d
不多远=không bao xa|d
不好=không tốt/bất hảo/không dễ/không thích|d
不定=không chừng/chưa chắc/bất định/không biết/không chắc|d
不定期=không định kỳ|d
不容许=không cho phép|d
不少=không ít|d
不尽=không hết/không hoàn toàn/vô cùng/bất tận/không hoàn toàn/không đầy đủ/vô tận/vĩnh viễn/không bao giờ hết|d
不已=không thôi/không ngớt/không dứt/mãi|d
不底=không đáy|d
不当=không làm/không đem/không nên/không đáng|d
不得不=không thể không/phải/cần phải|d
不得体=không thỏa đáng/không khéo léo|d
不得已=bất đắc dĩ/không thể không như vậy/buộc phải như vậy/phải/bắt buộc phải/có bổn phận phải|d
不必=không cần/khỏi/khỏi phải/không đáng/không bằng|d
不快=không nhanh/không vui/không khoái/không hài lòng/buồn hiu/khó chịu/không thoải mái/chậm/cùn/không bén/lụt/không thích/không quan tâm|d
不敢=không dám/không nên|d
不断=không ngừng/không đoạn/không đứt/không gãy/liên tục/liên tiếp|d
不早=không sớm/không còn sớm|d
不暇=không rảnh/không rỗi/không xuể/không có thì giờ/không ngơi/bận túi bụi|d
不曾=chưa từng/chưa hề/chưa|d
不期=bất kỳ/không hẹn/không định trước/không ngờ/bất ngờ|d
不来当=không đến làm|d
不来晚=không tới chậm|d
不来迟=không đến muộn|d
不正=bất chính/không chính|d
不正经=không đứng đắn|d
不独=không riêng/không chỉ/không những/chẳng những|d
不由得=không khỏi/không được/đành phải/buộc phải/không cho phép/không thể không/không cầm được/không nín được/không kềm được/không nhịn được|d
不禁=không khỏi/nhịn được/không kềm nổi/không nén nổi/không nhịn được/không ghìm mình nổi/cố gắng/cố|d
不经=không trải qua/không lịch sự/tao nhã|d
不能不=không thể không/tất nhiên/dĩ nhiên|d
不自在=không được tự nhiên/không dễ chịu|d
不见得=chưa chắc/không có thể/không cần thiết/chưa chừng/không nhất thiết như vậy/không hẳn như vậy/không vậy/đâu phải vậy/không chắc/không thấy được|d
不觉=chưa phát giác/không ngờ/chưa phát giác ra/chưa phát hiện/bất giác/bất giác|d
不许=không cho phép/không được/không được phép/không thể/không cho|d
不较=bất giác|d
不过意=áy náy/băn khoăn/xin lỗi|d
不远=không xa|d
不迭=cuống quít/bất điệt/không kịp/cuống cả lên/quíu đít/không ngừng/không ngớt/luôn mồm/không thôi|d
不难=không khó|d
不须=không cần phải/chờ đợi|d
不齐=không đủ/không đồng đều/không bằng nhau/khác|d
专断=lộng quyền/độc đoán/đơn phương quyết định|d
业已=đã/nghiệp dĩ|d
临终=lâm chung/hấp hối/sắp chết|d
久久=thật lâu/lâu lâu/rất lâu/mãi mãi/lâu lắm/hồi lâu/lâu thiệt lâu|d
久候=chờ chực/đợi lâu/chờ lâu|d
久别=cửu biệt/xa cách từ lâu/xa cách từ lâu/xa cách|d
久已=từ lâu/sớm đã|d
久点=lâu một chút|d
久等=đợi lâu/chờ lâu|d
久经=trải qua/kinh nghiệm/đã trải qua/kinh nghiệm lâu năm|d
久远=xa xưa/đã lâu/cửu viễn/lâu dài/lâu đời/rất xưa|d
乖不乖=có ngoan hay không|d
乖乖=ngoan ngoãn/trái lại/ngoan/biết vâng lời/cục cưng/bé ngoan/ai ya/ô/wow|d
乘便=nhân tiện/tiện thể/ngẫu nhiên/tình cờ|d
也=dã|d
也上=cũng tới|d
也不=cũng không|d
也且=cũng lại|d
也分=cũng chia|d
也刚=cũng vừa|d
也别=cũng đừng|d
也少=cũng ít|d
也当=cũng làm/cũng nên|d
也忙=cũng vội vàng|d
也慢=cũng chậm|d
也才=cũng mới|d
也敢=cũng dám|d
也未=cũng không|d
也正=cũng đang|d
也觉=cũng thấy/cũng cảm thấy|d
也许=có lẽ/hay là/e rằng/biết đâu/may ra/có thể|d
也连=cũng liền|d
也道=cũng nói|d
也都=cũng đều|d
也门=Y-ê-men/Yemen/Yêmen|d
乱=loạn|d
事先=trước đó/trước khi xảy ra|d
事少=chuyện ít|d
事忙=bận chuyện|d
于脆=dứt khoát|d
于衷=hợp tác|d
互为=tương hỗ là|d
互动=hỗ động/ảnh hưởng lẫn nhau, tác động qua lại/chuyển động cùng nhau|d
互往=tương hỗ|d
互相=lẫn nhau/giúp nhau/cho nhau/tương hỗ/với nhau|d
互连=quan hệ nối liền|d
些微=một chút/một ít/hơi|d
些许=một chút/một ít/những/chút|d
些须=một ít/một chút/một tí|d
亟须=cấp bách chờ đợi/rất cần thiết|d
亦=diệc|d
亲也=hôn cũng|d
亲手=tự tay/thân thủ/chính tay/tự tay|d
亲眼=tận mắt/từng/đã từng/chính mắt|d
亲耳=chính tai|d
亲脸=hôn mặt|d
亲自=tự mình/tự thân/chính mình/đích thân|d
亲近=thân cận/thân thiết/gần gũi/thân mật|d
人少=người ít/ít người/nhân thiếu|d
人敢=người dám|d
仅=cận|d
仅仅=vẻn vẹn/gần kề/chỉ/gần/mới/vừa vặn|d
仅以=vẻn vẹn lấy/chỉ muốn|d
仅只=vẻn vẹn/chỉ/đơn thuần|d
仅是=chỉ là|d
仅次=gần thứ|d
仅次于=gần với/sau/đằng sau/đứng sau/kế dưới/chỉ đứng sau|d
仅此=chỉ lần này/chỉ cái này|d
仍在=còn tại/còn đang/vẫn tại|d
仍旧=như cũ/như trước/vẫn/cứ/vẫn cứ|d
仍是=vẫn là|d
仍然=vẫn/vẫn đang/vẫn cứ/tiếp tục/lại|d
仍觉=vẫn cảm giác|d
仍须=vẫn cần phải|d
从不=chưa từng/từ trước tới giờ không|d
从严=sẽ nghiêm trị|d
从中=từ đó/từ trong|d
从先=trước/trước đây/lúc trước/ngày trước|d
从即=từ lúc|d
从新=lại lần nữa/từ mới|d
从未=chưa hề/chưa bao giờ/chẳng bao giờ|d
从来=cho tới bây giờ/chưa hề/từ trước đến nay/luôn luôn/trước đến giờ/xưa nay|d
从来不=xưa nay không/chưa bao giờ|d
从没=chưa từng|d
从腰=từ hông|d
从远=từ xa|d
从速=nhanh chóng/gấp gáp/càng sớm càng tốt/không chậm trễ/vội/cấp bách|d
以新=mới|d
以暇=dĩ hạ|d
以远=xa hơn|d
仰脸=ngửa mặt|d
仰面=ngửa mặt|d
任然=mặc nhiên|d
仿佛=phảng phất/dường như/hình như/giống như/giống/như|d
仿单=sách hướng dẫn sử dụng/bảng hướng dẫn sử dụng|d
仿古=giả cổ/bắt chước kiểu cổ/phỏng theo kiểu cổ|d
仿真=mô phỏng chân thật/phảng chân|d
仿真度=độ chân thực|d
伺机=tùy thời/tý cơ|d
似乎=tựa hồ/hình như/dường như|d
似于=giống như|d
似地=tựa như|d
似已=cũng|d
似得=giống như/tự đắc|d
似慢=như chậm|d
似是=dường như/tựa như/làm như|d
似曾=giống như đã từng|d
似然=tự nhiên|d
似缓=như chậm|d
似要=như muốn|d
似道=tự do|d
低微=thấp/thấp kém/trầm/nhỏ/khe khẽ/tệ/tệ bạc/thấp hèn|d
低速=tốc độ thấp/vận tốc thấp|d
何不=sao không/tại sao không/sao/sao lại không|d
何分=vì sao phân|d
何啻=không khác nào/không chỉ|d
何在=ở đâu/nào/tại đâu/ở chỗ nào|d
何尝=làm sao/chẳng phải/không phải là không|d
何常=hà thường|d
何当=khi nào/lúc nào/ngày nào/sao/gì/ngại gì/sợ gì/có sao đâu/làm sao/như thế nào/sao có thể/huống hồ/huống chi/nên/phải/cần phải|d
何往=đi nơi nào|d
何必=làm gì/hà tất/hà cớ/bất tất/cần gì/sao phải|d
何意=ý gì|d
何故=cớ gì/tại sao/vì sao/hà cố/cớ gì|d
何敢=nào dám|d
何来=sao là/tại sao/làm sao đến|d
何用=làm gì dùng/có ích lợi gì/cần gì dùng|d
何脸=mặt mũi gì|d
何苦=tội gì/cần gì/bất tất tự làm khổ mình/việc gì mà phải../hà khổ|d
何许=nơi nào/thế nào/gì/ra sao|d
何难=khách khí|d
何须=cần gì phải/không cần/khỏi|d
侃侃=chậm rãi/đĩnh đạc/ngay thẳng/cúng cỏi|d
侃儿=nói lóng/tiếng lóng/biệt ngữ/khẩu hiệu/khẩu lệnh/mật mã|d
依时=đúng giờ/kịp/kịp thời|d
依样=y theo/như vậy|d
依次=theo thứ tự/lần lượt|d
依此=này/dựa vào này|d
依然=y nguyên/vẫn như cũ/như cũ/như xưa/vẫn|d
依稀=lờ mờ/y hi/ngờ ngợ/ang áng/lơ đãng/mơ hồ/không rõ ràng/mang máng/loáng thoáng|d
依约=đúng hẹn|d
侧微=thấp hèn/Hèn mọn/ti tiện.|d
便=tiện|d
俄然=bỗng/bỗng nhiên/chợt|d
俄顷=khoảng khắc/phút chốc/giây phút/giây lát/chốc lát|d
倏地=phút chốc/bỗng chốc/chợt|d
倏尔=phút chốc|d
倏忽=bỗng nhiên/thoắt/bỗng chốc/chớp nhoáng|d
倏然=đột nhiên|d
借此=nhờ vào đó|d
偏不=cứ không/không|d
偏偏=hết lần này tới lần khác/lại/cứ/cố ý/vẫn cứ/khăng khăng/khư khư/cứ một mực/mà lại/nhưng/riêng/một mực|d
偏好=đặc biệt thích/thiên hảo|d
偏将=thiên tướng|d
偏巧=vừa vặn/đúng lúc/may mà/mà|d
偏暗=hơi tối|d
偏远=xa xôi/xa xăm|d
偶发=ngẫu nhiên xảy ra|d
偶尔=ngẫu nhiên/thỉnh thoảng/tình cờ/tình cờ|d
偶然=ngẫu nhiên/tình cờ/bất ngờ|d
偶而=thỉnh thoảng/ngẫu nhiên|d
偷偷=vụng trộm/len lén/trộm/lén lút|d
偷儿=trộm vặt|d
偷巧=trục lợi|d
偷手=giấu nghề|d
偷眼=nhìn trộm/nhìn lén/liếc trộm|d
偷门=thâu môn|d
傲然=ngạo nghễ/hãnh diện/bất khuất/kiên cường/thách thức/thách đố|d
傲狠=ngạo ngoan|d
兀然=đột nhiên|d
兀自=vẫn/hãy còn|d
先不先=trước hết/trước tiên|d
先且=trước tạm|d
先声=âm thanh báo trước/tiếng chuông báo trước/điềm báo trước/tiền đề|d
先是=đầu tiên là/vốn là/trước đây là/nguyên là|d
先自=lời đầu tiên|d
先至=tới trước|d
全乎=đầy đủ|d
全愈=khỏi hẳn|d
全新=hoàn toàn mới|d
全般=toàn bộ/toàn diện|d
共同=cộng đồng/chung/cùng/chung nhau|d
共处=chung sống/cùng tồn tại/sống chung|d
共度=cùng chung/cùng|d
共时=cùng lúc|d
共是=tổng cộng|d
其力=kỳ lực|d
其同=kỳ đồng|d
其大=to lớn|d
其实=kỳ thật/kỳ thực/thực ra/thật ra thì|d
其微=rất nhỏ|d
其意=nó ý/ý nghĩa/ý nghĩa|d
其深=thật sâu/độ sâu|d
其速=tốc độ|d
其道=đạo/một con đường riêng|d
其重=nó nặng|d
再=tái|d
再三=liên tục/luôn mãi/nhiều lần/hết lần này đến lần khác/tái tam|d
再不=lại không/không còn/nếu không/bằng không/không còn ... nữa/sẽ không/không nữa|d
再不复=cũng không còn/không còn|d
再不对=sai đến đâu|d
再不然=nếu không nữa thì|d
再也=rốt cuộc/cũng nữa/cũng lại|d
再倒=lại rót/rót nữa/tiếp|d
再好=cho dù tốt/khá hơn nữa/dù cho|d
再将=lại đem|d
再少=ít hơn nữa|d
再就=lại có|d
再度=lại lần nữa/lần thứ hai/lần nữa|d
再忙=bận rộn nữa|d
再慢=chậm nữa|d
再摸=sờ nữa|d
再敢=còn dám|d
再晚=chậm thêm/trễ nữa|d
再来上=lại đến thêm|d
再次=lần nữa/lần thứ hai/lại lần nữa|d
再活=lại sống/sống thêm/lại hoạt|d
再由=lại từ/lúc sau/lại do|d
再经=lại trải qua|d
再续=lại nối tiếp|d
再要=lại muốn/lại muốn|d
再见面=gặp lại/gặp mặt lại|d
再难=lại khó/khó hơn nữa|d
决不=quyết không/và không bao giờ/không bao giờ/không có gì|d
决别=quyết biệt/và nói lời tạm biệt/nói lời tạm biệt|d
决然=kiên quyết/dứt khoát/tất nhiên/nhất định/quyết nhiên|d
冷么=lạnh không|d
冷然=lạnh lùng|d
几为=mấy vị|d
几乎=cơ hồ/hầu như/gần như/chừng/gần/suýt nữa/xém|d
几可=gần như có thể|d
几将=mấy tướng|d
几幅=mấy tấm/mấy bức|d
几度=mấy chuyến/vài lần|d
几微=nhỏ/nhỏ bé/dấu hiệu/điềm báo|d
几时=bao lâu/lúc nào/khi nào/khi nào|d
几晚=mấy đêm/mấy đêm rồi|d
几曾=chưa bao giờ/lúc/khi|d
几疑=tựa như|d
几经=nhiều lần/lặp đi lặp lại|d
几至=hầu như/gần như/lập tức/ngay tức khắc|d
几觉=mấy giấc|d
几许=mấy phần/bao nhiêu|d
几近=gần như/một số gần như|d
凡下=thấp kém|d
凡乎=gần như|d
凡例=phàm lệ|d
凡命=phàm mệnh|d
凡庸=bình thường/tầm thường/thông thường/thường|d
凡微=tầm thường|d
凡心=phàm tâm/nhớ trần tục/nhớ cõi trần|d
凡是=phàm là/hễ là/mọi|d
凡此=phàm là những thứ này/phần lần đó|d
分之=phần có|d
分别=phân biệt/ly biệt/chia tay/biệt ly/xa cách/bất đồng/khác nhau/chia nhau/phân công nhau/chia ra|d
分处=phân đà/phân ra/phân chia|d
分快=mau chóng|d
分时=tiến hành cùng lúc/xử lý song song|d
分真=phần thật|d
分袂=ly biệt/chia tay|d
切勿=chớ/không nên/không được/ngàn lần không được|d
刚以=vừa mới|d
刚刚=vừa mới/vừa/vừa vặn/mới vừa|d
刚好=vừa vặn/vừa khít/vừa/vừa khớp/vừa khéo/đúng lúc/vừa lúc|d
刚将=vừa đem|d
刚巧=vừa vặn/vừa khớp/đúng lúc/may mắn/may mà|d
刚度=độ cứng/sức chịu đựng|d
刚来时=lúc mới tới|d
刚正=cương chính/ngay thẳng/chính trực|d
刚死=vừa mới chết|d
刚直=cương trực/chính trực/ngay thẳng|d
刚着=mới vừa|d
刚离=vừa rời|d
刚过=vừa qua/vừa qua khỏi|d
刚过来=vừa mới đến|d
初停=tạm ngừng|d
初刻=sơ khắc|d
初度=ngày sinh/sinh nhật|d
初愿=nguyện vọng ban dầu/ý nguyện ban đầu|d
初次=lần đầu/lần đầu tiên/lần thứ nhất|d
初步=sơ bộ/bước đầu/ban đầu/lúc đầu/sơ khởi/mở đầu|d
初衷=dự tính ban đầu/ước nguyện ban đầu/sơ trung|d
初速=sơ tốc/vận tốc ban đầu/vận tốc viên đạn khi ra khỏi nòng|d
到于=đến/cho dù/vả lại|d
到场=trình diện/có mặt/đến/đến nơi|d
到处=khắp nơi/nơi/mọi nơi/nơi nơi/đâu đâu/chỗ nào cũng/khắp chốn|d
到底=đến cùng/tới đáy/rốt cuộc|d
到庭=ra toà/đến toà án|d
到手=tới tay/được/giành được/trong tay/trong tầm tay/nằm trong tay|d
到时=đến lúc đó|d
到晚=đến muộn|d
到期=đến kỳ/đến kỳ hạn|d
到来=đến/ đã đến/đến nơi/tới nơi/bắt đầu/đã đến|d
到此=đến đây/đến đó/đến vậy/đến chỗ này|d
到点=đến giờ|d
到齐=đến đông đủ/tề tựu/tập trung đông đủ|d
刻日=kỳ hạn/hạn định|d
劈手=chộp/vồ|d
劈胸=chộp/thộp|d
劈脸=đúng ngay vào mặt/đâm thẳng vào mặt|d
劈面=đúng ngay vào mặt/đâm thẳng vào mặt/vỗ mặt/thẳng vào mặt|d
加一点=thêm một chút|d
务实=thiết thực/phải cụ thể/vụ thật|d
务必=nhất thiết phải/cần phải/cốt phải/ắt phải|d
务期=nhất định sẽ/nhất định phải|d
务正=việc chính đáng|d
务须=phải/cốt phải/ắt phải|d
动辄=động một tí/động thì/động/hơi một tí/hở ra là../động triếp|d
势微=thế nhỏ|d
势必=thế tất/tất phải/ắt phải|d
势来=tới|d
勿=vật|d
匀停=đầy đặn/dừng lại|d
匀脸=xoa đều/thoa đều|d
匀速=tốc độ đều đặn/tốc độ không thể/vận tốc đồng đều|d
十么=làm sao|d
十停=mười phần|d
十将=Thập Tướng/Thập Tương/thập tướng|d
十幅=thập phúc/mười bức|d
十怪=thập quái|d
十时许=10pm|d
十来下=gần mười cái|d
十来天=mười ngày qua/mười ngày/chừng mười ngày|d
十来里=khoảng mười dặm|d
十死=mười chết/thập tử|d
十足=mười phần/thập túc/thuần chất/đầy đủ/tràn đầy|d
十连=mười liên|d
千般=muôn vàn|d
单于=Thiền Vu|d
单以=riêng lấy/chỉ lấy/chỉ riêng lấy|d
单独=đơn độc/một mình|d
即分=liền phân ra|d
即刻=lập tức/tức khắc/ngay lập tức|d
即可=liền có thể/là được/sẽ xảy đến|d
即定=tức định|d
即将=sắp/gần/sẽ|d
即期=lập tức/tức thì/ngay tức khắc|d
却=khước|d
却不=cũng không|d
却不曾=lại chưa từng|d
却为=lại vì/nhưng mà làm/là một|d
却偏=lại|d
却再=lại/nhưng lại|d
却慢=thong thả|d
却是=lại là/nhưng là/cũng là|d
却步=lùi bước/giật lùi/chùn bước|d
却活=vẫn sống|d
却深=lại sâu|d
却远=nhưng còn xa/cho dù|d
历久=thời gian lâu|d
历尽=trải qua/nhiều lần trải qua/nhiều lần gặp phải|d
历次=nhiều lần/lịch thứ|d
历经=trải qua/kinh qua/nhiều lần trải qua|d
厉声=nghiêm nghị/lớn tiếng/lạnh lùng/cáu kỉnh|d
厉正=Lệ Chính|d
厉然=nghiêm nghị|d
原先=trước kia/ban đầu/thoạt tiên|d
原则上=trên nguyên tắc|d
原初=nguyên sơ/đầu tiên/khởi đầu|d
原地踏步=dậm chân tại chỗ|d
原处=chỗ cũ|d
原定=sớm định ra/định ra từ trước|d
原意=nguyên ý/ý gốc/ý ban đầu/bản ý/nguyện ý|d
原来=nguyên lai/lúc đầu/ban sơ/vốn/vốn dĩ/té ra/hoá ra/thì ra/thì ra là|d
原样=nguyên dạng/nguyên trạng|d
原经=nguyên kinh|d
又=hựu|d
及早=sớm cho kịp/nhanh chóng/sớm/cho sớm|d
反倍=phản bội|d
反对=phản đối/không tán thành/không đồng ý|d
反常=khác thường/lạ/bất thường/dị thường|d
反日=phản Nhật|d
反正=dù sao/ngược lại/quay về với chính nghĩa/trở về với chính nghĩa/đào ngũ/quân địch bỏ chạy sang hàng ngũ ta/dù...cũng/cho dù/thế nào cũng/dù sao cũng|d
反过来=trái lại/ngược lại|d
反面=mặt trái/phản diện/bề trái|d
另一半=một nửa khác/một nửa kia/nửa kia|d
另一头=bên kia/một đầu khác|d
另一手=tay kia/một tay kia|d
另一番=một phen khác|d
另一边=một bên khác/bên kia|d
另眼=mắt khác|d
只多不少=chỉ nhiều không ít|d
只好=đành phải/không thể làm gì khác hơn là/buộc lòng phải|d
只将=chỉ đem|d
只当=chỉ coi|d
只怪=chỉ đổ thừa/chỉ trách|d
只敢=chỉ dám|d
只经=chỉ bằng cách|d
只自=chỉ từ|d
只许=chỉ cho phép|d
只须=chỉ cần|d
只顾=chỉ lo/một mực/cứ/chỉ biết/chỉ chú ý đến/chỉ đoái hoài đến|d
同一天=cùng một ngày|d
同一律=luật đồng nhất/quy luật đồng nhất|d
同一时间=cùng một thời gian/cũng trong lúc đó|d
同声=đồng thanh|d
同意=đồng ý/bằng lòng/tán thành|d
同样=đồng dạng/giống nhau/như nhau/cũng/giống vậy|d
同步=đồng bộ/tính đồng bộ/quan hệ đồng bộ|d
同齐=đồng tề/ngang hàng|d
向上=hướng lên/hướng về phía trước/chí tiến thủ/hướng thượng/hướng lên trên|d
向往=hướng tới/hướng về/ngóng trông|d
唯别=duy biệt|d
唯独=duy chỉ có/chỉ có|d
嚎啕=gào khóc/khóc oà/khóc sướt mướt/Hào đào/khóc to/than vãn|d
四为=bốn là|d
四快=tứ khoái|d
四至=bốn bề giáp giới|d
四顾=tứ phương/chung quanh|d
囫=hốt|d
囫囵=nguyên lành/hoàn chỉnh/trọn/cả/ngon/hoàn thành/hoàn tất/nguyên vẹn/hốt luân|d
均=quân|d
基多=Ki-tô/Quito/Kitô|d
多于=nhiều hơn/nhiều/dư|d
多亏=nhờ có/may mắn/may mà|d
多佛=Dover|d
多得多=hơn rất nhiều/nhiều hơn|d
多得是=còn nhiều, rất nhiều|d
多由也=Tayuya|d
多疑=đa nghi/quá nhạy cảm|d
多难=nhiều khó khăn/cỡ nào khó khăn|d
多面手=đa tài/nhiều tài năng/giỏi nhiều mặt|d
大一统=đại nhất thống/thống nhất lớn/thống nhất quy mô lớn|d
大不大=lớn không lớn/có lớn hay không|d
大为=rất là/rất/rất đỗi/vô cùng/hết sức/rất nhiều|d
大举=quy mô/hàng loạt/tiến hành trên quy mô lớn/ồ ạt/đại sự/đại cử/quy mô lớn|d
大于=lớn hơn/tầm lớn hơn|d
大佛=đại phật|d
大便=đại tiện/phân/cứt/đi đồng/đi ị|d
大凡=hết thảy/nói chung/đại khái/phần nhiều/phần đông/đại phàm|d
大可=đều có thể/đại khả|d
大可不必=rất không cần phải/không cần phải|d
大同=đại đồng/thống nhất/nhất trí/Đại Đồng|d
大块头=to con/lớn con/đại khối đầu|d
大好=tốt đẹp/tốt/rất tốt/quý báu/khỏi/lành/hết/thật tốt|d
大定=đại định|d
大将=Đại tướng/đại tướng/tướng lĩnh/thủ lĩnh|d
大尽=tháng đủ|d
大幅=trên diện rộng/diện rộng/đại phúc|d
大幅度=trên phạm vi lớn/đại phúc độ/mức độ lớn|d
大庸=đại dung|d
大得=to đến/lớn đến/lớn đến mức|d
大得多=lớn/to lớn - hơn rất nhiều/lớn hơn nhiều lắm|d
大忙=đại ân/bận rộn/bận thời vụ/bận việc/đại mang|d
大快=đại khoái/quá nhanh|d
大意=chủ quan/đại ý/sơ suất/khinh thường/không chú ý/sơ ý/lơ là/qua quýt/bất cẩn|d
大愤=cả giận|d
大抵=nói chung/đại để/đại thể/đại khái|d
大概=đại khái/nét chính/sơ lược/sơ sơ/chung chung/có thể/có lẽ/khoảng|d
大步=nhanh chân/đi nhanh/sải bước|d
大牢=đại lao/nhà tù|d
大睁=mở to|d
大禁=đại cấm|d
大约=ước chừng/khoảng chừng/khoảng/ước độ/chắc là/chắc/rất có thể|d
大肆=trắng trợn/không kiêng nể/không e dè/phung phí/cổ động|d
大自然=thiên nhiên/giới tự nhiên|d
大致=đại khái/đại thể/tổng thể/cơ bản/khoảng chừng/ước chừng|d
大踏=đạp mạnh|d
大踏步=sải bước/xoải bước/bước nhanh|d
大较=đại giác/đại khái/chung chung|d
大过天=lớn hơn trời|d
大过年=cuối năm|d
大远=xa hơn|d
大连=Đại Liên|d
大难=đại nạn|d
奋力=ra sức/gắng sức|d
奋勇=anh dũng/dũng cảm/phấn dũng|d
奋然=hăng hái|d
奋袂=xắn tay áo/phất tay áo|d
好不=biết bao/được không/rất/quá/thật không|d
好么=được chứ/vậy thật|d
好乖=thật ngoan|d
好刚=thật cứng|d
好处=chỗ tốt/có lợi/có ích/điều tốt/lợi ích|d
好好=hảo hảo/thật tốt/cố gắng|d
好得快=rất nhanh|d
好早=thật sớm/buổi sáng tốt lành|d
好样=tốt lắm|d
好难=thật là khó|d
如同=như là/dường như/giống như/như thế|d
如实=chi tiết/như thực chất/đúng sự thực/sự thật/đúng sự thật/thực sự|d
如来佛=Phật Như Lai|d
如许=như thế/như vậy/những cái như vậy/những cái như thế|d
始一=vừa mới|d
始于=bắt đầu tại/bắt nguồn từ|d
始地=thủy địa|d
始才=mới|d
始然=thủy nhiên|d
始算=mới bắt đầu tính|d
始终=từ đầu đến cuối/thủy chung/trước sau|d
始自=bắt nguồn từ|d
姑且=tạm thời/tạm/cô thả|d
娓娓=êm tai/rủ rỉ|d
婉是=như là|d
婉约=uyển ước/uyển chuyển hàm xúc|d
宁愿=tình nguyện/thà rằng/thà|d
宁日=ngày yên tĩnh/ngày bình yên|d
定可=nhất định/chắc chắn/ắt - có thể|d
定当=ổn thỏa/thỏa đáng/thích hợp/đâu vào đó/nhất định phải/ắt phải/chắc chắn phải/ổn thoả/thoả đáng/nhất định|d
定时=định thời gian/đúng giờ/giờ quy định|d
定然=tất nhiên/chắc chắn/nhất định/ắt hẳn|d
定约=ký kết/ký hợp đồng/ước định/thoả thuận|d
定都=định đô/đóng đô/xây dựng kinh đô|d
实时=thời gian thực|d
实然=đột nhiên|d
实相=thực tướng|d
实际上=trên thực tế|d
对乎=đối thủ|d
对刚=đối cứng|d
对齐=xếp hợp lý/sắp xếp đồ/xếp ngay ngắn/xếp thẳng hàng|d
将要=muốn/sắp sửa/sắp/sẽ|d
將=tương|d
小不点=tiểu bất điểm/điểm không nhỏ/nhóc tỳ|d
小乎=tiểu tử|d
小偷=tiểu thâu/kẻ trộm/ăn trộm/tên trộm/kẻ cắp|d
小半=non nửa/non phân nửa/gần nửa|d
小幅度=biên độ nhỏ|d
小得多=nhỏ hơn nhiều/không lớn lắm|d
小断=đoạn nhỏ|d
小新=tiểu tân|d
小旦=Tiểu Đán|d
小步=bước nhỏ|d
小至=nhỏ đến|d
小许=tiểu Hứa|d
尚可=còn có thể/thượng khả|d
尚幼=còn trẻ con|d
尚摸=còn mơ hồ|d
尚新=mới tinh|d
尚早=còn sớm|d
尚未=chưa|d
尚远=rất xa|d
尤=vưu|d
尤为=càng/đặc biệt/sai|d
尤以=đặc biệt|d
尤其=nhất là/thực tế/vưu kì/đặc biệt là/càng/hơn nữa|d
尤加=Iuga|d
尤多=rất nhiều|d
尤是=riêng là|d
尤深=sâu hơn|d
尤甚=càng hơn|d
尤自=vưu tự|d
尤过=càng hơn|d
就=tựu|d
就便=thuận tiện/nhân tiện/tiện thể|d
就先=trước hết|d
就再=sẽ thấy|d
就势=nhân thể/tiện thể/nhân tiện/được thế|d
就同=liền cùng/sẽ cùng|d
就好=là tốt rồi/là được|d
就将=liền đem/liền sẽ|d
就少=liền thiếu đi/liền ít/liền ít đi/tựu ít đi|d
就已=đã|d
就快=cũng nhanh/cũng sắp|d
就怕=liền sợ/chỉ sợ|d
就怪=thì trách|d
就慢=cũng chậm|d
就敢=liền dám|d
就是=chính là/liền là/đúng thế|d
就来当=liền đến làm|d
就正=liền đang/xin ý kiến phê bình/học hỏi/xin chỉ bảo/xin chỉ dẫn|d
就此=như vậy/lúc đó/từ đấy/chính chỗ ấy/lúc ấy/đến đây/vì vậy/liền như vậy|d
就致=đã đưa|d
就要=liền muốn/liền phải/muốn/sẽ/sẽ phải|d
就近=lân cận/gần đây/liền gần/phụ cận|d
就里=nội tình/ý tưởng/tình hình nội bộ|d
尽先=ưu tiên/trước|d
尽兴=tận hứng/thoả thích/thoả thuê/thoả chí/thoải mái/đã/sướng|d
尽力=hết sức/tận lực/nỗ lực/gắng sức/cố gắng/ráng|d
尽可能=tận khả năng/làm hết sức|d
尽在=đều ở|d
尽处=nơi tận cùng/khắp nơi|d
尽头=phần cuối/cuối cùng/đầu cùng/cuối/phần dưới cùng/đáy/bờ bến|d
尽对=hết sức đối với|d
尽少=tối thiểu|d
尽心=tận tâm/dồn hết/tận lòng/hết lòng/hết lòng hết dạ|d
尽快=mau chóng/mau sớm|d
尽情=thỏa thích/thoả thích/thoả thuê/tận tình/tận lòng/tha hồ/mặc sức|d
尽数=đều/toàn bộ/hết mức|d
尽断=đứt đoạn|d
尽早=nhanh chóng/sớm|d
尽死=chết hết|d
尽算=tính hết|d
尽自=chỉ/vẫn/cứ|d
尽都=tất cả đều|d
尽量=tận lực/cố gắng hết mức/ra sức/cố sức/cố gắng hết sức/cố gắng đến mức cao nhất/tha hồ/thỏa thích/thỏa thuê/cố hết sức/gắng/ráng sức|d
居多=chiếm đa số/phần lớn/phần nhiều/số đông|d
居然=thế mà/lại có thể/rõ ràng/cư nhiên/lại/sáng sủa|d
届时=đến lúc đó/đến lúc/đến ngày/đúng giờ|d
届期=đến kỳ/đến thời hạn|d
屡=lũ|d
屡加=lớp|d
屡尝=lũ thường|d
屡屡=nhiều lần/luôn|d
屡次=nhiều lần/liên tiếp/hết lần này đến lần khác|d
屡经=lũ kinh|d
屹然=cao ngất/dáng sừng sững/cao chót vót|d
岂敢=sao dám/không dám|d
岂非=chẳng lẽ không phải/hẳn là|d
岿然=lù lù/sừng sững/cao ngất/cao chót vót/vị nhiên|d
差一点=kém một chút/thiếu một ít/thiếu chút nữa/thiếu một chút|d
差别=khác biệt/sai lệch/chênh lệch/sai khác/sự khác biệt|d
差得远=kém xa/kém xa lắm|d
已=dĩ|d
已不早=đã không còn sớm|d
已久=đã lâu|d
已于=đã ở|d
已将=đã xem|d
已小=đã nhỏ|d
已尽=đã hết|d
已往=trước đây/trước kia|d
已愈=cũng đã|d
已故=đã chết/đã qua đời|d
已断=đã đứt|d
已方=phe mình|d
已是=đã là/đã/đã là|d
已晚=đã muộn/đã tối/đã chậm|d
已暗=đã tối|d
已来=đã tới|d
已死=đã chết|d
已渐=đã hơi|d
已然=đã/dĩ nhiên/đã rồi/đã qua/đã như vậy/việc đã rồi|d
已经=đã/rồi|d
已而=đã mà/tiếp đó/ít lâu/không lâu sau/thôi/cho qua/dĩ nhi|d
已至=đã tới|d
已足=đã trọn|d
已过=đã qua|d
已近=đã gần đến|d
带劲儿=càng hăng|d
常定=Thường Định|d
常常=thường thường/thường/luôn|d
常年=lâu dài/quanh năm/hàng năm/năm bình thường|d
幡儿=phướn gọi hồn/phướn dẫn hồn|d
幡然=hoàn toàn/triệt để/mau chóng/phiên nhiên|d
干脆=dứt khoát/thẳng thắn/thành thật/sòng phẳng/cứ|d
并不=cũng không/không hề/chẳng hề/chả hề/chẳng|d
并不一定=cũng không nhất định|d
并举=đồng thời/đều phát triển/làm cùng lúc/tiến hành song song|d
并力=hợp lực|d
并未=vẫn chưa/cũng không/tuyệt không|d
并肩=sóng vai/kề vai/sánh vai/sánh bước/kề vai sát cánh/cùng nỗ lực/chung sức/hợp lực|d
幸亏=may mắn/may mà/may nhờ|d
幸免=may mắn thoát khỏi/may mắn tránh khỏi|d
幸得=may mắn được|d
幸而=may mà/may mắn|d
异举=dị cử|d
异乎=khác/dị hồ|d
异常=dị thường/khác thường/đặc biệt/phi thường/rất|d
异样=dị dạng/khác thường/khác nhau/thay đổi/đặc biệt|d
异次=dị thứ|d
异相=dị tướng/cảnh tượng kì dị|d
强直=tê cứng|d
当之=đương chi|d
当也=giờ cũng|d
当先=đi đầu/trước/dẫn đầu/lúc đầu/khi đó/trước tiên|d
当其=khi nó/trong khi|d
当即=lúc này/lập tức/ngay thức khắc/ngay tức thì|d
当得好=làm khá|d
当断=nên ngừng|d
当是=cho là/nghĩ là/coi là|d
当此=trong lúc|d
当然=đương nhiên/nên như thế/phải thế/tất nhiên/dĩ nhiên|d
当的=làm/làm đấy|d
当真=coi là thật/quả thật/khi chân|d
当紧=khẩn cấp/quan trọng/thiết yếu|d
当腰=ở giữa|d
彻夜=trắng đêm/thâu đêm/thâu đêm suốt sáng/suốt đêm/cả đêm|d
往下面=hướng phía dưới|d
往古来今=từ cổ chí kim|d
往复=lặp đi lặp lại/đền đáp lại/qua lại/đi lại/vãng phục|d
往常=thường ngày/thưòng lui tới/mọi khi/mọi ngày|d
往的=quá khứ/mê hoặc/đi|d
往腰=tới eo lưng|d
径大=khổng lồ|d
径往=kính vãng|d
径直=trực tiếp/thẳng/thẳng thắn/tiếp tục/tiếp|d
径自=thẳng/tự ý/kính tự|d
待旦=đợi sáng|d
很为=thực vì/rất là|d
很乖=rất ngoan/thật biết điều|d
很得法=rất đúng phương pháp|d
很快=rất nhanh|d
很早=rất sớm|d
很是=rất là|d
很晚=rất khuya/đã khuya/rất muộn|d
很期=rất tò mò|d
很狠=rất ác|d
很穷=rất nghèo/rất nghèo|d
很迟=rất trễ|d
徐步=từ từ/Từ Bộ/đi dạo|d
徒步=đi bộ/bộ hành|d
徒然=uổng phí/bỗng/vẻn vẹn/uổng công/chỉ/chỉ có|d
循声=theo tiếng|d
微乎=cơ hồ|d
微幅=biên độ cực nhỏ|d
微微=có chút/hơi/hơi hơi/có hơi/hiu hiu/mi-crô-mi-crô/na-nô/phần nghìn tỷ/Vivi|d
微疑=thoáng nghi|d
微睁=hơi mở|d
必=tất|d
必不得已=phải như vậy/nhất thiết phải như vậy|d
必偿=phải đền|d
必先=trước phải|d
必可=tất có thể|d
必定=nhất định/tất/chắc chắn/thế nào cũng|d
必将=chắc chắn/phải/tất nhiên/sẽ/ắt sẽ|d
必断=phải gãy|d
必方=Tất Phương|d
必是=hẳn là|d
必来=ắt tới|d
必点=nhất định sẽ điểm|d
必然=tất nhiên/thế nào cũng/tất yếu/tất/nhất định/chắc chắn/sự tất thế|d
必竟=dù sao|d
必经=cần phải trải qua|d
必至=sẽ đến|d
必要=tất yếu/cần phải/cần thiết/thiết yếu/không thể thiếu/không thể khác/vật cần thiết/điều cần thiết|d
必须=nhất định phải/phải/nhất thiết phải|d
忒=thắc|d
忙乎=bận bịu/bận rộn|d
忙声=tiếng bận|d
忙往=vội hướng về|d
忙忙=mang mang|d
快上=nhanh lên/khoái thượng/nhanh hơn/mau hơn|d
快于=nhanh hơn|d
快些=mau mau|d
快半=gần nửa|d
快嘴=lắm mồm/nhanh mồm/nhanh miệng/ba hoa/bẻm mép/nói năng bừa bãi|d
快将=mau đem|d
快当=sắp/nhanh nhẹn/nhanh nhạy/mau lẹ/lanh lợi|d
快得多=nhanh hơn nhiều|d
快快=mau mau|d
快意=khoái ý/sảng khoái/thoải mái|d
快慢=nhanh chậm/tốc độ/tốc lực/vận tốc/sự mau lẹ|d
快手=khoái thủ/người nhanh nhẹn|d
快暗=mau tối|d
快来=mau tới|d
快步=bước nhanh|d
快死=sắp chết/chết nhanh|d
快活=khoái hoạt/vui sướng/sung sướng/hài lòng/hoan hỉ/hân hoan/phấn khởi|d
快点=nhanh lên/nhanh lên một chút|d
快点儿=nhanh lên một chút|d
快要=sắp/định/gần/suýt|d
快过=nhanh hơn/mau hơn|d
快速=nhanh chóng/rất nhanh/thần tốc/cấp tốc/nhanh/tốc độ cao|d
快道=mau nói/khoái đạo|d
快门=cửa chớp/khoái môn/màn trập|d
快马=khoái mã|d
忽地=đột nhiên/bỗng/bỗng nhiên/đột ngột/thình lình/thoắt/bất thình lình|d
忽律=cá sấu|d
忽微=chuyện vặt/chuyện nhỏ|d
忽忽=thấm thoắt/thoáng qua/thoáng chốc/vù một cái/vèo một cái/nháy mắt/không được như ý/sơ ý|d
忽然=bỗng nhiên/đột nhiên/thình lình/bất thình lình/thoắt/bỗng/hốt nhiên/chợt vậy/chợt|d
忽略=xem nhẹ/quên/không chú ý/không lưu ý/sơ hở/chểnh mảng/lơ là/không để ý/sơ xuất/hốt lược/bỏ qua/coi thường|d
忽而=bỗng nhiên/đột nhiên/bỗng/thoắt/thình lình/đột ngột/lúc/lúc chợt|d
怅然=buồn bã/buồn vô cớ/thất vọng/tiu nghỉu|d
急中=trong lúc cấp bách|d
急于=nóng lòng/muốn làm ngay/muốn thực hiện gấp/muốn làm liền|d
急倒=ngã vội|d
急剧=kịch liệt/cấp tốc/nhanh mạnh/nhanh chóng|d
急忙=vội vàng/vội vã|d
急步=bước nhanh/bước vội/chạy nhanh|d
急眼=tức giận/nổi giận/nóng lòng/sốt ruột|d
急迫=cấp bách|d
急速=cấp tốc/nhanh chóng/lao nhanh/mau chóng|d
急难=cứu cấp/cứu nguy/cứu giúp|d
怪不=không lạ|d
怪怪=là lạ|d
怪样=quái dạng/bĩu môi/nhăn mặt|d
怪相=quái tướng/nhăn nhó/làm bộ nhăn nhó|d
恍然=giật mình/chợt/bừng tỉnh/tỉnh|d
恐怕=chỉ sợ/đáng sợ/sợ rằng/e rằng/liệu rằng/có lẽ/e sợ|d
恐是=sợ là|d
恐道=sợ hãi nói|d
恣情=tràn trề/thả cửa/phóng túng/tuỳ ý/bất kỳ|d
恣意=tuỳ tiện/bừa bãi/làm liều/mặc sức|d
恣肆=phóng túng/buông thả/hào phóng/phóng khoáng|d
恨上=hận lên|d
恨不得=hận không thể/nóng lòng/muốn/mong muốn/khao khát/nóng lòng mong muốn/hận không được|d
恨不能=hận không thể|d
恨声=giọng căm hận|d
恨意=hận ý/sự thù hận|d
恨死=hận chết|d
恰=kháp|d
恰可=vừa có thể|d
恰好=vừa lúc/vừa mới/đúng lúc/vừa đúng/vừa may/kháp hảo/vừa tốt/vừa vặn|d
恰巧=trùng hợp/vừa khéo/đúng lúc/vừa vặn/vừa may|d
恰当=thỏa đáng/thích hợp/thoả đáng/thích đáng/kháp đương|d
恰恰=vừa vặn/hoàn toàn/vừa lúc/vừa may/vừa đúng/kháp kháp|d
悄声=nhỏ giọng|d
悄步=bước nhẹ|d
悄然=lặng yên/bộ dạng âu lo/dáng vẻ ưu buồn/im bặt/im phăng phắc/im lặng/lặng lẽ|d
悄脸=mặt lặng|d
悉多=Sita|d
悉心=dốc lòng/hết lòng|d
悉数=toàn bộ/kể hết/đếm hết cả/tất cả/tất sổ|d
悍勇=dũng mãnh/dũng cảm/hãn dũng|d
悍将=hãn tướng|d
悍然=ngang nhiên/hung hãn/ngang tàng/ngang ngược|d
悍相=hãn tướng|d
悻=hãnh|d
悻幸=hậm hực|d
悻悻=hậm hực/phẫn nộ/hậm hực/Hãnh hãnh/tả cái dáng giận tức lộ ra ngoài|d
悻悻然=hậm hực/phẫn nộ|d
悻然=hậm hực/hờn giận/hờn dỗi|d
惟独=duy chỉ/duy độc/riêng chỉ/chỉ riêng/chỉ.../riêng..|d
惯偷=kẻ cắp chuyên nghiệp/kẻ cướp chuyên nghiệp/kẻ cắp quen tay/quen trộm|d
惯常=bình thường/đã từng/từng/thành thục/thường/hay/luôn/quán thường|d
想偷=muốn trộm|d
想必=chắc hẳn/sẽ/nói vậy/chắc chắn|d
愈加=càng thêm/càng... hơn|d
愈发=càng thêm/càng/dũ phát/bộc phát/càng phát|d
愈后=tốt hơn|d
愈复=đã phục hồi|d
愈大=càng lớn/ngày càng lớn|d
愈是=càng|d
愈来愈=càng lúc càng|d
愈渐=từ từ|d
愈甚=càng lắm|d
愈益=càng thêm/càng... hơn|d
愈越=dũ việt/vượt qua|d
愈趋=càng thêm|d
愤然=giận dữ/đầy giận dữ/bực tức|d
慢上=chậm hơn/mạn thượng|d
慢下来=chậm lại|d
慢于=chậm hơn|d
慢些=chậm một chút|d
慢则=chậm thì|d
慢得=chậm|d
慢慢=chậm rãi/từ từ|d
慢来=chậm đã|d
慢步=chậm rãi bước|d
慢活=chậm rãi sinh hoạt|d
慢点=chậm một chút|d
慢点儿=chậm một chút|d
慢行=đi từ từ/đi chậm/chậm chân/mạn hành/đi thong thả|d
慢说=khoan nói/đừng nói|d
慨然=xúc động/cảm động/cảm khái/khái nhiên/bùi ngùi vậy|d
或乎=có lẽ|d
或多或少=hoặc nhiều hoặc ít|d
或大或小=hoặc lớn hoặc nhỏ|d
或得=có thể được/hoặc là|d
或明=hoặc sáng|d
或明或暗=hoặc sáng hoặc tối|d
或暗=hoặc tối|d
或许=có lẽ/hay là/có thể/hoặc giả|d
或轻=hoặc nhẹ/hoặc nhẹ|d
截然=hoàn toàn/tuyệt nhiên/dứt khoát/rõ ràng/đầy đủ/trọn vẹn/toàn vẹn|d
才=tài|d
才刚=vừa mới/mới vừa/vừa|d
扶须=đỡ râu|d
批次=lượt|d
拟古=phỏng cổ/bắt chước lối cổ|d
拢共=tổng cộng/cộng lại/cộng tất cả|d
拨冗=bớt chút thì giờ/thu xếp công việc bớt chút thì giờ/nhín chút thì giờ|d
择日=tùy ý/trạch nhật|d
择期=chọn ngày|d
拼个=liều cái|d
拼力=hợp lực|d
按倒=đè ngã/ép đến|d
按时=đúng hạn|d
按期=đúng thời hạn/đúng hẹn|d
按次=theo thứ tự|d
按的=ấn/đè xuống đến mức|d
挨个=lần lượt/lần lượt từng cái|d
挨个儿=lần lượt từng cái/lần lượt/từng cái|d
挨次=lần lượt/tuần tự/liên tiếp|d
挨边=nép một bên/sát lề/gần/sắp|d
挨连=bụi cây|d
捎带脚儿=tiện thể/nhân tiện|d
据实=thật lòng|d
据对=đúng ra|d
据此=dưới đây|d
据点=cứ điểm/vị trí đổ bộ/đồn bót|d
据然=lại|d
撒旦=Satan|d
擅场=trội hẳn lên/áp đảo cả/hơn hẳn mọi người|d
擅自=tự tiện/tự ý|d
放肆=làm càn/suồng sã/láo xược/càn rỡ|d
故实=điển tích/câu chuyện lịch sử/giai thoại lịch sử/điển cố/xuất xứ|d
故常=cách cũ/cách làm thường lệ/lệ cũ/thành lệ|d
故意=cố ý/cố tình|d
故旧=bạn cũ|d
故然=tất nhiên|d
故都=cố đô|d
敢不敢=có dám hay không|d
敢当=dám đảm đương/dám cáng đáng/dám làm|d
整今=toàn bộ|d
整好=sửa lại|d
整晚=cả đêm|d
整齐=chỉnh tề/ngăn nắp/trật tự/làm cho ngay ngắn/làm cho có trật tự/ngay ngắn/hoàn chỉnh/đều/đều đặn/đồng đội|d
斗佛=Đấu Phật|d
斗勇=đấu dũng/so dũng khí|d
断乎=tuyệt đối/nhất định/hoàn toàn|d
断刚=Đoạn Cương|d
断后=đoạn hậu/cản phía sau/tuyệt tự/không người nối dõi/chặn hậu/cản ở phía sau|d
断然=quả quyết/kiên quyết/quả đoán/tuyệt đối/quyết|d
方敢=mới dám|d
方步=khoan thai/ung dung|d
旋即=chợt|d
无不=đều/đều bị/không khỏi/hoàn toàn|d
无别=không khác|d
无味=vô vị/nhạt nhẽo/nhạt phèo/không thú vị gì/chán phèo/chán|d
无声=im ắng/không tiếng động/im lặng/không hề có một tiếng động|d
无处=không chỗ|d
无奈=bất đắc dĩ/đành chịu/không biết làm sao/đành vậy/không có cách nào/tiếc rằng|d
无定=vô định|d
无将=không tướng|d
无尽=vô tận|d
无常=vô thường/Vô Thường/thay đổi luôn/không ổn định/thất thường/thần chết/quỷ vô thường/xảy ra chuyện vô thường/chết|d
无度=vô độ/không chừng mực/quá đáng/thái quá/quá chừng|d
无庸=không cần|d
无微=vô vi|d
无愧=không thẹn/không hổ thẹn/xứng/xứng đáng|d
无敢=không dám|d
无暇=không rảnh/hoàn mỹ/vô hạ/không rỗi/无瑕 (không tì vết)|d
无来由=không lý do|d
无疑=không thể nghi ngờ/không nghi ngờ gì/chắc chắn/quả quyết|d
无益=vô ích/không có ích/không ích gì|d
无码=không che|d
无穷=vô tận/vô cùng/vô hạn|d
无终=không có cuối cùng|d
无边=khôn cùng/vô biên/không giới hạn/không ranh giới|d
无须=không cần/không cần thiết/không râu|d
日以=ban ngày|d
日复=nhật phục|d
日常=thường ngày/hằng ngày|d
日渐=ngày càng/từ từ/dần dần|d
日趋=ngày càng/ngày một|d
日轻=tiểu thuyết nhẹ Nhật|d
早于=sớm hơn|d
早些=sớm đi/sớm chút|d
早先=trước kia/trước đây/ngày trước/vừa rồi|d
早就=đã sớm|d
早已=sớm đã/từ lâu/trước kia/trước đây/đã sớm|d
早早儿=sớm sớm/nhanh/mau|d
早是=sớm là|d
早死=chết sớm|d
早点=sớm một chút/cơm sáng/sớm chút/điểm tâm sáng|d
早点儿=sớm một chút|d
早经=sớm đã|d
早迟=sớm muộn|d
早都=đều sớm|d
时不时=thỉnh thoảng/thường thường/luôn luôn|d
时冉=Thời Nhiễm|d
时常=thường xuyên/thường thường/luôn luôn|d
时新=đúng mốt/hợp mốt|d
时而=khi thì/chốc chốc/lúc thì/thỉnh thoảng|d
暂且=tạm thời|d
暂停=tạm dừng/tạm ngừng/tạm ngưng/tạm ngừng trong chốc lát|d
暂别=tạm biệt|d
暂定=tạm định/tạm thời/tạm|d
暂当=tạm coi là|d
暂时=tạm thời|d
暂缓=tạm hoãn|d
暗中=âm thầm/trong bóng tối/trong bí mật/ngầm/lén lút/lén/sau lưng/bí mật/kín đáo/đằng sau hậu trường|d
暗之=ám chi|d
暗亏=thiệt ngầm/thiệt thòi/ám khuy/ám khuy (lén bị thiệt thòi)|d
暗处=chỗ tối/nơi tăm tối/chốn âm u/góc tối/chỗ bí mật|d
暗暗=âm thầm/ngầm/thầm/ngấm ngầm/lén lút|d
暗然=nhưng lại rối trí|d
暗码=ám mã/mã số lóng/mật mã hàng|d
暗自=âm thầm/thầm kín/trong thâm tâm/thầm/ngầm|d
暗许=ám hứa|d
暗门=cửa ngầm|d
更=canh|d
更不=lại càng không|d
更不疑=càng không nghi ngờ|d
更为=càng thêm/càng/thêm/hơn nữa/hơn|d
更久=càng lâu/lâu hơn|d
更其=càng/càng thêm/hơn nữa|d
更加=càng thêm/càng/thêm/hơn nữa|d
更动=thay đổi/biến đổi/sửa|d
更多为=càng đa số hơn|d
更多加=càng nhiều hơn hơn|d
更多好=càng thật tốt hơn|d
更多得=càng nhiều/càng đạt được nhiều hơn|d
更大=càng lớn/lớn hơn nữa/lớn hơn/càng to lớn hơn|d
更好=tốt hơn/càng tốt/càng dễ|d
更小=càng nhỏ hơn/nhỏ hơn|d
更少=càng ít/ít hơn|d
更忙=càng bận rộn/bận rộn hơn|d
更怕=càng sợ/sợ hơn|d
更怪=càng quái/càng trách|d
更慢=chậm hơn/càng chậm/càng chậm hơn|d
更新=đổi mới/canh tân/thay mới/rừng tái sinh/chương mới|d
更早=sớm hơn/càng sớm hơn|d
更易=càng dễ/thay đổi/biến đổi|d
更是=càng là/càng/càng là|d
更次=càng sau/canh/một canh|d
更正=sửa chữa/sữa chửa/đúng/cải chính/đính chính/sửa lại|d
更深=càng sâu/đêm khuya/nửa đêm/sâu hơn|d
更番=luân phiên/thay nhau|d
更穷=càng nghèo/nghèo hơn|d
更肆=càng làm càn|d
更要=càng muốn/càng phải|d
更觉=càng cảm thấy|d
更远=càng xa/xa hơn|d
更迟=muộn/trễ|d
更迭=thay đổi/đổi thay/luân phiên|d
更难=càng khó|d
更非=cũng không|d
曾=tằng|d
曾上=từng lên|d
曾为=từng vì/từng là|d
曾今=từng|d
曾易=Tăng Dịch|d
曾是=từng là|d
曾经=đã từng/từng|d
最为=nhất là/nhất/càng|d
最优=tối ưu|d
最先=trước hết nhất/trước hết|d
最少=ít nhất|d
最新=mới nhất|d
最早=sớm nhất|d
最是=nhất là/vô cùng nhất/nhất/là nhất|d
最最=cực kỳ/nhất|d
最未=chót nhất/chót/út|d
最次=kém nhất/cuối cùng|d
最深=sâu nhất|d
最深处=chỗ sâu nhất/nơi sâu xa nhất|d
最穷=nghèo nhất|d
最终=cuối cùng/cuối/sau cùng|d
最迟=chậm nhất/chậm nhất là/muộn nhất|d
有别=có khác/khác biệt/có khác biệt|d
有后=có hậu/có sau|d
有多深=sâu bao nhiêu/nhiều bao nhiêu/sâu đậm/bao sâu|d
有对=có đôi|d
有暇=có rảnh/có tỳ vết|d
有渐=dần có|d
有终=có cuối|d
有须=có râu|d
未便=không tiện/không nên/chưa tiện|d
未免=không khỏi/vị miễn/có hơi/có phần/khó tránh|d
未几=nhiều lần|d
未定=chưa định|d
未将=chưa đem|d
未尝=chưa chắc/khó/chưa từng/chưa hề/không hẳn/không phải là|d
未尽=chưa hết/đã hết|d
未得道=chưa đắc đạo|d
未必=chưa hẳn/vị tất/không hẳn/chưa chắc|d
未愈=chưa lành|d
未曾=chưa từng/chưa hề/chưa|d
未然=chưa xảy ra/chưa thành sự thật|d
未竟=chưa hoàn tất/chưa được/chưa hoàn thiện|d
未经=chưa/chưa qua|d
未见得=chưa chắc|d
未觉=chưa tỉnh/không cảm giác/chưa phát hiện|d
本不=vốn không|d
本为=vốn là|d
本以=vốn dĩ|d
本分=bản phận/bổn phận/an phận/yên phận/an phận thủ thường/giữ bổn phận|d
本意=bản ý/bổn ý/chủ ý/ý định ban đầu|d
本相=bản tướng/chân tướng/nguyên hình/diện mạo vốn có/bộ mặt vốn có/hình dạng cũ|d
本要=vốn muốn|d
本该=vốn nên/phải/nên|d
本非=vốn không phải là|d
权且=tạm thời/tạm|d
极个别=cực kì cá biệt|d
极为=cực kì|d
极其=cực kỳ/vô cùng/hết sức/cùng|d
极其可怕=cực kỳ đáng sợ|d
极好=vô cùng tốt/phi thường/phi phàm/quý giá/quý báu/có lợi/cực tốt|d
极对=rất đúng|d
极小=cực nhỏ/nhỏ nhất/cực tiểu/ít nhất/giá trị nhỏ nhất|d
极少=cực ít/cực nhỏ|d
极尽=cực điểm/hết sức|d
极度=cực độ/vô cùng/hết sức/quá sức/hết mức/cực điểm|d
极得=rất được/cực kỳ được|d
极忙=cực bận|d
极快=cực nhanh|d
极慢=cực chậm/thật chậm|d
极是=cực kỳ/rất đúng|d
极期=giai đoạn gay gắt nhất của bệnh/giai đoạn nguy kịch nhất/tột đỉnh/đỉnh cao nhất|d
极正=cực chính|d
极点=cực điểm/hết sức/vô cùng|d
极至=cực chí|d
极致=cực hạn/trình độ cao nhất/trình độ cực cao|d
极轻=cực nhẹ/nhẹ vô cùng|d
极速=cực tốc/cực nhanh|d
极难=rất khó/thật khó|d
果实=trái cây/quả thực/quả/thành quả/kết quả|d
果敢=quả cảm/dũng cảm/quả quyết|d
果断=quả quyết/quyết đoán/quả đoán|d
果然=quả nhiên/quả là/đúng là/thật sự/thực sự|d
果真=quả thật/quả thực/quả nhiên/không sai/quả vậy/quả đúng như vậy|d
格外=phá lệ/đặc biệt/vô song/vô cùng/khác thường/cực kỳ/hết sức/ngoài ra/cách khác|d
格致=truy nguyên/nghiên cứu đến cùng để biết nguồn gốc của sự vật|d
横步=bước ngang|d
横直=dù sao/dù sao cũng/dù sao đi nữa/dù thế nào đi nữa|d
横竖=dù sao/dù sao nữa/bất kỳ thế nào/thế nào đi nữa/dù sao cũng/hoành thụ|d
横越=ngang/ngang qua/vượt qua/băng qua/xuyên qua/vắt ngang/bắc ngang|d
欣月=Hân Nguyệt|d
欣欣然=vui vẻ/vui mừng|d
欣然=vui vẻ/vui sướng/hớn hở|d
止步=dừng bước/ngừng bước/dừng lại|d
正一道=đang cùng nhau|d
正中=chính giữa/chính trúng/ở giữa|d
正剧=chính kịch ̣|d
正处=chính xử|d
正常=bình thường/như thường|d
正手=tay thuận|d
正旦=chính đán/ngày mùng một tháng giêng/mùng một tết|d
正是=chính là/đúng là/chính thị/vậy|d
正步=đi nghiêm/bước đi nghiêm|d
正直=chính trực/ngay thẳng|d
正经=đứng đắn/chính kinh/nghiêm chỉnh/thập tam kinh/đoan trang/chính phái chính đáng/&thỏa đáng& chính thức/hợp tiêu chuẩn/đúng quy cách xác thực/thực tại/thực|d
正途=chính đồ/chính đạo/chính đồ/đường ngay|d
正门=cửa chính/ban ngày/cổng chính|d
死劲儿=hết sức/sức lớn nhất/gắng hết sức/lấy hết sức/cố sức|d
毅然=dứt khoát/kiên quyết/không chút do dự|d
毋庸=không cần|d
毋须=không cần/chớ làm|d
每一分=mỗi một phần|d
每句=mỗi câu|d
每夜=mỗi đêm|d
每常=thường thường/hàng ngày|d
每每=mỗi lần/mỗi khi|d
每经=mỗi khi trải qua|d
比分=điểm số/tỷ số|d
比得上=so ra mà vượt|d
比得过=hơn được|d
比肩=sánh vai/kề vai/so vai/sát cánh|d
比较=tương đối/so sánh/khá là/dường như/so với/hơn/khá|d
毕力=nỗ lực/gắng sức/tận lực/ra sức|d
毕天=Tất Thiên|d
毕竟=dù sao/rốt cuộc/cuối cùng/suy cho cùng/nói cho cùng/chung quy/dẫu sao|d
毫不=không chút nào|d
永不=vĩnh viễn không/vĩnh viễn không bao giờ|d
永为=vĩnh là/vĩnh viễn là|d
永久=vĩnh cửu/vĩnh viễn/lâu dài/mãi mãi|d
永别=vĩnh biệt|d
永正=Vĩnh Chính|d
永远=vĩnh viễn/mãi mãi/luôn|d
没劲儿=không sức lực|d
泛泛=hời hợt/sơ/qua loa/thông thường/bình thường/phiếm phiếm|d
活佛=Phật sống|d
深刻=khắc sâu/sâu sắc/cảm thụ sâu/hiểu sâu|d
渐=tiệm|d
渐久=tiệm cửu|d
渐偏=dần lệch|d
渐大=lớn dần|d
渐小=nhỏ dần/dần nhỏ|d
渐少=ít dần|d
渐快=nhanh dần/nhanh hơn|d
渐慢=chậm dần|d
渐暗=dần tối|d
渐次=dần dần/từ từ|d
渐渐=dần dần/từ từ/dần|d
渐稀=thưa dần|d
渐觉=dần thấy|d
渐趋=từ từ/tiệm xu|d
渐近=tiệm cận/tiến gần|d
渐远=xa dần|d
源远=nguyên viễn|d
满分=max điểm/mãn phân|d
满处=khắp/đầy đủ/khắp nơi|d
满期=mãn kỳ|d
满眼=đầy mắt/cho đã mắt/trong mắt/đâu đâu cũng thấy/hiện cả ra trước mắt/mặt tràn đầy|d
满脸=mặt mũi tràn đầy/vẻ mặt/mặt mũi/tỏ rõ vẻ|d
照实=tình hình thực tế/dựa theo tình hình thực tế|d
照常=như thường lệ|d
照旧=như cũ/như trước/theo lệ cũ|d
照样=như thường/làm theo/rập khuôn/như cũ/chiếu dạng|d
照此=dựa theo này|d
照直=đi thẳng/nói thẳng/thẳng đuồn đuộc|d
照相=chụp ảnh/chụp hình|d
照过相=chụp qua ảnh|d
片断=đoạn ngắn/ngắt quãng/mẩu/một đoạn/nhỏ nhặt/vụn vặt/không hoàn chỉnh|d
牢中=trong lao|d
牢内=trong lao|d
牢实=vững chắc/bền vững/rắn chắc/chắc chắn/tráng kiện|d
牢牢=một mực/vững vàng|d
牢门=cửa nhà lao/cửa lao/cửa tù|d
特为=riêng/chuyên/đặc biệt/chỉ|d
特么=mẹ nó/đặc yêu|d
特別=đặc biệt|d
特别=đặc biệt/vô cùng/rất/riêng biệt/chuyên biệt/càng/nhất là|d
特定=đặc biệt/riêng/chỉ định đặc biệt/riêng biệt/đặc định|d
特快=tốc hành/nhanh/đặc biệt nhanh/xe tốc hành|d
特意=cố ý/ý đặc biệt/riêng/chuyên/đặc biệt/có lòng|d
特批=đặc phê/đặc phê (*)|d
特此=nhân đây/do đó/do dó/đặc biệt ở đây|d
特独=đặc biệt|d
特约=mời riêng/hẹn riêng/đặt riêng/đặc ước|d
特许=đặc cách/giấy phép đặc biệt/phép đặc biệt/đặc biệt cho phép|d
狠命=hết sức/cố sức/liều mạng/thục mạng/liều lĩnh/ngoan mệnh|d
狠得心=nhẫn tâm được|d
狠心=nhẫn tâm/quyết/đành phải/bất chấp/ngoan tâm|d
狠狠=hung hăng/mạnh mẽ|d
狠狠心=quyết tâm|d
独处=một mình/một chỗ/sống một mình/sống cô độc/sống cô đơn|d
独断=độc đoán/chuyên quyền/võ đoán|d
独此=duy nhất cái này|d
独步=độc bộ/kiệt xuất/vượt bậc|d
独独=đơn độc/cô đơn/một mình|d
独眼=độc nhãn|d
独自=một mình/tự mình|d
猛不丁=bỗng nhiên/đầy người|d
猛力=mãnh lực/mạnh mẽ|d
猛劲儿=dồn sức/tập trung sức lực/hăng say/hăng hái|d
猛可=bỗng nhiên/bỗng|d
猛地=bỗng nhiên/mạnh mà/mạnh/chợt/đột nhiên|d
猛将=mãnh tướng/dũng tướng|d
猛然=đột nhiên/bỗng nhiên/bất thình lình|d
猛的=đột nhiên/chợt/mãnh|d
猝然=thốt nhiên/đột nhiên/bất ngờ/đột ngột/thình lình|d
率众=đem người|d
率先=dẫn đầu/trước tiên/tiên phong|d
率尔=khinh suất/qua loa/qua quýt/bất cẩn|d
率性=thẳng thắn/suất tính|d
率直=ngay thẳng/thẳng thắn|d
率真=thẳng thắn/thành thật|d
甚为=rất là|d
甚久=thật lâu sau/thật lâu|d
甚喜=rất mừng|d
甚多=rất nhiều|d
甚好=rất tốt|d
甚小=quá nhỏ|d
甚幸=rất may|d
甚得=rất được|d
甚微=quá mức bé nhỏ/quá nhỏ/rất ít|d
甚快=quá nhanh/rất nhanh|d
甚慢=quá chậm|d
甚或=thậm chí/ngay cả|d
甚是=rất là/thật là|d
甚深=quá sâu/rất sâu|d
甚缓=rất chậm|d
甚而=thậm chí/đến nỗi/ngay cả|d
甚至=thậm chí/ngay cả/đến nỗi|d
甚至于=thậm chí/thậm chí còn|d
甚轻=rất/quá nhẹ/rất nhẹ|d
甚远=rất xa/khá xa|d
甚速=rất nhanh|d
甚难=thật khó|d
生须=mọc râu|d
甫=phủ|d
由头=cớ/cái cớ/lý do/nguyên cớ|d
由易=từ dễ|d
由衷=từ đáy lòng/tự đáy lòng/từ trong thâm tâm|d
由难=từ khó|d
略同=gần giống nhau|d
略好=hơi tốt/lược hảo|d
略微=hơi/thoáng/một chút/một tí/hơi hơi/sơ sơ|d
略慢=chậm hơn/hơi chậm|d
略觉=hơi cảm thấy|d
疾忙=vội vàng/gấp gáp|d
疾趋=chạy nhanh/chạy nhốn nháo|d
痛经=đau bụng kinh/đau bụng khi hành kinh|d
登时=nhất thời/lập tức/ngay tức khắc/liền|d
登此=đăng cái này|d
白断=gãy không|d
白须=râu bạc trắng|d
百般=đủ kiểu/mọi cách/bằng mọi cách/bằng mọi giá/đủ loại/đủ điều/trăm điều/trăm chiều/dùng mọi cách|d
百须=bách tu|d
的么=sao|d
的当=hợp lý/làm/đích đáng/thoả đáng/coi là/đương|d
的是=chính là|d
的的确确=đích đích xác xác|d
的确=đích xác/hoàn toàn chính xác/đích thực/quả thực/quả là/đúng là/xác thực|d
皆=giai|d
益于=nhờ vào/nhờ sự giúp đỡ|d
直竖=dựng đứng/dựng thẳng/dựng lên|d
相一相=xem một chút|d
相互=tương hỗ/lẫn nhau/qua lại|d
相分=tương phân|d
相同=giống nhau/tương đồng/như nhau|d
相声=tướng thanh/tướng thanh (hát hài hước châm biếm)/tấu nói|d
相处=ở chung/sống chung với nhau/ăn ở với nhau/chung sống|d
相好=thân mật/nhân tình/thân nhau/bạn thân/yêu nhau/phải lòng/bồ/người tình|d
相对=tương đối/đối lập/so sánh|d
相当=tương đương/tương đối/khá cao/khá/rất|d
相抵=chống đỡ/tương để/giằng co|d
相机=máy ảnh/camera/Cameras/cameras/máy chụp hình/xem xét cơ hội|d
相约=hẹn nhau/ước hẹn/hẹn ước|d
相继=lần lượt/nối tiếp nhau|d
相许=tương hứa|d
相较=khách quan/tương giác/so sánh|d
相连=tương liên/liên kết|d
相里=họ Tướng Lý|d
相面=xem tướng/coi tướng|d
真不少=thật không ít|d
真个=chính xác/quả thật/thật là/rõ ràng là|d
真乖=thật ngoan|d
真佛=chân phật/Phật thật|d
真儿=Chân nhi|d
真力=chân lực|d
真味=mùi vị thực sự|d
真命=chân mệnh|d
真实=chân thực/chân thật|d
真少=thật ít|d
真巧=thật là khéo/thật là tinh xảo/thật là tấu xảo|d
真心=thực tình/thật tình/thành tâm/thật lòng thật dạ/thật bụng/thành thật/thật lòng/chân tâm/thiệt tình|d
真意=chân ý/ý thật/chân thành/chân thật/chủ ý|d
真慢=thật chậm|d
真敢=thực có can đảm/thật sự dám|d
真早=sớm thật|d
真是=thật sự là/thực sự là/rõ là/thật là|d
真正=chân chính/chính thức/thật sự/chính xác/xác thực|d
真死=chết thật|d
真相=chân tướng/bộ mặt thật|d
真真=thật thật/chân thực|d
真真是=thật sự là|d
真确=chân thật/chân thực/rõ ràng/rõ ràng chính xác|d
真穷=thật nghèo/nghèo vãi|d
真紧=thật chặt/thật chặt|d
真经=chân kinh|d
真身=chân thân|d
真难=thật khó|d
眼睁睁=trơ mắt/mắt mở trừng trừng|d
着劲儿=dùng sức/ra sức|d
着实=quả thực/thực tại/xác thực/quả là/thật là/nặng nề/ra trò/thật|d
着眼=suy nghĩ/quan sát|d
瞬即=lập tức/thuấn tức|d
瞬步=Thuấn Bộ/thuấn bộ|d
硬实=khoẻ mạnh/rắn chắc/ngạnh thật|d
硬是=quả thực là/đơn giản chỉ cần/dám/thật sự/thật là/chính là/vẫn cứ|d
碰巧=trùng hợp/tình cờ/vừa vặn/may/ngẫu nhiên|d
私自=tự mình/một mình|d
秉直=chính trực/cương trực|d
稍一=hơi chút|d
稍为=sơ qua/khá/hơi/một chút|d
稍候=chờ một chút|d
稍停=ngừng nghỉ/hơi nghỉ|d
稍刻=phút chốc|d
稍加=thêm chút/hơi thêm|d
稍动=hơi động/sảo động|d
稍后=sau đó/sau này|d
稍好=tốt hơn một chút|d
稍小=ít hơn|d
稍带=mang theo|d
稍微=hơi/hơi chút/sơ qua/một chút/hơi hơi|d
稍慢=hơi chậm|d
稍晚=chậm một chút/chậm hơn|d
稍暗=hơi tối|d
稍次=hơi kém|d
稍稍=thoáng/qua loa/sơ sơ|d
稍等=chờ một lát/chờ một chốc/chờ|d
稍许=sơ qua/hơi/một chút|d
稍轻=nhẹ hơn|d
稍近=hơi gần/lân cận|d
稍远=xa hơn một chút|d
稍迟=chậm hơn|d
稍顷=chốc lát|d
稳准狠=ổn chuẩn hung/vững vàng chuẩn xác|d
稳步=vững bước/vững chắc/vững vàng|d
究其=truy cứu/cứu kỳ/nghiên cứu|d
究竞=rốt cuộc|d
究竟=đến tột cùng/kết quả/thành quả/kết cục/phần cuối/rốt cuộc/cuối cùng|d
究级=cứu cấp|d
窄处=hẹp nhất|d
窄小=nhỏ hẹp|d
窄道=đường hẹp|d
窄门=cửa hẹp|d
立下=lập xuống/lập/lập được|d
立于=đứng ở/dựng ở|d
立体声=âm thanh nổi/âm thanh hi-fi|d
立候=đứng đợi/đợi lấy ngay|d
立分=đã phân|d
立刻=lập tức/tức khắc/ngay/lập tức. tức khắc/lập khắc|d
立即=lập tức/ngay|d
立地=đạp đất/đất trồng/lập tức/ngay|d
立定=đứng nghiêm/kiên định/đứng lại/chắc chắn/lập định|d
立愈=lập tức khỏi hẳn|d
立意=lập ý/dàn ý/quyết định/xác định chủ đề|d
立时=lập tức/ngay/tức khắc|d
立正=nghiêm/đứng nghiêm|d
立法=lập pháp|d
立眼=trợn mắt|d
立约=lập ước/công ước/giao kèo|d
立至=lập chí|d
立觉=bỗng thấy|d
立足=đặt chân/dừng chân/chỗ dựa/chỗ đứng/đứng/(*có chỗ đứng để sinh sống)|d
立身=lập thân/đứng thẳng/dựng thân|d
立面=mặt chính/vẽ ngoài|d
竞然=vậy mà/lại còn|d
竟=cánh|d
竟也=lại cũng|d
竟以=lại lấy/càng lấy|d
竟再=càng lại|d
竟在=lại|d
竟将=càng đem/lại đem|d
竟已=không ngờ|d
竟敢=dám/lại dám|d
竟是=đúng là/hẳn là/càng là|d
竟然=vậy mà/dĩ nhiên/cũng/mà/lại/vậy mà|d
竟究=lại rốt cuộc|d
竟自=nhưng vẫn/mà/lại/vậy mà/vậy lại|d
竟至=quả là/không ngờ/đến nỗi|d
竟觉=cảm giác|d
竭力=kiệt lực/tận lực/cố gắng/hết sức/cật lực|d
竭尽=cạn kiệt/dùng hết/dốc hết/đem hết|d
竭诚=tận tuỵ/hết sức trung thành/vô cùng chân thành/toàn tâm toàn ý/hết lòng hết dạ/hết lòng|d
简古=cổ xưa/khó hiểu|d
简直=quả thực/đơn giản/quả là/thật là/tưởng như là/chừng như/tưởng chừng như/dứt khoát/nhất quyết/nhất định|d
简码=giản mã|d
简约=giản lược/ngắn gọn/súc tích|d
素常=thường ngày/bình thường|d
素未=vốn không|d
索然=tẻ nhạt/đần độn/buồn tẻ/tác nhiên|d
索要=yêu cầu/đòi|d
紧忙=bận rộn lo lắng/căng thẳng bận rộn/bận túi bụi/vội vàng/hấp tấp/nhanh chóng|d
紧次=kém sát|d
紧紧=chăm chú/chú ý/tha thiết/chặt chẽ/sít sao/gắt gao/thân thiết/thật chặt|d
紧迫=gấp gáp/bức bách/cấp bách/gấp rút|d
累次=nhiều lần/liên tục|d
约分=rút gọn phân số/ước lượng phân số|d
约旦=Jordan|d
纯正=thuần tuý/thuần khiết/chính gốc/trong sáng/đúng đắn|d
纯然=thuần nhiên|d
纵声=ầm ĩ/inh ỏi|d
纵步=cất bước/rảo bước/bước nhảy|d
纵深=thọc sâu/bề dày về quân sự/tung thâm|d
纵眼=phóng tầm mắt|d
纵肩=nhún vai|d
纷乱=phân loạn/rối loạn/lung tung/hỗn loạn/lộn xộn/hỗn độn|d
纷纷=nhao nhao/đều/sôi nổi/ào ào/tới tấp/dồn dập/nhộn nhịp/rối rít|d
终久=cuối cùng/chung quy|d
终了=kết thúc/xong/cuối cùng|d
终于=rốt cục/cuối cùng/rốt cuộc|d
终其一生=cuối cùng cả đời/cả một đời|d
终古=mãi mãi/vĩnh viễn|d
终可=rốt cuộc có thể|d
终夜=suốt đêm|d
终将=cuối cùng rồi sẽ|d
终尽=chung tẫn|d
终归=chung quy/cuối cùng|d
终日=cả ngày/suốt ngày/trọn ngày|d
终是=cuối cùng là/cuối cùng|d
终未=cuối cùng cũng chưa|d
终点=điểm cuối/điểm cuối cùng/tới hạn/điểm kết thúc/điểm cuối|d
终究=cuối cùng/chung quy|d
终要=cuối cùng cũng phải|d
终身=chung thân/cả đời/suốt đời/trọn đời|d
经久=kéo dài/hồi lâu/lâu/lâu bền/không thay đổi/bền/trải qua hồi lâu|d
经在=đã tại|d
经常=thường xuyên/bình thường/hàng ngày/như thường lệ/thường thường/luôn luôn/thường|d
经得住=chịu được/chịu đựng được|d
经此=trải qua này|d
绝不=tuyệt không/tuyệt đối không|d
绝今=tuyệt kim|d
绝倒=cười ngất/cười lớn|d
绝后=tuyệt hậu/không con/không người nối dõi/sau này không còn nữa|d
绝命=tuyệt mệnh|d
绝地=tuyệt địa/nơi cực kỳ nguy hiểm/đường cùng/bước đường cùng|d
绝处=tuyệt xử|d
绝好=tuyệt hảo|d
绝对=tuyệt đối/hoàn toàn/nhất định/toàn bộ/dứt khoát/cực kỳ/cùng cực/nhất/cực/tuyệt|d
绝早=rất sớm/cực sớm|d
绝活=tuyệt chiêu/sản phẩm đặc biệt/tuyệt chiêu đặc biệt|d
绝然=tuyệt nhiên|d
绝续=đứt và nối/còn mất|d
绝非=tuyệt không phải/cũng không/tuyệt đối không phải|d
缓一缓=hoãn một chút/chậm một chút|d
缓地=chậm chạp|d
缓慢=chậm chạp/thong thả/từ tốn/không vội vàng/chầm chậm|d
缓期=hoãn lại/hoãn thời gian/kéo dài thời hạn/hoãn kỳ hạn|d
缓步=chậm rãi/đi chầm chậm/đi chậm/bước chậm|d
缓缓=chậm rãi|d
缓过劲来=thong thả lại sức/lấy lại sức được|d
翻倍=gấp bội/tăng gấp đôi|d
老许=lão Hứa|d
而别=chia tay|d
而定=mà định ra|d
而断=mà đứt|d
而终=mà kết thúc/mà chết/mà chấm dứt|d
聊且=tạm thời/tạm|d
联袂=cùng nhau/dắt tay nhau/nắm tay nhau/cùng/liên mệ|d
肆力=tận sức/tận lực/hết sức/làm hết sức|d
肆意=tùy ý/mặc ý/tuỳ tiện/tuỳ ý|d
胡须=sợi râu/chòm râu/hàm râu|d
自便=tự tiện/tuỳ tiện|d
自分=tự đánh giá/tự thấy|d
自古=từ xưa/từ xưa tới nay|d
自后=sau này/về sau/từ đó về sau|d
自尽=tự sát/tự vận/tự tử|d
自已=chính mình/tự mình/tự kiềm chế/kiềm nén/mình|d
自幼=thuở nhỏ|d
自愈=tự lành/tự khỏi/tự hết|d
自愧=tự thẹn|d
自愿=tự nguyện|d
自来=từ trước đến nay/từ trước đến giờ/xưa nay/vốn là|d
自然=tự nhiên/thiên nhiên/giới tự nhiên/tự do phát triển/đương nhiên/hiển nhiên|d
自由度=độ tự do|d
自禁=tự kiềm chế/nén/dằn|d
自经=tự tử/tự sát/tự vận/treo cổ tự tử|d
自苦=chuốc khổ/chuốc phiền|d
自觉=tự giác/cảm thấy/cảm giác/tự cảm thấy|d
自许=tự tán dương|d
自顾自=phối hợp/tự mình|d
至上=chí thượng/tối cao/cao nhất/trên hết|d
至为=quá sức|d
至今=đến nay/đến bây giờ|d
至刚=chí cương|d
至多=nhiều nhất/lớn nhất/tối đa/nhiều lắm là|d
至大=to lớn/chí đại|d
至好=bạn tốt/bạn chí thân/bạn thân|d
至少=chí ít/ít nhất|d
至快=nhanh nhất|d
至此=đến tận đây/đến đây/đến lúc này/đến nước này/đến bước này|d
至死=đến chết/chí tử/đến chết/cho đến chết|d
至深=sâu vô cùng/sâu nhất|d
至要=phương pháp tối ưu/phương pháp tốt nhất/phần quan trọng/phần trọng yếu|d
至诚=thành tâm thành ý/thật thà/thành thực/chân thành|d
至道=chí đạo/đến Đạo|d
至齐=đến đầy đủ|d
莫不=ai cũng/không ... không/không có cái nào không/không... không/nếu không/không ai không|d
莫奈=Monet|d
莫当=mạc đương|d
莫怕=chớ sợ|d
莫怪=chớ trách|d
莫敢=không ai dám/nào dám|d
莫然=im lặng|d
莫过于=không ai qua được/không gì bằng|d
蓄须=để râu|d
蓦=mạch|d
蓦地=bỗng dưng/bỗng/bất ngờ|d
蓦得=mạch đắc|d
蓦然=bỗng nhiên/chợt|d
被底=đáy chăn|d
被迫=bị ép/bị bắt buộc/bị thúc ép/bị buộc|d
詎=cự|d
誓约=thệ ước/thề ước|d
讵=cự|d
诚然=quả thật/thực vậy/thực mà/thực tế/thực tại/tất nhiên/cố nhiên/đương nhiên/thành nhiên|d
该当=phải làm/đáng/phải/nên/cần phải|d
谆谆=ân cần/khẩn thiết/thành khẩn/dặn đi dặn lại|d
豁然=thông suốt/bỗng nhiên/trở nên/rộng mở/rộng rãi|d
贸然=tùy tiện/tuỳ tiện/bừa/không suy nghĩ kỹ càng|d
赶上=đuổi kịp/gặp phải/vượt qua/bắt kịp/vấp phải/kịp/còn kịp/ép buộc/buộc/đuổi tới|d
赶下来=chạy xuống|d
赶不上=không đuổi kịp/cản không nổi/không bằng/không theo kịp/không kịp/không gặp/không có/không cản nổi|d
赶场=đi chợ/họp chợ/chạy sô|d
赶夜=đi đêm|d
赶巧=vừa vặn/đúng lúc/vừa đúng lúc|d
赶往=chạy tới|d
赶得上=theo kịp/đuổi kịp/kịp/còn kịp/gặp/gặp phải|d
赶忙=vội vàng/lập tức/mau/gấp/gấp rút|d
赶快=nhanh/mau mau/chạy nhanh/mau nhanh/nhanh lên/mau lên/khẩn trương|d
赶早=vội/mau/nhanh lên/mau lên/vội vàng|d
赶时间=đuổi thời gian/thời gian đang gấp/không có thời gian|d
赶明儿=ngày khác/kia/ngày kia/ngày nào đó|d
赶来=chạy đến/tới rồi/chạy tới|d
赶点=cố theo kịp/đến nơi/kịp thời cơ/kịp lúc/kiếm điểm/kêu số|d
赶紧=tranh thủ thời gian/nhanh lên/vội vàng/hấp tấp/khẩn trương/mau mau/nhanh chóng/vội/vội vã|d
赶过来=chạy tới|d
起先=thoạt đầu/khởi điểm/trước tiên/đầu tiên/ban đầu|d
起初=mới đầu/lúc đầu/đầu tiên/thoạt đầu/ban đầu/khởi đầu|d
起早=dậy sớm|d
起步=cất bước/khởi bước/cất bước/lăn bánh/khởi bộ|d
趁乱=thừa dịp loạn|d
趁便=nhân tiện/luôn dịp/sẵn tiện|d
趁势=thừa cơ/thừa thế/nhân dịp/thừa dịp|d
趁夜=thừa dịp lúc ban đêm/nhân màn đêm|d
趁手=tiện tay/tiện lợi/thuận tiện/sấn thủ|d
趁早=sớm làm/kịp thời/thừa lúc còn sớm mà hành động/càng sớm càng tốt/khi chưa muộn/kịp lúc|d
趁机=thừa cơ/nhân cơ hội/thừa cơ|d
趁此=thừa này|d
趁空=lợi dụng thời gian rảnh|d
越下=càng rơi xuống|d
越为=càng trở nên|d
越儿=Việt nhi|d
越剧=Việt kịch|d
越加=càng thêm|d
越发=càng phát ra/càng/càng... càng../càng ngày càng|d
越好=càng tốt|d
越小=càng nhỏ|d
越少=càng ít|d
越往=càng đi|d
越快=càng nhanh|d
越怕=càng sợ|d
越慢=càng chậm|d
越早=càng sớm|d
越是=càng là/càng|d
越机=Việt cơ|d
越来=càng ngày|d
越来多=càng tới nhiều|d
越来越=càng ngày càng|d
越深=càng sâu|d
越渐=càng lúc|d
越积=càng để lâu|d
越紧=càng chặt/càng chặt|d
越级=vượt cấp/vượt bậc|d
越要=càng phải|d
越趋=càng có xu hướng|d
越边=vượt biên|d
越过=vượt qua/lướt qua/vượt|d
越近=càng gần|d
越远=càng xa|d
越迟=càng trễ|d
越难=càng khó|d
足已=đủ để|d
足底=bàn chân/đủ để|d
足跟处=chỗ gót chân|d
足轻=túc khinh|d
轮不上=không đến lượt|d
轮次=theo trình tự/theo trật tự/theo tuần tự/theo thứ tự/số lần|d
轮番=thay nhau/luân phiên/thay phiên|d
轰然=ầm vang/ầm ầm/rầm rầm/rền vang/vang dội|d
轻分=tách nhẹ|d
轻在=nhẹ nhàng ở|d
轻声=nhẹ giọng/nói khẽ/thanh nhẹ|d
轻年=trẻ tuổi|d
轻度=cường độ thấp|d
轻微=rất nhỏ/nhẹ/hơi một chút/đôi chút/nhỏ nhẹ/nhẹ nhàng|d
轻快=nhẹ nhàng/nhẹ/nhanh nhẹn thoải mái|d
轻忽=khinh thường/xem thường/coi thường|d
轻慢=khinh mạn/ngạo mạn/khinh thường|d
轻步=bước nhẹ|d
轻点=điểm nhẹ/nhẹ chút/ điểm nhẹ/nhẹ một chút|d
轻缓=nhẹ nhàng chậm chạp|d
轻脆=giòn nhẹ|d
轻轻=nhẹ nhàng/khe khẽ|d
较为=tương đối/vừa phải/hơi|d
较之=so sánh với/so với|d
较偏=khá lệch|d
较场=sàn vật/sàn đấu võ|d
较早=hơi sớm/khá sớm|d
较晚=muộn/hơi muộn|d
较紧=khá căng|d
较迟=hơi trễ|d
较量=đọ sức/đấu/đọ sức/tính toán/so đo/tranh tài|d
迄今=cho tới nay/đến tận bây giờ/cho đến nay|d
迅即=lập tức|d
过之=qua|d
过刚=quá cứng|d
过深=quá sâu|d
过继=nhận làm con thừa tự/cho làm con thừa tự/cho làm con nuôi|d
迎面=đối diện/trước mặt/đâm đầu vào/chạm mặt|d
近乎=gần như/hầu như/thân mật/gần gũi/thân thiết/quen thuộc/dường như/sáp/gần/giáp/kề|d
这步=việc này|d
进一步=tiến một bước/tiến thêm một bước/hơn nữa/thêm một bước|d
进度=tiến độ/tiến độ kế hoạch|d
进步=tiến bộ/tiến lên/đi lên/tiến triển/phát triển|d
进深=độ sâu/chiều dọc/chiều dài/chiều sâu|d
进益=bổ ích/tiến bộ/tiến ích|d
远之=viễn chi|d
远些=xa một chút|d
远地点=điểm xa trái đất nhất|d
远较=hơn xa|d
远远=xa xa|d
远门=xa nhà/đi xa/bà con xa/chi họ xa/họ hàng xa|d
连声=liên thanh/không ngớt lời/luôn miệng/không ngớt lời|d
连夜=trong đêm/suốt đêm/mấy đêm liền/liền mấy đêm/cả đêm|d
连天=không ngớt/mấy ngày liền/liên tục/không ngừng/luôn/chọc trời/ngất trời//cả ngày/ngay cả thiên|d
连将=liền đem|d
连年=mấy năm liên tục/liên tục nhiều năm/nhiều năm liền/liên tiếp nhiều năm/nhiều năm liên tục|d
连忙=vội vàng/vội vã|d
连手=liên thủ/ngay cả tay|d
连日=mấy ngày liền/liên tiếp mấy ngày/mấy ngày liên tiếp|d
连番=luân phiên/liên tục|d
连袂=tay trong tay/cùng đến/cùng đi|d
连觉=thậm chí đi ngủ|d
连连=liên tục/lia lịa/liên miên/cuống quít/liên tiếp/liên liên|d
迟不迟=có chậm hay không|d
迟些=trễ chút|d
迟慢=chậm trễ/chậm chạp/rề rà|d
迟早=sớm muộn/không sớm thì muộn/trước sau gì|d
迟点=chậm một chút/một lát/chậm một chút|d
迟点来=tới trễ một chút|d
迟疑=chần chờ/chần chừ/do dự/ngập ngừng/lưỡng lự/không nhất quyết|d
迟缓=chậm chạp/đà đẫn/rề rà/trì trệ/chậm lại|d
迟迟=chậm chạp/trì trệ/chậm trễ/lần lữa/kề cà|d
迥然=khác hẳn/khác xa/huýnh nhiên|d
逐一=dần dần/từng cái/từng thứ/từng cái một/đếm từ số một|d
逐个=từng cái/từng chiếc/từng cái một|d
逐之=xua đuổi|d
逐年=từng năm/hằng năm/từng năm một/mỗi năm|d
逐日=từng ngày/hằng ngày/mỗi ngày/trục nhật|d
逐月=từng tháng|d
逐次=lần lượt/trục thứ|d
逐步=từng bước/lần lượt/trục bộ|d
逐渐=dần dần/từ từ/từng bước|d
逐级=từng cấp|d
通夜=suốt đêm/cả đêm|d
通常=bình thường/thông thường/thường thường|d
通往=thông hướng/đi thông/đi về|d
通经=thông kinh/thông hiểu kinh điển|d
通连=thông với/thông nhau/liền với|d
通都=thông đô|d
遽然=đột nhiên/bất thình lình/bất ngờ/đột ngột/cự nhiên|d
還=hoàn|d
都=đô|d
酌定=xét đoán/phán đoán|d
酌情=xét/xét tình hình cụ thể/chước tình|d
酌量=cân nhắc/suy nghĩ/đánh giá/tuỳ tình hình|d
酣然=say sưa/say bí tỉ|d
重不=nặng không|d
重之=trọng chi|d
重复=lặp lại/tha cho/chồng chéo/trùng lặp/trùng/nhắc lại/tái diễn|d
重愈=nặng hơn|d
重样=giống nhau|d
重迭=trùng điệp|d
长三=dài ba|d
长久=lâu dài/dài lâu|d
长于=sở trường/lớn ở/khéo/giỏi/chuyên|d
长仅=dài chừng|d
长处=sở trường/chỗ mạnh/điểm mạnh/ưu điểm|d
长夜=đêm dài/đêm trường/thời kỳ đen tối/cả đêm/trọn đêm|d
长年=nhiều năm/quanh năm/suốt năm/người ở đợ/đầy tớ/trường thọ/chủ thuyền/người chủ thuyền|d
长幼=trưởng ấu|d
长得多=lớn lên nhiều/dài hơn nhiều|d
长得快=lớn nhanh|d
长期=trường kỳ/thời gian dài/dài hạn/lâu dài|d
长活=ở đợ/người ở đợ/đầy tớ|d
长相=tướng mạo/mặt mũi/khuôn mặt/lớn lên|d
长脸=tăng thể diện/mặt dài/mọc mặt/tăng vinh quang/tăng thể diện (*mặt dài)|d
长近=dài gần|d
长远=lâu dài/dài lâu|d
长途=đường dài|d
长须=râu dài|d
间或=thỉnh thoảng/có lúc/ngẫu nhiên/hoạ hoằn|d
间断=gián đoạn/ngừng/đứt đoạn|d
阔少=cậu ấm/con nhà giàu/công tử bột|d
陆续=lần lượt/lục tục|d
陡度=độ dốc/dốc|d
陡然=đột nhiên/rồi đột nhiên/đột ngột|d
险乎=suýt nữa|d
险些=suýt nữa|d
险处=chỗ hiểm|d
随中=trong tùy tùng|d
随便=tùy tiện/tuỳ/tuỳ thích/tuỳ ý/mặc sức/tha hồ/tuỳ tiện/bất cứ|d
随劲=tùy kình|d
随即=lập tức/liền theo sau/ngay sau đó|d
随口=thuận miệng/nói thiếu suy nghĩ|d
随后=sau đó/theo sau|d
随喜=tuỳ hỉ/vui lòng làm chuyện công đức/vãn cảnh chùa/tham quan cảnh chùa|d
随地=tùy chỗ/bất cứ nơi nào/bất cứ chỗ nào/mọi nơi|d
随处=khắp nơi/tùy ý|d
随心=tùy tâm/tuỳ mình/tuỳ theo lòng mình/vừa ý/hài lòng|d
随意=tùy ý/tuỳ ý|d
随手=tiện tay/thuận tay|d
随时=tùy thời/bất cứ lúc nào/khi có yêu cầu/khi có thể|d
随机=ngẫu nhiên/tùy cơ hội/tùy cơ|d
随然=tùy nhiên|d
随笔=tuỳ bút/ghi chép/bút kí/tùy bút|d
随行=tùy hành/đi theo|d
随身=tùy thân/mang bên mình/theo bên người/bên người|d
随里=trong tùy tùng|d
隔别=cách biệt/chia tay|d
难不住=khó không được/không làm khó được|d
难不倒=không làm khó được|d
难于=khó mà/khó tại/khó với/khó ở chỗ|d
难以=khó mà/khó có thể|d
难倒=làm khó/chẳng lẽ|d
难免=khó tránh khỏi/khó tránh/miễn cưỡng|d
难处=khó xử/khó sống chung/khó ăn ở/khó khăn/chỗ khó|d
难奈=khó nại|d
难度=độ khó/mức độ khó khăn/trình độ khó/điều khó khăn|d
难当=không chịu nổi|d
难得=khó được/hiếm thấy/khó có được/ít thấy/hiếm có/ít có/khó|d
难得一见=khó gặp|d
难怪=khó trách/thảo nào/hèn chi/chẳng trách/chớ trách|d
难愈=khó lành|d
难是=khó là|d
难点=chỗ khó/chỗ vướng mắc/chỗ gay go/điểm khó khăn|d
难的=khó khăn|d
难禁=khó chịu|d
难越=khó vượt|d
难道=chẳng lẽ/lẽ nào/chẳng nhẽ|d
零时=lúc không giờ|d
霍乱=hoắc loạn/bệnh dịch tả/dịch tả/bệnh thổ tả|d
霍然=bỗng nhiên/đột nhiên/khỏi bệnh ngay/thuyên giảm nhanh chóng/hoắc nhiên|d
霎气=sương khói|d
霎然=vừa loáng|d
非也=cũng không phải|d
非凡=phi phàm/phi thường/lạ thường/khác thường|d
非分=không an phận/không nên có/không yên phận/không thuộc bản thân/không phải của mình|d
非同=không giống|d
非命=bỏ mạng/chết vì tai nạn|d
非复=không còn là|d
非少=Phi thiếu|d
非常=phi thường/vô cùng/đặc biệt/bất thường/không bình thường/rất/cực kỳ/hết sức|d
非得=phải/không phải/cần phải/thế nào cũng phải..|d
非死=không chết|d
非独=không những/chẳng những|d
非诚=không thành thật|d
非道=không phải đạo/phi đạo|d
非难=khiển trách/trách móc/chê trách/phê bình|d
顶一下=chống đỡ một hồi|d
顶多=nhiều lắm là/nhiều lắm/nhiều nhất|d
顶少=chí ít/ít nhất/ít ra|d
顷刻=khoảnh khắc/khoảng cách/phút chốc/chốc lát|d
顺其=thuận theo|d
顺手=thuận tay/thuận lợi/tiện tay/tiện thể/nhân tiện/nhân thể|d
顺次=lần lượt/theo thứ tự|d
顺眼=thuận mắt/vừa mắt/hợp nhãn|d
顺耳=dễ nghe/thuận tai/xuôi tai/lọt tai|d
顿住=dừng lại|d
顿刻=tạm thời/lập tức/tức thì|d
顿即=lập tức/tức thì|d
顿好=thu xếp tốt|d
顿时=lập tức/nhất thời/ngay/liền/tức khắc|d
顿然=đột nhiên/bỗng nhiên|d
顿笔=ngừng bút|d
顿缓=nhất thời dừng lại|d
顿而=nhất thời|d
顿觉=chợt cảm thấy|d
顿足=dậm chân/giậm chân|d
预后=dự đoán bệnh tình/đoán trước bệnh tình/tiên lượng bệnh/dự hậu|d
颇=pha|d
颇深=rất sâu/thâm hậu/khá sâu|d
颇远=tương đối xa/khá xa|d
频发=liên tiếp phát sinh/tần phát|d
频次=tần thứ/tần suất/tần số|d
频频=liên tiếp/tần tần|d
飘乎=phiêu hồ|d
飘然=phiêu nhiên/lóe lên/trôi giạt/bồng bềnh/lướt qua|d
飘远=bay xa|d
首先=đầu tiên/sớm nhất/thứ nhất/trước hết/trước tiên|d
首发=xuất ra đầu tiên/thủ phát|d
首尔=Seoul|d
首当=thủ đương|d
首相=Thủ tướng/thủ tướng|d
首肯=cho phép/gật đầu đồng ý/bằng lòng/đồng ý/thủ khẳng|d
首都=thủ đô/thủ phủ|d
马上=lập tức/ngay/tức khắc/liền lập tức/trên ngựa|d
马好=ngựa tốt|d
马快=sai nha|d
马步=trung bình tấn|d
马速=mã tốc|d
骤然=bỗng nhiên/chợt/đột nhiên/bỗng|d
高个儿=to con|d
高举=giơ cao/giơ lên cao/nâng cao/giương cao|d
高倍=bội số lớn|d
高处=chỗ cao/nơi cao/vị trí cao|d
高往=cao vãng|d
高慢=kiêu ngạo/ngạo mạn|d
高莫=Cao Mạc|d
高远=cao xa/thăm thẳm/cao vời|d
高速=cao tốc/nhanh chóng/tốc độ cao/cực nhanh|d
默然=im lặng/lặng lẽ/không nói gì|d
默许=ngầm đồng ý/bằng lòng ngầm/ưng thuận ngầm/ngầm cho phép|d
默默=yên lặng/lặng lẽ/im lặng|d
鼎新=cách tân/đổi mới/lập mới|d
齐往=tụ hướng|d
