一侧=một bên/hơi nghiêng|f
上下=trên dưới/cao thấp/già trẻ/từ trên xuống dưới/toàn thể/tốt xấu/giỏi kém/khoảng chừng/lên xuống/xuôi ngược|f
上中下=thượng trung hạ|f
上岸=lên bờ|f
上方=phía trên|f
上游=thượng du/hàng đầu|f
上端=đầu trên/đầu mút|f
上边=bên trên|f
上部=thượng bộ/bộ trên|f
上面=phía trên/mặt trên/trước/phần trên/trên/trên mặt/mặt/phương diện/cấp trên/hàng trên/vai trên/lớp trên/ở trên/thượng diện/bên trên|f
下方=phía dưới|f
下游=hạ du/hạ lưu/địa vị kém/lạc hậu|f
下端=phần dưới|f
下边=phía dưới/bên dưới/ở dưới/kẻ dưới|f
下部=phần dưới/hạ bộ|f
下面=phía dưới/ở dưới/phần dưới/dưới đây/cấp dưới/bên dưới|f
业内=nghiệp nội|f
东侧=phía đông/sườn đông/cánh đông|f
东北方=phía đông bắc/hướng đông bắc|f
东北角=góc đông bắc/góc đông bắc|f
东北面=mặt đông bắc|f
东南方=phía đông nam|f
东南角=góc đông nam|f
东南部=đông nam bộ/Đông Nam/phần đông nam|f
东南面=phía đông nam|f
东游=đông du|f
东端=đầu đông|f
东西向=đồ vật hướng/đông tây hướng|f
东西方=đông tây phương|f
东西部=Đông Tây Bộ|f
东角=góc đông|f
东部=đông bộ/phía Đông/phương Đông|f
东隅=đông ngung|f
东面=phía đông/mặt đông|f
东首=đầu đông|f
东麓=chân núi phía đông|f
两侧=hai bên|f
两岸=hai bên bờ/hai bờ sông/đôi bờ/hai bên bờ biển Đài Loan, ranh giới giữa Đài Loan và Trung Quốc|f
两旁=hai bên/trái phải hai bên|f
两边=hai bên/hai hướng/hai nơi/hai phía/hai phương diện|f
两间=hai gian|f
中下部=trung-hạ bộ|f
中北部=trung bắc bộ|f
中后期=trung hậu kỳ|f
中外=trung ngoại/trong và ngoài nước/trong nước và ngoài nước|f
中方=trung phương/Phía Trung Quốc/phía Trung Quốc|f
中游=trung du/trung bình/vùng trung du/miền trung du/bình thường|f
中部=trung bộ|f
中间=ở giữa/trung gian/chính giữa/giữa/bên trong/trung tâm|f
之上=phía trên/trên/bên trên|f
之下=phía dưới/dưới/bên dưới|f
之内=bên trong/ở trong/trong vòng|f
之前=trước đó/phía trước/trước khi/trước/lúc trước|f
之后=về sau/đời sau/đằng sau/lúc/khi/sau/chi hậu|f
之外=bên ngoài/ở ngoài/ra|f
之旁=bên cạnh/cạnh|f
之期=kỳ hạn|f
之来=chi lai/tới|f
之缘=duyên phận|f
之角=chi giác|f
之边=bên cạnh|f
之远=xa|f
之间=ở giữa/trong lúc đó/tầm đó/giữa|f
之际=lúc/chi tế/thời khắc|f
之面=mặt|f
以上=trở lên/trên đây/đã ngoài/lên/ở trên|f
以下=trở xuống/phía dưới/dưới/dưới đây/sau đây|f
以内=trong vòng/nội/trong khoảng|f
以前=trước kia/trước đây/ngày trước|f
以北=phía bắc|f
以南=phía Nam|f
以后=về sau/sau đó/sau này/sau khi|f
以期=để|f
以来=đến nay/tới nay/trước nay|f
以西=phía tây|f
以近=gần hơn/gần hơn,|f
以里=trong vòng|f
侧后=sau hông|f
侧后方=phía sau|f
侧方=bên cạnh|f
侧旁=bên cạnh/bên/mặt bên/bên hông|f
侧边=bên cạnh|f
侧近=cạnh/bên/gần|f
侧面=mặt bên/khía cạnh/bên cạnh/trắc diện/cạnh sườn/mặt sườn/mặt hông/mặt nghiêng|f
偏下=chếch xuống dưới/thiên hạ|f
偏外=thiên ngoại|f
偏旁=thiên bàng|f
关后=xem xét|f
其内=trong đó/bên trong|f
内侧=bên trong/Closed Beta/nội trắc|f
内部=nội bộ/bên trong|f
初中=sơ trung/trung học/trung học sơ cấp/trung học cơ sở/trung học đệ nhất cấp/trường cấp hai|f
前中后=tiền trung hậu|f
前后=trước sau/từ đầu đến cuối/đầu và cuối|f
前夕=đêm trước/trước giờ/trước lúc/trước giờ|f
前头=đằng trước/trước mặt/phía trước|f
前方=phía trước/tiền phương/đằng trước/trước mặt/tiền tuyến|f
前期=giai đoạn trước/tiền kì/ngày trước/tiền kỳ|f
前江=Tiền Giang/tỉnh Tiền Giang|f
前海=Tiền Hải|f
前端=phía trước/lối vào/front-end|f
前边=phía trước/đằng trước|f
前面=phía trước/đằng trước/phần đầu/trước mặt|f
北上=Bắc thượng/bắc thượng/lên phía bắc|f
北侧=cánh bắc|f
北向=bắc hướng/ngoảnh về hướng bắc|f
北岸=bờ bắc|f
北方=phương bắc/bắc phương/phương Bắc/khu vực Bắc bộ|f
北端=đầu bắc/đầu phía bắc/phía bắc|f
北边=phía bắc/phương Bắc/miền Bắc|f
北部=bắc bộ/phía bắc/phía bắc/phương bắc|f
北面=mặt phía bắc/phía bắc diện/quần thần/mặt quay về hướng bắc/phía bắc/mặt phía bắc|f
北麓=chân núi phía Bắc|f
南下=xuôi nam|f
南侧=phía nam/bên phía nam|f
南向=nam hướng/ngoảnh về hướng nam/hướng nam|f
南岸=bờ Nam/bờ phía nam|f
南方=phương nam/phía nam/hướng nam/miền nam/nam phương|f
南端=đầu nam/phía nam/nam đoan|f
南线=nam tuyến/tuyến đường phía nam|f
南边=phía nam/miền nam|f
南部=nam bộ/vùng phía nam/miền nam|f
南面=mặt phía nam/nam diện/ngoảnh về phương nam/phía nam/mặt nam|f
南麓=chân núi phía nam|f
反侧=nghiêng trở lại/phản trắc/trằn trọc/trăn trở/không phục tùng/không thuận lòng/không được lòng/không yên/hay thay đổi/tráo trở/thất thường|f
右上角=góc trên bên phải|f
右下方=phía dưới bên phải|f
右下角=dưới góc phải|f
右侧=phía bên phải|f
右半=nửa phải|f
右方=bên phải|f
右边=bên phải/hữu biên/phía hữu|f
右面=mặt phải/bên phải|f
后方=hậu phương/phía sau/sau|f
后边=phía sau|f
后部=phần sau/phía sau/đuôi thuyền/đuôi tàu|f
后面=đằng sau/phía/mặt sau/phía sau/tiếp sau/phần sau|f
周围=chung quanh/chu vi/xung quanh|f
周旁=khắp nơi|f
周游=chu du/đi du lịch khắp nơi/đi khắp nơi;chu du/đi khắp/đi khắp nơi|f
周边=xung quanh/quanh thân/chu vi/chung quanh/vật lưu niệm|f
四周围=chu vi|f
四围=xung quanh/chung quanh|f
四旁=bốn bề/xung quanh|f
四边=bốn phía/xung quanh/chung quanh|f
四近=vùng lân cận/vùng xung quanh|f
四间=bốn gian|f
外侧=cạnh ngoài/rìa ngoài|f
外围=bên ngoài/ngoại vi/chu vi/chung quanh/xung quanh/vòng ngoài|f
外方=bên ngoài|f
外来=ngoại lai/từ bên ngoài đến|f
外海=ngoại hải/hải ngoại|f
外边=bên ngoài/ngoài/mặt ngoài/phía ngoài|f
外部=ngoại bộ/phần ngoài/vẻ ngoài/bề ngoài/mặt ngoài/bên ngoài|f
外间=gian ngoài/phòng ngoài/ngoài/bên ngoài|f
外面=bên ngoài/bề ngoài/phía ngoài|f
左上角=góc trái trên cùng|f
左侧=bên trái/phía trái|f
左岸=tả ngạn/bờ trái|f
左边=bên trái|f
左近=lân cận/gần kề/phụ cận/bên cạnh/bên trái|f
左面=bên trái/bên/phía trái|f
底下=dưới đáy/dưới/phía dưới/bên dưới/sau này/sau đó/tiếp đó|f
底中=trong|f
底内=trong /bên trong|f
底来=sâu cạn|f
底端=đáy/để đoan|f
底角=góc đáy|f
底边=đường đáy/cạnh đáy|f
底部=dưới đáy/cuối cùng/để bộ|f
底里=nội tình bên trong/bên trong/nội tình|f
底面=mặt dưới/đáy|f
庭前=đình tiền/trước sân|f
当面=ở trước mặt/ngay mặt/trước mặt/phía trước/ở trước mặt|f
斜边=cạnh xéo/cạnh chéo/cạnh xiên|f
旁侧=bên hông|f
旁旁=rong ruổi|f
旁边=bên cạnh/hai bên trái phải/chỗ tiếp cận|f
最上层=tầng cao nhất|f
最下角=góc dưới cùng|f
最内间=bên trong nhất|f
最南端=vùng cực nam|f
最后=cuối cùng/tối hậu/sau cùng|f
最近=gần nhất/gần đây/mới đây/vừa qua|f
最间=ở giữa nhất|f
期中=giữa kỳ/bên trong|f
期内=bên trong|f
期期=kỳ nào|f
期间=trong lúc đó/trong đó|f
末后=cuối cùng/sau hết/sau cùng|f
末期=thời kì cuối/mạt kì/mạt kỳ|f
末端=cuối cùng|f
正上方=ngay phía trên|f
正东方=hướng chính đông|f
正前方=ngay phía trước|f
正北方=phía chính bắc|f
沿岸=ven bờ/dọc theo bờ|f
沿江=vùng ven sông|f
沿海=duyên hải/vùng duyên hải|f
沿线=dọc tuyến|f
沿街=bên đường/dọc phố/dọc đường|f
皮上=trên da|f
肚上=trên bụng|f
肚中=trong bụng/bụng|f
肚内=trong bụng|f
背上=trên lưng/cõng lên|f
背下来=học thuộc/gánh vác|f
背侧=bên lưng|f
背后=phía sau/sau lưng/lưng/mặt trái/ngấm ngầm/vụng trộm|f
背部=phần lưng/lưng|f
背面=mặt sau/mặt trái/lưng/phía sau|f
脚上=trên chân|f
脚下=dưới chân/trước mắt/hiện nay/gần/sắp|f
脚前=chân trước|f
脚旁=bên cạnh chân|f
脚部=cước bộ/bước chân|f
脚面=mu bàn chân/bàn chân/cước diện|f
裡面=bên trong|f
西侧=phía Tây/phía tây|f
西北方=hướng tây bắc|f
西北角=góc Tây Bắc/góc tây bắc|f
西北边=tây bắc biên|f
西北部=tây bắc bộ/tây bắc/phần tây bắc|f
西北面=phía tây bắc|f
西南方=phía Tây Nam|f
西南角=góc tây nam/góc Tây Nam|f
西南边=biên giới tây nam|f
西南部=tây nam bộ/Tây Nam/phần tây nam|f
西南面=mặt tây nam|f
西游=Tây Du|f
西端=đầu tây|f
西角=góc hướng tây|f
西部=tây bộ/Tây Bộ/miền tây/vùng phía tây|f
西面=phía tây/mặt tây|f
西麓=chân núi phía tây|f
足部=bắp chân/phần đùi|f
跟上=đuổi theo/đuổi kịp/bắt kịp/theo kịp/sánh kịp/đuổi tới|f
跟前=trước mặt/bên cạnh/cạnh/gần/sắp tới/tới đây/gần tới/bên mình/trước người|f
身侧=bên cạnh thân/bên cạnh người/bên hông/bên người|f
身后=sau lưng/phía sau/sau khi qua đời/sau khi chết|f
近海=gần biển/duyên hải|f
里中=phòng trong|f
里侧=bên trong|f
里内=phòng trong/dặm trong|f
里半=dặm rưỡi|f
里外=trong ngoài/dặm ngoài/hơn dặm/ngoài dặm/hơn…dặm|f
里头=bên trong|f
里边=bên trong|f
里间=phòng trong/trong|f
里面=bên trong/trong|f
附上=kèm thêm/đính kèm|f
附下=gần xuống|f
附中=trường trung học phụ thuộc|f
附近=phụ cận/lân cận/vùng phụ cận/vùng lân cận/gần đây/gần|f
面上=trên mặt/nét mặt|f
面前=trước mặt/phía trước/trước mắt|f
面对面=mặt đối mặt|f
面部=bộ mặt/khuôn mặt|f
顶上=trên đỉnh/chống lên|f
顶端=đỉnh/mút/chỏm/chóp/cuối/cuối cùng/sau cùng/chót/đầu mút/chóp đỉnh|f
顶部=đỉnh chóp/đỉnh/chóp/mui/trần/ngọn/đầu/nóc|f
