一共=hết thảy/tổng cộng/gồm|j
一内一外=một trong một ngoài|j
一副副=một gương mặt|j
一发发=từng phát|j
一弹指=gảy ngón tay một cái/một cái gảy ngón tay/một cái đạn chỉ|j
一战=một trận chiến/đánh một trận/nhất chiến|j
一拖=khẽ kéo|j
一排排=từng dãy/từng hàng|j
一改=thay đổi|j
一筹=một bậc/một nước/một bước/một cấp|j
三三制=chế độ 33|j
三中全会=Tam Trung Toàn Hội|j
三人行=ba người đi/nhóm ba người|j
三伏=tam phục/mùa nóng/mạt phục|j
三公=Tam công/tam công|j
三军=tam quân/ba quân/quân đội|j
三无=ba không|j
三行=ba hàng|j
三长两短=không hay xảy ra/việc bất trắc/chuyện không may/tối lửa tắt đèn/tam trường lưỡng đoản/chuyện bất trắc|j
三陪=ba bồi|j
三飞=tam phi/ba chuyến bay|j
上下游=thượng hạ du|j
上佳=thượng giai/thượng cấp|j
上届=khóa trước/thượng giới|j
上校=thượng tá/thượng giáo/Thượng tá|j
上百=trên trăm/hơn trăm|j
上院=thượng viện|j
世届=thế giới|j
东盟=Đông Minh/đồng minh|j
东直=cổng Đông Trực|j
两广=Lưỡng Quảng|j
两晋=Lưỡng Tấn|j
两淮=Lưỡng Hoài|j
两行=hai hàng|j
两长一短=hai dài một ngắn|j
两院=hai viện|j
个人财产=cá nhân tài sản|j
中下游=trung hạ du|j
中专=trung chuyên/trung cấp|j
中专生=trung chuyên sinh|j
中产=trung sản|j
中介=môi giới/người đại lý/trung gian|j
中伏=trúng phục kích/tiết Trung Phục/khoảng tiết Trung Phục|j
中低层=trung đê tầng|j
中低端=trung đê đoan|j
中保=người trung gian/người môi giới/người đứng giữa và người bảo đảm/trung bảo/người đứng giữa nhận trách nhiệm giới thiệu cả hai bên|j
中军=trung quân/chủ soái/1.trung quân|j
中医=Trung y/trung y/Đông y/y học Trung Quốc/thầy thuốc Đông y/bác sĩ Đông y|j
中小=trung tiểu/bên trong tiểu|j
中小企业=doanh nghiệp vừa và nhỏ/các doanh nghiệp vừa và nhỏ|j
中小学=trung tiểu học/trường tiểu học và trung học cơ sở/trung học tiểu học|j
中小学生=học sinh trung tiểu học|j
中招=trúng chiêu|j
中指=ngón giữa/bên trong chỉ|j
中校=trung tá/trung giáo/Trung tá|j
中老年=trung lão niên|j
中行=trung hành/làm phải|j
中西医=Trung Tây y|j
中选=trúng tuyển/chọn vào/bên trong tuyển|j
中院=trung viện|j
中飞=bên trong bay/trung phi|j
乒乒=binh binh|j
九大=chín đại/cửu đại|j
九行=cửu hành|j
九运=cửu vận|j
乾粮=lương khô|j
二三流=nhị tam lưu|j
二伏=trung phục/tiết trung phục|j
五大=ngũ đại|j
五小=ngũ tiểu|j
五小时=năm tiếng đồng hồ/năm giờ|j
五指=năm ngón tay/ngũ chỉ|j
五行=Ngũ Hành|j
亚运会=Á vận hội|j
交投=gặp nhau/giao nhau|j
交警=cảnh sát giao thông|j
交通运输=chuyên chở/vận tải|j
产权证=giấy chứng nhận quyền sở hữu|j
人和=người cùng/nhân hòa/sự đoàn kết của nhân dân/nhân hoà|j
人均=bình quân đầu người|j
人多=nhiều người|j
人大=nhân đại/Đại hội Nhân dân/đại hội đại biểu nhân dân toàn quốc|j
人证=nhân chứng/người làm chứng|j
仓促间=trong lúc vội vã|j
仓储=cất vào kho/chứa trong kho/bỏ vào kho|j
伪证=ngụy chứng/chứng cứ ngụy tạo/chứng cứ giả|j
作伪证=cho lời khai giả/khai man|j
俄军=quân Nga|j
光大=làm vinh dự/làm rạng rỡ/làm vinh quang hiển hách/rộng lớn/to lớn/đông đảo|j
光电=quang điện|j
党委=đảng uỷ/đảng ủy|j
党委办=văn phòng đảng ủy|j
党支部=chi bộ đảng|j
党证=thẻ đảng/thẻ đảng viên|j
八大=bát đại|j
公共财产=tài sản chung/tài sản công cộng|j
六军=Lục Quân|j
六合=lục hợp/trên dưới và bốn phương/Lục Hợp|j
六大=lục đại/Lục Đại|j
六小=sáu tiểu|j
六小时=sáu tiếng|j
六指=lục chỉ|j
六畜=lục súc/gia súc|j
六管=sáu nòng|j
六经=lục kinh/sáu kinh|j
六证=lục chứng|j
军人证=căn cước quân nhân|j
军邮=quân bưu/bưu chính quân sự/hệ thống bưu chính quân sự|j
农协=hiệp hội nông nghiệp|j
农帮=Nông bang|j
农牧=nông mục/trồng trọt chăn nuôi|j
农行=nông hành|j
农贸=nông mậu|j
冬奥会=Olympic mùa đông/Thế vận hội mùa đông|j
冬运=vận tải mùa đông|j
出新招=ra chiêu mới|j
函大=đại học hàm thụ|j
刑侦=hình sự trinh sát/hình trinh|j
刑满=hết hạn tù|j
刑警=cảnh sát hình sự/hình cảnh|j
创优=gắng hết sức/cố hết sức|j
创投=đầu tư mạo hiểm/đầu tư|j
北伐=bắc phạt|j
北军=Bắc Quân|j
北双=Bắc Song|j
北大=Bắc Đại|j
医保=bảo hiểm y tế|j
医大=đại học y khoa|j
医证=giấy chứng nhận y tế|j
十三太保=Thập Tam Thái Bảo/thập tam thái bảo|j
十三经=thập tam kinh|j
十六强=thập lục cường/Top 16|j
十兵卫=Jubee'|j
十卫=thập vệ|j
十大=thập đại|j
十强=thập cường|j
十指=mười ngón/mười ngón tay|j
十杰=thập kiệt|j
十盟=thập minh|j
十进制=thuật toán/hệ thập phân|j
南投=Nam Đầu|j
南行=đi về phía nam|j
印证=xác minh/chứng thực/kiểm chứng/vật dùng chứng minh/ấn chứng|j
县政协=huyện chính hiệp/huyện chính hiệp|j
发改委=phát cải ủy|j
发短信=gửi nhắn tin|j
同业=đồng nghiệp/cùng ngành/cùng nghề/bạn đồng nghiệp/người cùng ngành|j
同人展=triển lãm doujin|j
同伐=cùng thế hệ|j
同化=đồng hóa/đồng hoá/hiện tượng biến âm|j
同宽=rộng bằng nhau|j
同居=ở chung/ở cùng/chung sống/ăn ở với nhau|j
同校=cùng trường|j
同游=cùng dạo/đồng du|j
同盟=đồng minh/khối đồng minh/tổ chức đồng minh|j
同行=đồng hành/cùng ngành/cùng nghề/người cùng nghề/người cùng ngành/song hành/cùng đi|j
后援会=hậu viện hội/hội hậu viện|j
四人帮=Tứ Nhân Bang|j
四伏=tứ phía/mai phục khắp nơi|j
四办=Phòng 4|j
四大=tứ đại/Tứ đại|j
四战=bốn trận chiến/tứ chiến|j
四指=bốn ngón tay|j
四散=tứ tán/phân tán bốn phía/tản đi khắp nơi|j
四海帮=Tứ Hải Bang|j
四行=tứ hạnh/tứ hạnh tứ hạnh/tứ hạnh tứ hạnh|j
团控=đoàn khống|j
国企=xí nghiệp nhà nước/quốc xí|j
国共=quốc cộng|j
地保=địa bảo/lính bảo an địa phương|j
外企=xí nghiệp bên ngoài|j
夜航=Dạ Hàng|j
大专院校=trường cao đẳng|j
大排档=quán bán hàng|j
大排行=theo thứ tự/vai vế|j
天地会=thiên địa sẽ/Thiên Địa hội|j
太保=Thái Bảo/thái bảo/Thái bảo|j
太行=Thái Hành|j
太贪=quá tham|j
央企=ương xí|j
央告=cầu khẩn/cầu xin/van xin|j
央托=van nài/nhờ làm hộ|j
央行=ngân hàng trung ương|j
央视=ban tổ chức/ương thị|j
奥运=Olympic|j
奥运会=thế vận hội Olympic|j
妇联=hội Liên hiệp Phụ nữ/Hội Liên hiệp Phụ nữ/hiệp hội phụ nữ|j
妊妇=phụ nữ mang thai/bà bầu|j
婚介所=trung tâm giới thiệu hôn nhân|j
婚外=ngoài giá thú/không hôn nhân|j
婚检=kiểm tra sức khoẻ|j
存储=tồn trữ|j
安全区=khu vực an toàn/khu an toàn|j
安全期=kỳ an toàn|j
家产=gia sản/gia tài/tài sản|j
家伏=gia phục|j
家信=thư nhà|j
家小=nhà tiểu/vợ con/vợ|j
家电=đồ điện gia dụng|j
家访=đi thăm hỏi các gia đình/viếng nhà/thăm viếng|j
家财=gia tài/gia sản|j
家长会=hội phụ huynh/họp phụ huynh|j
家长制=chế độ gia trưởng|j
寧=ninh|j
少保=thiếu bảo/thái bảo|j
居委会=cư ủy hội|j
川帮=Xuyên Bang|j
工兵连=công binh liên|j
工农联盟=liên minh công nông|j
工商业=công thương nghiệp/nghề buôn bán|j
工商会=hội công thương|j
工商局=cục Công Thương/cục công thương|j
工商联=hội liên hiệp công thương nghiệp|j
工商银行=ngân hàng Công Thương|j
左证=chứng cứ/bằng chứng|j
巴比=Barbie|j
常委=thường ủy|j
常委会=thường ủy hội|j
干警=cảnh sát/cán cảnh|j
干证=nhân chứng/người làm chứng|j
年产=sản lượng hàng năm/sản xuất hàng năm|j
年华=tuổi tác/thì giờ:tuổi tác/thì giờ/niên hoa|j
年幼=tuổi nhỏ/còn tấm bé|j
建委=kiến ủy|j
彩超=thải siêu|j
德比=Debby|j
德行=đức hạnh|j
总后勤部=tổng hậu cần bộ|j
恒产=bất động sản|j
成反比=thành tương phản/tương phản/thành ngược lại/tỉ lệ nghịch|j
户均=bình quân hộ gia đình|j
房中术=thuật phòng the|j
房产=bất động sản|j
房产证=giấy tờ bất động sản/bất động sản chứng|j
房地产=bất động sản/phòng địa sản|j
房客=khách trọ/người thuê nhà/khách thuê nhà|j
房展=phòng triển lãm/triển lãm phòng|j
房改=cải cách nhà ở/cải cách chế độ nhà ở|j
房管=quản lý bất động sản/quản lý địa chính/sở địa chính|j
房管局=cục quản lý bất động sản|j
房角=góc phòng|j
房院=sân phòng|j
打短工=làm công ngắn hạn/làm thuê ngắn hạn|j
打砸抢=phá phách cướp bóc|j
技穷=kỹ cùng|j
技高一筹=cao hơn một bậc/kỹ cao một bậc|j
抗粮=chống giao nộp lương thực|j
抗美援朝=kháng mĩ viện triều/chống Mỹ cứu nước/Chống Mỹ, giúp Triều Tiên|j
拉大=kéo dài/lạp đại|j
拉比=Labie/Rabi|j
招投标=chiêu đầu tiêu|j
招招=chiêu chiêu/từng chiêu/chiêu nào chiêu nấy|j
掌控=chưởng khống/khống chế/nắm trong tay|j
改一改=sửa lại/sửa lại một chút|j
政协=hội nghị hiệp thương chính trị/chính hiệp|j
数伏=vào hè/vào hạ|j
数到三=đếm tới ba|j
数控=điều khiển kỹ thuật số|j
斐=phỉ|j
日产=mỗi ngày sản xuất|j
日化=nhật hóa|j
日大=ngày càng lớn|j
日行=ngày đi|j
最小化=thu nhỏ lại|j
月华=ánh trăng/ánh sáng trăng/quầng trăng/vầng sáng quanh mặt trăng|j
月桂=nguyệt quế|j
月比=Thi Đấu Hàng Tháng|j
期中考=thi giữa kỳ|j
期中考试=thi giữa kỳ|j
期冀=hi vọng|j
本地化=bản địa hoá/bản địa hóa/thích ứng|j
村委会=thôn ủy hội|j
林副局=Lâm cục phó|j
欧化=âu hoá|j
欧盟=Liên Minh Châu Âu EU|j
欧运=Âu Vận|j
武侦=Butei|j
武比=đọ võ/vũ bỉ|j
武行=võ hạnh/vai võ phụ|j
武警=cảnh sát vũ trang/vũ cảnh|j
毛纺=dệt len/hàng dệt len/hàng len|j
民航=hàng không dân dụng|j
江浙=Giang Chiết|j
江淮=Giang Hoài|j
沪=Thượng Hải|j
沽=cô|j
泛指=phiếm chỉ/nói về|j
泛黄=ố vàng|j
洋地黄=cây dương địa hoàng/địa hoàng tây|j
活地图=bản đồ sống/người quen tình hình/người thành thạo đường đi nước bước|j
深化=gia tăng/sâu sắc hơn/đi đến chỗ sâu sắc hơn/thâm hóa|j
深广=sâu rộng|j
深部=thâm bộ|j
深院=thâm viện|j
深黄=thâm trầm/vàng sẫm|j
渝=du|j
港澳=Hong Kong|j
港警=nhân viên bến cảng/nhân viên chỉ huy ở bến tàu|j
滇=điền|j
滦=loan|j
火控=điều khiển hoả lực/kiểm soát hỏa hoạn/kiểm soát hỏa lực|j
环保=hoàn bảo/bảo vệ môi trường/vòng bảo vệ|j
环保局=hoàn bảo cục|j
环卫=bảo vệ môi trường|j
环合=vây quanh/chung quanh/xung quanh|j
环指=còn chỉ|j
环游=hoàn du|j
环行=đi vòng/đi đường vòng|j
环视=đảo mắt/nhìn chung quanh/nhìn bốn phía|j
环顾四周=ngắm nhìn bốn phía|j
珠宝行=cửa hàng châu báu|j
生啤=sinh ti|j
生长期=thời kì sinh trưởng|j
畲=xa|j
盐帮=Diêm bang|j
省人大=tỉnh nhân đại|j
省委=Tỉnh ủy|j
省政协=tỉnh chính hiệp|j
省纪委=tỉnh kỷ ủy|j
省视=thăm viếng|j
省运会=tỉnh vận hội|j
石化=hóa đá/hoá đá|j
石帮=Thạch bang|j
研发=nghiên cứu phát minh/nghiên cứu|j
社保=bảo hiểm xã hội|j
私企=xí nghiệp tư nhân|j
科大=Bách Khoa|j
科比=khoa bỉ|j
空投=nhảy dù/thả dù/tiếp tế đường không/không đầu|j
立宪=lập hiến|j
立法会=hội lập pháp|j
管委会=quản ủy hội|j
粤=việt|j
粮行=lương hành|j
红筹=hồng trù|j
纪委=Ban Kỷ Luật Thanh tra/kỷ ủy/Ban Kỷ Luật Thanh Tra/Kỷ ủy|j
纪检=kiểm tra kỷ luật/kỷ kiểm|j
纪检委=kỷ kiểm ủy|j
纪检组=kỷ kiểm tổ|j
纪行=nhật ký hành trình|j
经侦=kinh trinh/qua điều tra|j
美军=quân Mỹ|j
美容美发=mỹ dung mỹ phát|j
美工=trang trí/nghệ nhân trang trí|j
老三届=lão tam giới|j
老弱病残=già yếu tàn tật/người già yếu tàn tật/người già yếu/người già yếu bệnh hoạn/người già yếu bệnh tật|j
联电=điện báo/thông báo bằng điện tín|j
联盟=liên minh|j
船老大=chủ thuyền/bác lái đò/người lái chính|j
苏共=Đảng Cộng Sản Liên Xô/Tô Cộng/Đảng cộng sản Liên Xô|j
苏小小=Tô Tiểu Tiểu|j
苏比=Tô Bỉ|j
英军=quân Anh|j
药检=kiểm tra chất cấm/kiểm tra thuốc/kiểm tra ma túy|j
蓉=dung|j
西行=đi về phía tây|j
证伪=chứng giả/chứng thực|j
证监会=chứng giám hội|j
财大=tài đại|j
财贸=tài mậu/tài chính mậu dịch/tài chính thương mại|j
质保=bảo đảm (warranty)|j
质检=chất kiểm/kiểm tra chất lượng/Chất lượng/qc|j
质证=đối chứng/đối chất|j
贫下中农=bần hạ trung nông/bần nông và trung nông|j
贸贸=lèm nhèm|j
超短裤=quần soóc ngắn/quần đùi ngắn/quần cực ngắn|j
足协=liên đoàn bóng đá|j
足银=bạc đủ tuổi/bạc ròng|j
车展=triển lãm xe/triển lãm ô tô/triển lãm mô tô|j
轻信=dễ tin/cả tin/nhẹ tin|j
轻化=nhẹ hóa|j
边检=biên kiểm|j
辽军=Liêu quân|j
通信=thông tin/thư từ qua lại/thư đi tin lại|j
通共=tổng cộng/tất cả|j
通电=mở điện/có điện/gửi điện thông báo/đánh điện/bức điện thông báo|j
通联=liên lạc/liên hệ/thông tin liên lạc|j
通胀=lạm phát|j
通航=thông tàu thuyền/thông máy bay|j
通行=thông hành/qua lại/đi lại/thông dụng/lưu hành/dùng chung/đi chung|j
通透=thông thấu/thông suốt|j
通邮=trao đổi bưu kiện/thư từ qua lại|j
道行=đạo hạnh|j
邮电=bưu điện|j
钢硬=cứng rắn/kiên cường|j
钻石矿=mỏ kim cương|j
闽粤赣=Mân Việt Cán|j
陕甘=Thiểm Cam|j
青帮=Thanh Bang/Thanh bang|j
青电=Thanh Điện|j
青贮=ủ phân xanh/ủ xi-lô|j
革委会=Cách ủy hội/Ủy ban Cách mạng|j
鲁比=Rewby|j
黄赌毒=nội dung độc hại|j
黔=kiềm|j
