一不小心=không cẩn thận/không nghĩ qua là|l
一专多能=nhất chuyên đa năng|l
一个巴掌拍不响=một cây làm chẳng nên non/tại anh tại ả, tại cả hai bên|l
一举数得=một mũi tên trúng mấy chim|l
一了百了=chấm dứt|l
一亿人=một trăm triệu người|l
一介不取=mảy may chẳng chịu lấy/nhất giới bất thủ/một mảy chẳng chịu lấy|l
一件件=từng kiện/từng kiện từng kiện/từng món một/một kiện kiện|l
一伸一缩=lắc lư liên tục|l
一位数=một chữ số|l
一元复始=nhất nguyên phục thủy|l
一决胜负=một quyết thắng bại|l
一决雌雄=nhất quyết thư hùng/một quyết thư hùng/để cạnh tranh cho một chức vô địch|l
一击必中=một kích tất trúng|l
一分高下=một phân cao thấp|l
一到九=một đến chín|l
一动不动=không nhúc nhích/vẫn không nhúc nhích|l
一动不如一静=một động không bằng một tĩnh|l
一包在内=bao gồm tất cả/tổng cộng tất cả|l
一反常态=thái độ khác thường|l
一变二=một biến hai|l
一变再变=biến rồi lại biến|l
一呼一吸=một hít một thở/mỗi lần hít thở|l
一呼百应=nhất hô bách ứng/được nhiều người ủng hộ|l
一品红=cây trạng nguyên|l
一国三公=một nước ba vua/quyền lực không thống nhất|l
一国之君=nhất quốc chi quân/vua của một nước|l
一国之母=nhất quốc chi mẫu|l
一声不吭=không rên một tiếng/không nói tiếng nào|l
一声不响=không nói một tiếng|l
一声令下=ra lệnh một tiếng|l
一大家子=cả một nhà/cả cái nhà|l
一大早=sáng sớm|l
一大笔钱=một số tiền lớn|l
一天到晚=suốt ngày/từ sáng đến tối/cả ngày lẫn đêm|l
一头雾水=không hiểu ra sao/đầu óc mơ hồ|l
一奶同胞=đồng bào cùng một mẹ|l
一子一女=một trai một gái/một con trai một con gái|l
一字一句=mỗi chữ mỗi câu/gằn từng chữ/từng chữ từng câu|l
一字一字道=từng chữ từng chữ nói|l
一字一板=nói năng rành mạch/rành rọt từng chữ|l
一字一顿=từng chữ nói ra/một chữ một cái/từng chữ từng chữ|l
一字不差=không sai một chữ/không kém một từ/nguyên văn|l
一字不易=một chữ không đổi|l
一字之差=kém một chữ/kém nhau một chữ|l
一字千金=một chữ ngàn vàng/một chữ nghìn vàng/có giá trị văn chương cao/một chữ đáng giá nghìn vàng|l
一字排开=xếp thành một hàng/xếp hàng ngang|l
一学就会=vừa học liền biết|l
一定之规=ý đã định/quy tắc đã định|l
一家家=từng nhà|l
一小堆=một đống nhỏ/một đống nhỏ|l
一席之地=một chỗ cắm dùi/nhỏ nhoi/thấp kém/một chỗ ngồi/một vị trí|l
一席话=một lời nói/buổi nói chuyện/lời nói|l
一干二净=không còn một mảnh/không còn một mống|l
一年一度=mỗi năm một lần|l
一年到头=quanh năm suốt tháng/suốt năm|l
一年多来=hơn một năm qua|l
一心二用=nhất tâm nhị dụng/nhất tâm nhị dụng(*)/thứ nhất nghĩ thứ hai là làm|l
一心多用=nhất tâm đa dụng|l
一息尚存=còn lại một hơi/đến hơi thở cuối cùng|l
一想通=nghĩ thông suốt|l
一成多=hơn một phần mười|l
一把子=một nhóm người|l
一把抓=ôm đồm/đồng loạt/làm đồng loạt không phân biệt nặng nhẹ/vồ một cái|l
一拐一拐=chân thấp chân cao|l
一拖再拖=hết kéo lại kéo|l
一招一式=một chiêu một thức/từng chiêu từng thức|l
一招半式=một chiêu nửa thức|l
一损俱损=có nhục cùng nhục/nhất tổn câu tổn|l
一揽=bao quát|l
一揽子=tổng quát/hàng loạt/cả gói|l
一摆=bãi xuống/ngăn/chặn lại/ngăn lại/vẫy một cái|l
一教就会=vừa dạy liền biết|l
一文不值=không đáng một đồng/không đáng giá một đồng|l
一文不名=không xu dính túi/nghèo xơ xác|l
一无所好=không có điều gì hay|l
一无是处=không còn gì khác/cái gì cũng sai/không đúng tý nào/tồi tệ|l
一日游=du lịch một ngày/chuyến du lịch một ngày|l
一时之间=trong lúc nhất thời/trong khoảng thời gian ngắn|l
一时半会=nhất thời bán hội/nhất thì bán hội/trong thời gian ngắn|l
一时半会儿=một lát/một chốc|l
一暴十寒=buổi đực buổi cái/một ngày phơi nắng mười ngày để lạnh/cả thèm chóng chán|l
一本万利=một vốn bốn lời/buôn một lãi mười|l
一条条=từng đầu/từng cái/một mảnh dài hẹp/từng cái từng cái|l
一条线=một đường|l
一条藤儿=cùng một giuộc/cùng một dây|l
一来二去=một tới hai đi|l
一查到底=tra đến cùng|l
一样样=từng loại|l
一模一样=giống nhau như đúc|l
一步之遥=cách xa một bước/một bước ngắn|l
一步到位=một bước đến nơi/một bước tại chỗ/giải quyết một vấn đề trong một lần|l
一步棋=một nước cờ|l
一段时间=một đoạn thời gian/một thời gian ngắn/một quãng thời gian|l
一段落=một giai đoạn/một giai đoạn, một đoạn/một đoạn|l
一段话=một đoạn văn/nhất đoạn văn|l
一段路=một đoạn đường|l
一派胡言=nói bậy nói bạ/một bên nói bậy nói bạ/hoàn toàn là nói bậy|l
一浪高过一浪=sóng sau cao hơn sóng trước|l
一清二楚=nhất thanh nhị sở/rõ rõ ràng ràng|l
一清二白=rõ ràng|l
一溜风=vụt đi/nhanh như chớp|l
一炮打响=một pháo nổ vang/làm lần đầu đã thành công|l
一炮而红=một lần là nổi tiếng|l
一片空白=trống rỗng|l
一物降一物=vỏ quýt dày có móng tay nhọn|l
一环扣一环=một vòng chụp một vòng|l
一生一世=một đời một thế/cả cuộc đời/một đời một kiếp|l
一男一女=một nam một nữ|l
一男三女=một nam ba nữ|l
一男二女=một nam hai nữ|l
一白一红=một trắng một đỏ|l
一着地=vừa chạm đất|l
一睹=thấy/chứng kiến|l
一石激起千层浪=một viên đá dấy lên ngàn cơn sóng|l
一碗水端平=xử lý sự việc công bằng/nước trong một chén thẳng băng|l
一票否决权=một phiếu quyền phủ quyết|l
一笔带过=sơ lược/tóm lược|l
一线天=nhất tuyến thiên|l
一统天下=nhất thống thiên hạ|l
一群群=từng bầy/từng nhóm một/từng bầy từng bầy|l
一老一少=một già một trẻ|l
一肚子气=đầy bụng tức giận/tức cành hông|l
一肚子火=nổi giận trong bụng|l
一股脑=một mạch/một tia ý thức|l
一股脑儿=toàn bộ/tất cả/hết thảy|l
一脉相传=nhất mạch tương truyền, cha truyền con nối/cha truyền con nối/truyền từ đời này sang đời khác|l
一般化=chung chung|l
一般地说=nói chung|l
一般性=nói chung/đa số|l
一般来说=bình thường mà nói|l
一般而言=thông thường mà nói/nói chung|l
一般般=bình thường/bình thường thôi|l
一般见识=chấp nhặt/không chấp nhặt/không tranh chấp với người kém hiểu biết|l
一般说来=bình thường nói đến|l
一表非凡=tướng mạo phi phàm|l
一触即爆=hết sức căng thẳng/chạm vào là nổ ngay|l
一言不=không một lời|l
一言为定=một lời đã định|l
一语中的=một câu trúng đích/trong một từ/đánh dấu bằng một nhận xét|l
一语破的=nói trúng tim đen/gãi trúng chỗ ngứa|l
一诺千金=lời hứa ngàn vàng|l
一路上=trên đường đi/dọc theo đường đi|l
一路货色=kẻ giống nhau|l
一路顺风=thuận buồm xuôi gió/lên đường xuôi gió|l
一较高下=phân cao thấp|l
一连气儿=liên tiếp/không ngừng|l
一醉方休=không say không nghỉ|l
一钱不值=không đáng một xu/không đáng giá một đồng tiền/rẻ mạt/không đáng một đồng|l
一锅粥=hỗn loạn/rối ren/lung tung|l
一锤子买卖=mua bán một lần/làm một cú|l
一门心思=tập trung tinh thần/một lòng một dạ|l
一闪而藏=chợt lóe rồi biến mất|l
一闪而过=chợt lóe lên|l
一问一答=một hỏi một đáp|l
一阵风=một trận gió/thoáng/chớp nhoáng/một chốc/một lát/một cơn gió|l
一阶一阶=một bậc một bậc/một cấp một cấp|l
一阶之差=kém một cấp|l
一阶比一阶=cấp nọ so với cấp kia|l
一阶灵脉=linh mạch cấp một|l
一阶阶=từng bậc từng bậc|l
一雄一雌=một đực một cái|l
一青一红=một thanh một hồng|l
一颦=một cái nhăn mày/nhăn mặt|l
一颦一笑=một cái nhăn mày một nụ cười/một cái nhăn mày một tiếng cười/một cái nhíu mày một nụ cười|l
七亿人=bảy trăm triệu người|l
七弯八拐=bảy rẽ tám quẹo|l
七拐八弯=bảy quẹo tám rẽ|l
七拐八拐=bảy lần quặt tám lần rẽ/thất quải bát quải|l
七步成诗=bảy bước thành thơ|l
七脉会武=thất mạch hội võ|l
七言诗=thơ thất ngôn|l
万世不易=vạn thế không đổi|l
万事具备=vạn sự sẵn sàng|l
万人之上=trên vạn người|l
万分感激=cảm kích vạn phần|l
万有引力=lực vạn vật hấp dẫn/sức hút|l
万种风情=phong tình vạn chủng|l
三一律=luật tam nhất|l
三不管=việc không ai quản lí/việc ba vạ|l
三亿人=ba trăm triệu người|l
三位一体=tam vị nhất thể/một thể ba ngôi|l
三句话=ba câu nói|l
三好学生=học sinh ba tốt|l
三字经=Tam Tự kinh|l
三教九流=tam giáo cửu lưu/đủ hạng người|l
三灾八难=tam tai bát nạn|l
三班倒=thay phiên ba ca|l
三男一女=ba nam một nữ|l
三管齐下=ba thứ kết hợp|l
三级跳远=nhảy ba bước/nhảy 3 bước/ba cấp nhảy xa/Nhảy 3 bước|l
三花脸=vai hề|l
三角函数=hàm số lượng giác|l
三角恋爱=tình yêu tay ba/tình tay ba/mối tình tay ba|l
三蹦子=xe ba bánh/ba cái bungee|l
上上下下=từ trên xuống dưới|l
上上之策=thượng sách|l
上下其手=giở trò/giở thủ đoạn|l
上不着天=trên không chạm trời/bên trên không chạm trời|l
上了贼船=lên phải thuyền giặc|l
上千人=hơn nghìn người/hơn ngàn người|l
上吐下泻=thượng thổ hạ tả/thổ tả|l
上呼吸道=đường hô hấp trên|l
上天入地=lên trời xuống đất|l
上天无路=lên trời không đường|l
上层建筑=kiến trúc thượng tầng|l
上当受骗=bị lừa|l
上有老下有小=trên có già dưới có trẻ|l
上气不接下气=thở không ra hơi/thở không được|l
上班时间=giờ làm việc|l
上皮组织=tổ chức thượng bì/biểu mô|l
上窜下跳=luồn lên nhảy xuống/thượng thoán hạ khiêu/nhảy nhót tưng bừng|l
上贼船=lên thuyền giặc|l
上蹿下跳=trên nhảy dưới tránh/thượng thoan hạ khiêu/trên nhảy dưới tránh (*né đòn)/nhảy nhót tưng bừng|l
上辈子=đời trước/tổ tiên/kiếp trước|l
下一关=cửa ải tiếp theo|l
下一场=trận tiếp theo/cuộc kế tiếp|l
下一辈=một đời sau|l
下三滥=hạ lưu/thấp hèn|l
下三烂=hạ tiện|l
下不为例=lần sau không thể chiếu theo lệ này nữa/lần sau không được viện dẫn lẽ này nữa/chỉ giải quyết như vậy một lần thôi/lần sau không được vi lệ|l
下不了台=xuống đài không được/không xuống đài được/tiến thoái lưỡng nan|l
下不来台=xuống đài không được/không xuống đài được/sượng mặt/mất mặt|l
下不着地=dưới không chạm đất/bên dưới không chạm đất|l
下划线=đường gạch chân/gạch dưới/gạch chân|l
下句话=câu kế tiếp|l
下周一=thứ hai|l
下回分解=hạ hồi phân giải|l
下围棋=chơi cờ vây|l
下地无门=không cửa xuống đất|l
下定义=hạ định nghĩa|l
下定决心=hạ quyết tâm|l
下有对策=dưới có đối sách/dưới đây có biện pháp đối phó|l
下楼去=đi xuống lầu|l
下流无耻=hạ lưu vô sỉ|l
下班时间=lúc tan việc|l
下着雨=mưa|l
下着雪=có tuyết rơi|l
下礼拜=tuần sau|l
下笔千言=hạ bút thiên ngôn/bút thiên ngôn|l
下苦功=chịu khổ cực/gắng sức|l
下落不明=tung tích không rõ|l
下辈子=kiếp sau/đời sau|l
不一会=chỉ chốc lát|l
不上不下=nửa vời/không tốt cũng chẳng xấu/xoàng/tầm thường/vừa phải/bậc trung/tiến thoái lưỡng nan/dở ông dở thằng/dở dang/lỡ dở/không trên không dưới|l
不上就不上=không thượng sẽ không thượng|l
不上眼=không vừa mắt|l
不下雨=không mưa|l
不不上=trên không ra  không ra|l
不中意=không hợp ý/không trúng ý|l
不中枪=không trúng đạn|l
不中用=không dùng được/không còn dùng được|l
不中箭=không trúng tên|l
不为过=không quá đáng/không đủ|l
不买账=không thèm chịu nể mặt mũi|l
不予置评=không bình luận|l
不二法门=không có con đường thứ hai/phương pháp duy nhất/cách giải quyết độc nhất vô nhị/phương pháp tốt nhất/chỉ một con đường/con đường duy nhất|l
不亦宜乎=bất diệc nghi hồ/chẳng cũng nên ư !|l
不人道=vô nhân đạo/không nhân đạo/bất nhân/mất đi bản năng làm người|l
不今不古=bất cổ bất kim|l
不介意=không ngại/không để ý/không để tâm/không chú ý|l
不传之术=bất truyền chi thuật|l
不作兴=không cho phép|l
不作官=không làm quan|l
不作数=không giữ lời/không tính/không đếm|l
不值一提=không đáng giá nhắc tới/không đáng nhắc tới|l
不值一钱=rẻ mạt/không đáng một đồng|l
不像样=không ra dáng|l
不像话=không tưởng nổi/kỳ cục/vô lý/không hợp lý/kỳ quái/tệ quá/không thể tưởng tượng nổi/hư không tưởng nổi|l
不全是=không hoàn toàn là|l
不关好=không đóng kỹ|l
不冷不热=lãnh đạm/không nóng không lạnh/ôn hoà/thờ ơ|l
不出府=không ra ngoài phủ|l
不分上下=bất phân cao thấp|l
不分彼此=không phân khác biệt/tuy hai mà một/không phân biệt bên nọ với bên kia/bất phân bỉ thử/chẳng phân biệt được đấy với đây|l
不分胜负=bất phân thắng bại/bất phân thắng phụ|l
不分说=không phân trần|l
不分青红皂白=không phân tốt xấu/vơ đũa cả nắm/không phân biệt trắng đen gì cả|l
不切实际=không thực tế/không thiết thực|l
不划算=không có lời/nó không đáng|l
不动产=bất động sản/tài sản/của cải/tài sản cố định|l
不动关=bất động quan|l
不动换=không hoạt động|l
不动问=không xin hỏi|l
不单单是=không đơn thuần là|l
不变性=không biến tính|l
不可不=phải có|l
不可企及=không thể đuổi kịp|l
不可估量=không thể đo lường/vô số/vô hạn/mênh mông/không thể lường được/không thể đo đếm|l
不可向迩=không thể tiếp cận/không thể đến gần được|l
不可多得=hiếm có/ít có/hiếm|l
不可或缺=không thể thiếu|l
不可抗力=không thể đối kháng/trường hợp bất khả kháng/sức không thể chống/không gì ngăn nổi|l
不可数=không thể đếm|l
不可胜数=không thể đếm/đếm không xuể/không đếm xuể/nhiều vô số|l
不可避免=không thể tránh né/không thể tránh khỏi|l
不可限量=bất khả hạn lượng/bất khả hạn lượng (*)/không thể đo lường|l
不吃不喝=không ăn không uống|l
不合情理=không hợp tình lý|l
不合算=không có lợi|l
不同之处=chỗ khác biệt/chỗ bất đồng|l
不同凡响=không tầm thường/không giống bình thường/phi phàm/phi thường/xuất sắc/nổi bật/đáng chú ý/nổi tiếng/không tầm thường|l
不名一钱=nghèo không một đồng/nghèo rớt mồng tơi/không một xu dính túi|l
不名誉=mất danh dự/mất thể diện/không tốt đẹp đẽ gì|l
不听话=không nghe lời|l
不吭=không lên tiếng|l
不吵不闹=không cãi cọ không ồn ào/không ồn ào|l
不周到=không chu đáo|l
不和睦=không hòa thuận|l
不咸不淡=không mặn không nhạt/đều đều/không mặn không lạt|l
不回府=không hồi phủ|l
不回话=không đáp lời|l
不因不由=vô duyên vô cớ|l
不在少数=không phải số ít/số lượng cũng không ít|l
不在此列=không ở trong đám này/không ở nhóm này/không nằm trong số này|l
不在话下=không đáng kể/không nói chơi/khỏi phải nói/xem thường/chuyện nhỏ nhặt/chuyện đương nhiên/không thành vấn đề/không nói ở đây/là điều chắc chắn|l
不声不响=vô thanh vô tức/âm thầm|l
不复存在=không còn tồn tại/không còn tồn tại nữa|l
不外乎=không có gì hơn/không ngoài|l
不多不少=không nhiều không ít|l
不多喝=không uống nhiều|l
不多见=không thấy nhiều/không thường thấy|l
不多说=không nói nhiều|l
不多问=không hỏi nhiều|l
不够意思=không có suy nghĩ|l
不够格=không đủ tư cách/không đủ phân lượng|l
不够看=không đáng chú ý|l
不大一样=không giống nhau lắm|l
不大不小=không lớn không nhỏ|l
不大到=không thường đến/không lớn đến|l
不大好=không được tốt|l
不大懂=không hiểu lắm|l
不大放=không toả sáng|l
不大用=không tác dụng lớn|l
不好战=không hiếu chiến|l
不好过=không dễ chịu|l
不如意事常八九=việc không như ý thường xảy ra nhiều/không bằng ý sự thường bát cửu|l
不如说=không bằng nói|l
不孝之子=con bất hiếu|l
不孝子=đứa con bất hiếu/con bất hiếu|l
不学无术=bất học vô thuật/không học vấn không nghề nghiệp/dốt nát/kém cỏi/vô học/học chả hay, cày chả biết/viết không hay, nắm cày không thạo/bất tài/văn dốt vũ dát|l
不学白不学=bất học thì uổng phí|l
不守信用=không giữ lời hứa|l
不安于位=không an phận/không an toàn tại chỗ|l
不定式=không hình thái|l
不实之处=chỗ không thật|l
不宣而战=không tuyên mà chiến/tấn công bất thình lình/chiến tranh không tuyên chiến|l
不容乐观=không thể lạc quan/không cần lạc quan|l
不容分说=không cho giải thích/khỏi bày giải/khỏi giải thích/không giải thích|l
不容小视=không thể coi thường|l
不容忽视=không thể bỏ qua|l
不对么=không đúng a|l
不对劲=không thích hợp/không hợp lý/không đúng/không hợp/không vừa ý/chẳng phù hợp/không tâm đầu ý hợp/bất thường/không bình thường/khó chịu/không ý hợp tâm đầu/có cái gì không đúng|l
不对味=không đúng vị|l
不对头=bất thường/không đối đầu/không đúng/không thích hợp/có vấn đề/không đúng lắm|l
不对的=không đúng|l
不寻上=không tìm tới|l
不就象=không liền như|l
不差什么=chẳng thiếu gì/đủ cả/xấp xỉ/gần giống nhau/hầu hết/hầu như/bình thường/thông thường|l
不干不净=không sạch sẽ/bẩn thỉu/dơ dáy/ô trọc/thô tục|l
不干么=không làm chi|l
不开本=không khổ sách|l
不当人子=bất đương nhân tử|l
不当得利=giàu có bất công|l
不待说=không cần nói|l
不得了=quá ghê gớm/thật/ghê gớm/nguy/tột bực/cực kỳ khủng khiếp/khủng khiếp/thậm tệ/quá/quá sức/cực kỳ/quá chừng/vượt trội/vô cùng/cùng cực/cực độ/không được/bó tay rồi/tuyệt vời|l
不得有误=không được sai sót/không được sai lầm|l
不得要领=không bắt được trọng điểm/chưa nắm được mấu chốt/chưa nắm được cái chính|l
不必要=không tất yếu/không cần thiết|l
不忍心=không đành lòng|l
不忘本=không quên gốc/không vong bản|l
不快不慢=không nhanh không chậm|l
不怎么=không thế nào/không thể nào|l
不怎么样=chẳng ra sao cả/chẳng thế nào cả|l
不怕死=không sợ chết|l
不思进取=không muốn phát triển/không biết tiến thủ|l
不急之务=việc không gấp|l
不愁吃=không lo ăn|l
不感兴趣=không có hứng thú|l
不懂事=không hiểu chuyện|l
不懂装懂=ra vẻ hiểu biết|l
不成人=người tàn tật/người khuyết tật/phế nhân|l
不成体统=không ra thể thống gì|l
不成器=không nên thân/không ra hồn/bất thành khí/vô dụng|l
不成形=không thành hình|l
不成才=không thành tài|l
不成文法=luật rừng/luật bất thành văn|l
不成方圆=không thành phương viên|l
不成气候=không có thành tựu/không được việc gì|l
不成话=không ra gì|l
不成问题=không thành vấn đề|l
不战而退=không đánh mà lui|l
不打紧=không quan trọng/không hề gì/không quan hệ/không sao/không can hệ|l
不拉下=không kéo xuống|l
不拉几=bất lạp kỷ|l
不摆上=không mang lên|l
不放过=không bỏ qua/không buông tha|l
不敢后人=không chịu thua kém/không dám hậu thế|l
不敢当=không dám nhận/không dám làm|l
不敢越雷池一步=không dám vượt qua giới hạn|l
不断改进=sửa đổi không ngừng|l
不无关系=không thiếu quan hệ|l
不时之需=bất cứ tình huống nào/khi cần đến/lúc bất thường|l
不明不白=không minh bạch/không hiểu|l
不明说=không nói rõ|l
不明飞行物=bất minh phi hành vật|l
不是味儿=không phải khẩu vị/không đúng điệu/không đúng cách/không đúng mùi vị/không hợp/bất thường/khác thường/lạ lùng/kỳ quặc/kỳ lạ/khó chịu/chịu không nổi/bối rối/lo lắng|l
不服气=không phục/ấm ức/không chịu|l
不服输=không chịu thua|l
不期然=bất ngờ|l
不期而会=không hẹn mà gặp/tình cờ gặp|l
不期而然=nào ngờ/bất ngờ|l
不期而至=bất ngờ tới|l
不期而遇=không hẹn mà gặp/tình cờ gặp/tình cờ tìm thấy|l
不来电=không điện báo|l
不止一次=không chỉ một lần|l
不死之术=bất tử chi thuật|l
不比来=không gần đây|l
不治之伤=thương thế không thể chữa khỏi|l
不治之症=bệnh bất trị/bệnh nan y/tai hoạ khó dứt/tệ nạn khó trừ|l
不治好=không chữa khỏi|l
不法分子=phần tử ngoài vòng luật pháp/phần tử bất hợp pháp|l
不消说=khỏi cần nói|l
不清不楚=thật không minh bạch/thật không hiểu/không minh bạch|l
不清不白=không thanh không bạch/bất thanh bất bạch|l
不渝=không đổi/bất thay đổi/không thay đổi|l
不温不火=không nóng không lạnh/bất ôn bất hỏa|l
不灵敏=không nhạy bén|l
不然的话=nếu không/nói cách khác|l
不熄不灭=bất tức bất diệt|l
不甘示弱=không cam lòng yếu thế/không chịu yếu thế/không chịu thua kém|l
不甚了了=không rõ lắm/chẳng rõ ràng/không còn nữa|l
不甚了解=không hiểu nhiều lắm|l
不用说=không cần phải nói|l
不由分说=không nói lời gì|l
不男不女=bất nam bất nữ|l
不留心=không lưu tâm/không lưu ý|l
不留情面=không nể mặt mũi/không nể mặt|l
不疾不徐=không nhanh không chậm|l
不登大雅之堂=không lịch sự/tao nhã/không thể bày ra/không thể phô ra/không thể trình ra/tục tằn|l
不盈一握=không đủ một nắm|l
不相干=không liên quan/không thể làm chung/chẳng dính dáng/không liên hệ nhau/không liên hệ|l
不看僧面看佛面=không nể mặt sư thì cũng nể mặt phật|l
不眠不休=không ngủ không nghỉ|l
不眠之夜=đêm không ngủ|l
不着家=không có nhà|l
不着寸褛=không tấc mảnh vải|l
不着痕迹=không để lại dấu vết|l
不着边际=nói chuyện không đâu/nói tràng giang đại hải/nói tràn cung mây/nói không đâu vào đâu/nói trên trời dưới biển/nói chuyện đẩu đâu/không thiết thực/viển vông/một tấc tới trời/lạc đề quá xa|l
不着陆=không chạm đất|l
不瞒你说=không nói gạt ngươi|l
不知世务=không biết thời thế|l
不知就里=không biết nội tình/không hiểu nội tình/không biết là trong/ngây thơ|l
不知所谓=không biết mùi vị|l
不知进取=không biết tiến thủ|l
不知进退=không biết tiến thối/không chừng mực/vô chừng mực/không biết tiến lùi|l
不禁不由=bất giác/không tự chủ được|l
不等上=không chờ thêm|l
不等分=không chia đều|l
不等式=bất đẳng thức/không công bằng|l
不等量=không ngang nhau|l
不算什么=không tính là gì/không coi vào đâu|l
不管三七二十一=bất chấp tất cả/không cần biết đúng sai/không xét xanh đỏ đen trắng/không xét phải trái đúng sai/bất cần tất cả/bất cần mọi thứ/chẳng xét đúng sai ngọn ngành|l
不管不顾=không quan tâm/không chăm sóc/không trông nom/chẳng ngó ngàng gì tới/mang con bỏ chợ/liều lĩnh/liều mạng/xông bừa|l
不管怎么=bất kể thế nào|l
不管部长=bộ trưởng không bộ|l
不紧不慢=không nhanh không chậm|l
不经一事=đi một ngày đàng học một sàng khôn|l
不经意=lơ đãng/vô ý/không chú ý/thiếu thận trọng/cẩu thả/không để ý/không lưu tâm|l
不结盟=không kết minh/phi liên kết/không liên kết|l
不美观=không mỹ quan|l
不老少=không già trẻ|l
不耻下问=không ngại học hỏi kẻ dưới/phóng khoáng/khiêm tốn/không ngại học hỏi người dưới, kẻ kém cỏi hơn mình|l
不胜任=không đảm nhiệm được|l
不胜其扰=chịu không nổi phiền phức|l
不胜感激=cảm kích khôn cùng|l
不能不要=không thể không cần/không thể không muốn|l
不能容忍=không thể chịu đựng|l
不自量=không tự lượng/không lượng sức mình/tự đánh giá mình quá cao/lấy thúng úp voi|l
不自量力=không biết tự lượng sức mình/tự đánh giá mình quá cao/lấy thúng úp voi/cầm gậy chọc trời|l
不良分子=phần tử bất lương|l
不良少年=thiếu niên bất lương|l
不良影响=ảnh hưởng xấu|l
不花用=không chi dùng|l
不药而愈=không thuốc mà khỏi|l
不衫不履=lôi thôi lếch thếch/Chẳng áo chẳng giầy, ý nói quần áo không ngay ngắn chỉnh tề, mà còn lôi thôi xốc xếch.|l
不装鬼=không giả quỷ|l
不要命=không muốn sống/không muốn mạng|l
不要紧=không sao/đừng lo/không sao cả/không hề gì/không việc gì/chẳng sao đâu/không cần gấp gáp/không quan trọng lắm|l
不要脸=không muốn mặt/không biết xấu hổ|l
不见棺材不掉泪=chưa thấy quan tài chưa đổ lệ|l
不见经传=điều chưa biết/không có trong sách vở/lạ/chưa từng có ai biết đến/lý luận không căn cứ/nhân vật không tiếng tăm|l
不规矩=không quy củ/hạnh kiểm xấu/ăn ở xấu/cách cư xử xấu|l
不言之教=dĩ đức giáo dân|l
不认账=không nhận nợ/không nhận trướng/quỵt/quỵt nợ/vỡ nợ/chối/không giữ lời hứa/không thừa nhận ghi chép/không công nhận|l
不记前仇=không nhớ thù xưa|l
不讲情面=không nể tình|l
不讲理=không nói đạo lý|l
不讲道理=không nói đạo lý/không hợp lý|l
不论什么=bất luận cái gì|l
不识之无=chẳng biết i tờ/không biết chữ|l
不识大体=không biết đại cục/không làm/thấy được việc lớn|l
不识时务=không biết thời thế/không thức thời vụ/không biết thời vụ|l
不谙世事=không rành thế sự|l
不象样=không ra dáng|l
不象话=không ra cái gì|l
不负众望=không phụ sự mong đợi của mọi người|l
不负责任=không chịu trách nhiệm|l
不负重望=không phụ kỳ vọng|l
不费吹灰之力=không cần tốn nhiều sức/dễ dàng chóng vánh/dễ như bỡn/chẳng tốn công/chẳng tốn hơi sức nào/dễ như trở bàn tay/không phí nhiều sức/dễ như ăn bánh|l
不起作用=không có tác dụng|l
不起浪=không dậy sóng|l
不起眼=không đáng chú ý/không ngờ tới/không chớp mắt/tầm thường/không ngờ|l
不起眼儿=không thu hút/hấp dẫn/xoàng/xoàng xĩnh/không hấp dẫn/không đáng để mắt tới/không đáng coi trọng|l
不躲不避=không trốn không né|l
不过关=không quá quan/không có khả quan|l
不进则退=không tiến tắc thối/không tiến tất thối/không tiến ắt lùi|l
不进反退=không tiến ngược lại thụt lùi|l
不逊于=không kém hơn/không hơn|l
不遗余力=tận hết sức lực/dốc hết sức/dồn tâm trí/đem hết sức mình|l
不避不闪=không né tránh|l
不避艰险=không ngại gian nguy|l
不闪不避=không tránh không né|l
不问青红皂白=không biết phải quấy/không hỏi bừa bãi/không phân biệt đỏ xanh hay đen trắng|l
不闻不问=chẳng quan tâm/chẳng hỏi han/thờ ơ lãnh đạm/không dòm ngó tới/bỏ con giữa chợ|l
不阴不阳=bất âm bất dương/không âm không dương|l
不降反升=không giảm ngược lại tăng|l
不随意肌=cơ nhẵn/cơ trơn|l
不露痕迹=không lộ ra dấu vết|l
不领情=không lĩnh tình/không cảm kích|l
不食子=không ăn thịt con|l
不鸣则已=không lên tiếng thì thôi/không biết thì thôi|l
与世隔绝=ngăn cách với đời/ngăn cách/đoạn tuyệt - với nhân thế/hoàn toàn tách biệt với thế gian|l
与你何干=có liên quan gì tới ngươi|l
与你同在=ở cùng với ngươi|l
与时俱进=rất nhanh thức thời|l
与此有关=có liên quan với đó|l
与民争利=cùng dân tranh lợi/tranh giành lợi ích với người dân|l
与生俱来=bẩm sinh/từ lúc sinh ra đã mang theo|l
专款专用=tiền nào việc ấy|l
专科学校=trường dạy nghề/trường chuyên khoa|l
专美于前=giành mất danh tiếng|l
且不说=không nói đến/lại không nói|l
且慢=chậm đã/khoan đã/hãy khoan|l
且战且退=vừa đánh vừa lui|l
世态炎凉=thói đời nóng lạnh/lòng người dễ thay đổi|l
世界各地=các nơi trên thế giới|l
世界末日=tận thế/ngày tận thế/thế giới tận thế|l
世风日下=thế phong nhật hạ|l
东扯西拉=đông xả tây kéo|l
东扯西拽=vướng mắc với nhau|l
东拉西扯=nói nhăng nói cuội/đông lạp tây xả/đánh trống lảng/kéo lê qua lại|l
东方不败=Đông Phương Bất Bại|l
东看西看=nhìn đông nhìn tây|l
东碰西撞=chạy tán loạn/đụng đông đụng tây|l
东窜西跳=nhảy đi nhảy lại|l
东躲西藏=trốn đông trốn tây/trốn đông núp tây/đông đóa tây tàng/trốn đằng đông nấp đằng tây|l
东躲西跑=cực kỳ sợ hãi|l
东食西宿=đông thực tây túc|l
丝毫不差=không kém chút nào|l
丝毫无损=không hư hao chút nào|l
丝绸之路=con đường tơ lụa|l
丝绸面料=chất liệu tơ lụa/vải lụa|l
丢下去=ném xuống|l
丢人现眼=mất mặt xấu hổ/mất mặt/mất thể diện|l
丢到家=ném về tận nhà|l
丢眼色=nháy mắt/đưa mắt ra hiệu/đưa mắt|l
丢面子=mất mặt/bẽ mặt/xấu mặt/mất thể diện|l
丢饭碗=mất chén cơm|l
两亿人=hai trăm triệu người|l
两句话=hai câu nói/hai câu|l
两回事=hai việc khác nhau|l
两性关系=lưỡng tính quan hệ/quan hệ giới tính|l
两性生殖=sinh sản hữu tính|l
两条路线=hai con đường|l
两条道路=hai con đường|l
两栖动物=động vật lưỡng thê|l
两男一女=hai nam một nữ|l
两男两女=hai nam hai nữ/hai trai hai gái|l
两者之间=giữa hai bên/giữa hai cái/giữa hai người|l
两肋插刀=không tiếc mạng sống/giúp bạn không tiếc cả mạng sống/hai sườn bị đao đâm|l
两袖清风=liêm khiết thanh bạch/thanh liêm/liêm khiết/thanh bạch/thanh liêm (*tay áo đón gió)|l
严格来说=nghiêm chỉnh mà nói|l
严格要求=yêu cầu nghiêm khắc|l
严格说来=nghiêm chỉnh mà nói|l
严词拒绝=từ chối thẳng thắn|l
丧气话=ủ rủ/nói chuyện mất tinh thần|l
个人所得税=thuế thu nhập cá nhân|l
个人档案=hồ sơ cá nhân|l
个人见解=cá nhân kiến giải|l
个人隐私=cá nhân tư ẩn|l
中不溜儿=loại vừa/cỡ vừa/trung bình|l
中到大雪=tuyết vừa đến dày|l
中年男人=trung niên nam nhân/người đàn ông trung niên|l
中年男子=nam tử trung niên/trung niên nam tử/người đàn ông trung niên|l
中枢神经=trung khu thần kinh|l
中等偏上=đã trên trung đẳng|l
中等教育=giáo dục trung cấp|l
中篇小说=tiểu thuyết vừa/truyện vừa|l
中规中矩=trung quy trung củ/đúng quy đúng củ|l
丰功伟业=phong công vĩ nghiệp|l
临战状态=trạng thái lâm chiến/trạng thái chuẩn bị chiến đấu|l
临时演员=diễn viên tạm thời|l
临渊羡鱼=đến vực thèm cá/có nguyện vọng nhưng không thực hiện được/nhìn mà thèm thuồng|l
临阵磨枪=lâm trận mới mài gươm/nước đến chân mới nhảy|l
为之一振=vì đó rung một cái|l
为之动容=vì đó động dung/trở nên động dung|l
为人处世=cách đối nhân xử thế/đối nhân xử thế|l
为人处事=xử sự làm người|l
为人师表=làm gương sáng cho người khác/vi nhân sư biểu|l
为今之计=vì kế hoạch hôm nay/kế trước mắt|l
为国为民=vì nước vì dân/vì dân vì nước|l
为国而战=chiến đấu cho đất nước/chiến đấu vì đất nước|l
为我所用=làm việc cho ta|l
为时尚早=còn sớm|l
为时已晚=thì đã trễ/lúc này đã muộn|l
为时过早=hơi sớm|l
为期不远=cách không xa|l
为民造福=tạo phúc cho dân|l
为民除害=vì dân trừ hại|l
举例来说=chẳng hạn như|l
举全教之力=dùng sức lực toàn giáo phái|l
举国之力=cử quốc chi lực|l
举教之力=sức lực toàn giáo phái|l
举步维艰=cất bước khó khăn|l
举起手来=giơ tay lên|l
久治不愈=ở lâu không dứt|l
久病成医=bệnh lâu thành thầy thuốc/bệnh lâu dài thành y học/bệnh lâu khỏi khiến bệnh nhân thành bác sĩ|l
久经沙场=kinh nghiệm sa trường|l
久负盛名=nổi tiếng lâu đời|l
义体化=cyborg hoá|l
义务教育=giáo dục bắt buộc/giáo dục phổ cập|l
义形于色=nghiêm nét mặt|l
义成=Nghĩa Thành|l
乍一看=chợt nhìn/mới nhìn|l
乍听=chợt nghe|l
乍暖还寒=chợt ấm chợt lạnh/chợt nóng chợt lạnh/thoạt ấm còn lạnh|l
乍然=đột nhiên|l
乍现=chợt hiện/hiện ra|l
乍看之下=chợt nhìn lại|l
乍看来=mới xem/thoạt đầu|l
乍见=liếc thấy|l
乏善可陈=muốn khen cũng chẳng có gì mà khen|l
乏术=thiếu phương pháp/hết cách/không có phương pháp/phạp thuật|l
乘兴而来=nhân hứng mà tới/thừa hứng mà đến/Nhân cao hứng mà lại.|l
乙状结肠=kết tràng chữ S|l
也不分=cũng không phân|l
也不多=cũng không nhiều|l
也不多说=cũng không nhiều lời|l
也不招=cũng không khai|l
也不晚=cũng không muộn/cũng không chậm/muộn|l
也不说=cũng không nói|l
也不迟=cũng không muộn/cũng không trễ|l
也学不来=cũng học không được|l
也就是说=nói cách khác|l
也想家=cũng nhớ nhà|l
也想问=cũng muốn hỏi|l
也要学=cũng muốn học/cũng phải học|l
也顾不=cũng không đoái hoài/cũng không cố|l
乡巴佬=nhà quê/Hai lúa/hương ba lão|l
买一送一=mua một tặng một|l
买上告下=chạy thầy chạy thợ/chạy thuốc|l
买回去=mua về/mua về|l
买回来=mua về|l
乱扣帽子=chụp mũ lung tung|l
乱说话=nói lung tung|l
争奇斗艳=ganh đua sắc đẹp/tranh kỳ đấu diễm|l
争强斗胜=tranh cường đấu thắng|l
争权夺利=tranh quyền đoạt lợi/tranh giành quyền lợi|l
事不关己=việc không liên quan đến mình/việc không liên quan tới mình|l
事不关已=sự bất quan kỷ|l
事不宜迟=việc này không nên chậm trễ|l
事不过三=quá tam ba bận|l
事关重大=can hệ trọng đại/sự quan trọng đại|l
事到临头=sự đáo lâm đầu/sự đáo lâm đầu (*)/nước đã đến chân|l
事到如今=chuyện cho tới bây giờ/chuyện đến nước này|l
事务繁多=công việc bề bộn|l
事半功倍=làm ít công to/làm chơi ăn thật/làm chơi ăn thật/làm ít mà hiệu quả nhiều|l
事后诸葛亮=mã hậu pháo/sau đó Gia Cát Lượng/một thiên tài trong việc nhìn lại/nhận thức muộn màng là 20-20|l
事在人为=sự do người làm|l
事实上=trên thực tế|l
事实真相=chân tướng sự thật|l
事已至此=việc đã đến nước này|l
事急=chuyện gấp|l
事成之后=sau khi chuyện thành công|l
事般=sự việc|l
事要忙=chuyện bận rộn|l
二一添作五=chia đồng ăn đủ/ngang nhau/đều nhau/chia đều hai bên/kẻ tám lạng, người nửa cân|l
二人转=nhị nhân chuyển/hát kiểu Nhị Nhân Chuyển/Cát kịch/hai người chuyển|l
二十八宿=nhị thập bát tú|l
二千人=hai ngàn người|l
二当家=Nhị đương gia|l
二花脸=vai thứ|l
二话不说=không nói hai lời|l
二话没说=không nói hai lời|l
云消雾散=trời quang mây tạnh/vân tiêu vụ tán|l
互不侵犯=không xâm phạm lẫn nhau|l
互不侵犯条约=hiệp ước không xâm phạm lẫn nhau|l
互不相让=không ai nhường ai|l
互帮互助=hỗ bang hỗ trợ|l
互惠互利=đôi bên cùng có lợi|l
互相关心=quan tâm lẫn/cho nhau/quan tâm lẫn nhau|l
互相合作=hợp tác lẫn nhau|l
互相帮助=giúp đỡ cho nhau/trợ giúp lẫn nhau|l
互相矛盾=mâu thuẫn lẫn nhau|l
互通有无=bù đắp nhau/bổ sung nhau|l
五一劳动节=ngày Quốc tế Lao động/ngày 1 tháng 5|l
五口之家=nhà năm người|l
五味杂陈=ngũ vị tạp trần/ngũ vị tạp trần (ngọt chua cay đắng mặn)|l
五方杂处=người tứ chiếng sống với nhau|l
五花大绑=trói gô/trói chéo tay/trói gô cổ và chéo cánh tay ra sau lưng|l
五音不全=ngũ âm chưa hoàn thiện/năm âm thanh không đầy đủ/giọng điệu điếc|l
交上来=giao lên|l
交头接耳=châu đầu ghé tai/rỉ tai thì thầm/thì thầm với nhau|l
交感神经=thần kinh giao cảm|l
交换价值=giá trị trao đổi|l
交换条件=điều kiện trao đổi|l
交浅言深=thân thiết với người quen sơ|l
交织着=đan xen/đan vào|l
交谈起来=nói chuyện với nhau/bắt đầu trò chuyện|l
交通安全=an toàn giao thông|l
交通工具=phương tiện giao thông/công cụ giao thông|l
交通系统=hệ thống giao thông|l
享乐主义=chủ nghĩa khoái lạc|l
享清福=hưởng thanh phúc/Hưởng phúc|l
亮铮铮=sáng quắc/sáng loáng|l
亲不亲=có thân hay không|l
亲力亲为=tự thân đi làm/thân lực thân vi/tự thân làm|l
亲如一家=thân như một nhà/thân thiết như một gia đình/mối quan hệ thân thiết như gia đình|l
亲如兄弟=thân như huynh đệ|l
亲朋好友=thân bằng hảo hữu|l
亲眼所见=tận mắt nhìn thấy|l
亲眼目睹=tận mắt nhìn thấy/chính mắt thấy/tận mắt nhìn|l
亲眼看到=tận mắt thấy|l
亲眼看见=tận mắt nhìn thấy|l
亲眼见到=tận mắt nhìn đến/chính mắt thấy được|l
人为因素=yếu tố con người|l
人之初=nhân chi sơ|l
人之常情=nhân chi thường tình|l
人事不知=bất tỉnh nhân sự|l
人事不醒=bất tỉnh nhân sự|l
人事关系=quan hệ nhân sự|l
人事变动=thay đổi nhân sự|l
人人平等=mọi người bình đẳng/mọi người đều bình đẳng|l
人人有责=người người đều có trách nhiệm|l
人以群分=người chia theo nhóm/nhân dĩ quần phân|l
人体实验=thí nghiệm trên người/nhân thể thực nghiệm|l
人到中年=người đã trung niên|l
人前人后=người trước người sau|l
人单势孤=người đơn thế cô|l
人口过剩=thừa dân số/tăng dân|l
人命关天=mạng người quan trọng|l
人在何处=người ở nơi nào|l
人在江湖=người trong giang hồ|l
人外有人=nhân ngoại hữu nhân/người giỏi còn có người giỏi hơn|l
人多地少=người nhiều ít đất|l
人多着=nhiều người|l
人头攒动=người người nhốn nháo|l
人字拖=dép lào|l
人寿年丰=con người khoẻ mạnh, mùa màng bội thu|l
人小鬼大=nhân tiểu quỷ đại/nhân tiểu quỷ đại (*)/người nhỏ mà ma mãnh|l
人工呼吸=hô hấp nhân tạo|l
人工成本=chi phí nhân công/chi phí lao động/Chi phí nhân công|l
人工授精=thụ tinh nhân tạo|l
人工流产=nạo thai/phá thai|l
人影憧憧=bóng người thấp thoáng|l
人心隔肚皮=lòng người khó dò|l
人性本善=nhân tính vốn thiện/bản chất con người là tốt|l
人敢来=người dám tới|l
人文环境=hoàn cảnh nhân văn|l
人无完人=chẳng ai hoàn mỹ/nhân vô hoàn nhân|l
人来疯=đứa tinh nghịch|l
人模人样=hình người dáng người|l
人浮于事=người nhiều hơn việc/người thừa việc thiếu/việc ít người nhiều|l
人烟稀少=người ở thưa thớt|l
人生在世=người sống một đời|l
人生地不熟=chưa quen cuộc sống nơi đây|l
人生如梦=nhân sinh như mộng/nhân sinh như giấc mộng|l
人神共愤=nhân thần cộng phẫn|l
人类文明=văn minh nhân loại/nền văn minh nhân loại|l
人见人爱=người gặp người thích/ai thấy cũng thích|l
人身自由=tự do thân thể|l
人造纤维=tơ nhân tạo/bông nhân tạo|l
人际关系=quan hệ nhân mạch/nhân tế quan hệ|l
仅供参考=chỉ để tham khảo|l
仅此而已=chỉ thế thôi/không hơn/vậy thôi/thế thôi/chỉ đến thế mà thôi|l
仅限于=giới hạn trong|l
从上到下=từ trên xuống dưới|l
从下到上=từ dưới lên trên|l
从下向上=từ dưới lên trên|l
从业人员=người làm|l
从今以后=từ nay về sau|l
从今天起=từ hôm nay trở đi|l
从今往后=từ nay về sau|l
从何说起=bắt đầu nói từ đâu/vì sao lại nói thế|l
从南到北=từ nam đến bắc|l
从古到今=từ cổ chí kim|l
从古至今=từ xưa đến nay|l
从外向内=từ ngoài hướng vào trong|l
从头再来=làm lại từ đầu|l
从头到脚=từ đầu đến chân|l
从始至终=từ đầu đến cuối/tòng thủy chí chung/từ đầu chí cuối/từ đầu tới cuối|l
从宽发落=nhẹ tay xử phạt/rơi từ chiều rộng|l
从小到大=từ nhỏ đến lớn|l
从左到右=từ trái đến phải/từ trái sang phải|l
从我做起=ta phải theo luật thôi|l
从早到晚=từ sáng sớm đến tối/từ sớm đến muộn/từ sớm đến tối|l
从未有过=chưa bao giờ có/chưa bao giờ từng có|l
从未见过=chưa bao giờ thấy qua/chưa từng thấy qua/chưa từng gặp|l
从此以后=từ nay về sau/từ đó về sau|l
从现在起=từ giờ trở đi|l
从生到死=từ sinh ra đến chết/từ sinh ra đến chết đi|l
从这一点=từ một điểm này|l
从那之后=từ đó về sau|l
从那以后=từ đó về sau|l
从那时起=từ đó trở đi|l
从里到外=từ trong ra ngoài|l
他乡遇故知=tha hương ngộ cố tri|l
他妈的=mẹ nhà hắn/con mẹ nó|l
他山之石=đá ở núi khác|l
付之一笑=cười bỏ qua|l
付诸一笑=gượng cười/đưa nó vào một nụ cười/đưa vào một nụ cười|l
付诸于=phó chư vu|l
付诸流水=trôi theo nước chảy|l
付诸行动=biến thành hành động|l
仙人跳=tiên nhân khiêu|l
仙客来=hoa anh thảo/cây tiên khách lai|l
代代相传=đời đời truyền lại|l
令两女=khiến hai cô gái|l
令人信服=khiến người tin phục/thuyết phục|l
令人满意=làm người vừa lòng|l
令人生厌=làm người ta sinh chán ghét|l
令人起敬=linh nhân khởi kính/khiến người nẩy lòng kính|l
令人钦佩=khiến người khâm phục|l
令他着=làm hắn|l
令字=lệnh chữ|l
令行禁止=kỷ luật nghiêm minh|l
以下犯上=lấy hạ phạm thượng/phạm thượng|l
以人为本=lấy người làm gốc/lấy con người làm trung gian/hướng về con người|l
以人为镜=lấy người làm gương/lấy con người làm gương|l
以人废言=ghét nghe/không thèm nghe/chẳng thèm nghe|l
以史为镜=lấy sử làm gương/lấy lịch sử làm gương|l
以多胜少=lấy nhiều thắng ít|l
以少胜多=lấy ít thắng nhiều|l
以工代赈=lấy thù lao thay cứu tế/lấy công tác thay thế/cung cấp công việc để xóa đói giảm nghèo|l
以次充好=dùng hàng kém thay hàng tốt/lấy hàng kém đổi đồ tốt/nạp tiền thứ cấp|l
以此类推=cứ thế mà suy ra|l
以毒攻毒=lấy độc trị độc/đạp gai lấy gai mà lể/lấy độc công độc|l
以民为本=lấy dân làm gốc/lấy người dân làm trung gian|l
以泪洗面=lấy nước mắt rửa mặt|l
以父之名=nhân danh cha/nhân danh người cha|l
以物换物=lấy vật đổi vật|l
以理服人=lấy lý phục người/để thuyết phục mọi người|l
以眼还眼=ăn miếng trả miếng/đòn lại trả đòn|l
以血洗血=lấy máu rửa máu/rửa máu bằng máu|l
以进为退=lấy tiến làm lùi/Lấy tiến làm lùi|l
以防万一=đề phòng khi bất trắc/chỉ trong trường hợp/Dự liệu/đề phòng|l
以防不测=để phòng bất trắc|l
仰人鼻息=phụ thuộc/cậy thân cậy thế/sống nhờ vào hơi thở của người khác|l
仰躺着=nằm ngửa|l
价值规律=quy luật giá trị|l
价廉物美=hàng ngon giá rẻ/hàng tốt giá rẻ/giá rẻ và đẹp/rẻ và chất lượng tốt|l
任何迹象=bất kỳ dấu hiệu gì|l
伏低做小=khom lưng hạ mình/phục thấp làm nhỏ|l
优哉游哉=thoải mái nhàn nhã/ưu tai du tai/nhàn nhã|l
优惠待遇=được ưu đãi|l
优生优育=ưu sinh ưu dục/ưu sinh ưu dục|l
优胜劣汰=khôn sống mống chết|l
会心一笑=hiểu ý mà cười một cái/sẽ mỉm cười|l
传入神经=thần kinh cảm giác|l
传达出来=truyền ra ngoài/truyền đạt ra|l
传过来=truyền tới/truyện tới|l
伤痕累累=vết thương chồng chất|l
似懂非懂=cái hiểu cái không/như hiểu mà không hiểu|l
似火=như lửa|l
似男似女=như nam như nữ/tự nam tự nữ|l
似笑非笑=giống như cười mà không phải cười/tự tiếu phi tiếu/tựa như cười mà không phải cười|l
似金非金=như kim mà không phải kim|l
低下头去=cúi đầu|l
低下头来=cúi đầu xuống|l
低买高卖=mua thấp bán cao|l
低人一等=kém một bậc/thấp hơn một bậc/kém một cấp/kém người một bậc|l
低声下气=ăn nói khép nép|l
低头搭脑=chán nản|l
低头耷脑=chán nản/ỉu xìu/tiu nghỉu|l
低姿态=thái độ khiêm nhường|l
低成本=nhẹ vốn|l
低等动物=động vật cấp thấp|l
低等植物=thực vật cấp thấp|l
低等生物=sinh vật cấp thấp|l
体力劳动=lao động chân tay|l
体态轻盈=dáng điệu uyển chuyển|l
何种地步=loại tình trạng nào/trình độ nào|l
余年前=năm nhiều hơn trước đây|l
余情未了=dư tình chưa xong/dư tình chưa hết|l
你争我夺=ngươi tranh ta đoạt/tranh giành/tranh đoạt/giành giật|l
你们好=các ngươi tốt/các ngươi khỏe/chào các ngươi|l
你信么=ngươi tin không|l
你好坏=ngươi thật là xấu/ngươi thật là hư|l
你推我让=ngươi đẩy ta nhường|l
你来我往=ngươi tới ta đi|l
使不上力=không làm được gì|l
使性子=phát cáu/cáu kỉnh/phát bực/nổi nóng|l
使用不当=sử dụng không thích đáng|l
使用指南=hướng dẫn sử dụng|l
使眼色=nháy mắt/đưa mắt ra hiệu|l
供不应求=cung không đủ cầu/cung cấp không theo kịp nhu cầu|l
供求关系=quan hệ cung cầu|l
供认不讳=thú nhận thẳng thắn/thú nhận/để thực hiện một lời thú nhận đầy đủ|l
供选择=để cho lựa chọn|l
依我来看=như ta thấy|l
依我看=theo ta thấy|l
依样画葫芦=y dạng họa hồ lô/y dạng họa hồ lô (*đồ lên vật có sẵn mà ra hình vẽ)|l
依样葫芦=rập khuôn máy móc|l
依稀记得=nhớ mang máng|l
侦探小说=tiểu thuyết trinh thám|l
侦探社=tổ trinh thám|l
便携式电脑=máy tính xách tay|l
便步走=bước thoải mái|l
俗不可耐=tục không chịu được/tục không chửi được|l
俗话说=tục ngữ nói/có câu nói|l
俗话说得好=có câu nói rất hay|l
保外就医=phóng thích|l
保存起来=bảo tồn lại|l
保留意见=giữ nguyên ý kiến|l
修辞学=tu từ học|l
倒买倒卖=buôn đi bán lại/đầu cơ tích trữ|l
倒地不起=ngã xuống đất không dậy nổi|l
倒大霉=xui xẻo/hỏng bét/gặp vận rủi lớn|l
倒插门=ở rể/gửi rể|l
倒栽葱=ngã lộn nhào/ngã bổ chửng/ngã lộn đầu xuống/đâm nhào/lộn đầu xuống/chồng cây chuối|l
倒装句=câu đảo ngược|l
候补委员=ủy viên dự bị|l
借反震之力=mượn lực phản chấn|l
借此机会=mượn cơ hội này|l
借风使船=mượn gió bẻ măng/mượn gió giăng buồm|l
值不值=có đáng giá hay không|l
值不值得=có đáng giá hay không|l
值得一提=đáng nhắc tới|l
值得注意=đáng giá chú ý|l
值日生=trực nhật sinh/sinh viên trực tiếp/quận trưởng|l
值班人员=nhân viên trực|l
假以时日=đợi một thời gian|l
假冒着=giả mạo|l
假模假式=giả mô giả dạng/mô hình giả mạo/làm bộ làm tịch|l
停止下来=dừng lại|l
健步如飞=bước đi như bay|l
健美操=thể dục thẩm mỹ|l
健身操=bài tập thể dục/aerobics|l
傲然挺立=cứng rắn đứng thẳng/ngạo nghễ đứng thẳng|l
傲睨万物=ngạo mạn không coi ai ra gì/ngạo nghễ vạn vật|l
傲骨嶙峋=cương nghị chính trực|l
傻不拉几=ngốc hết chỗ chê|l
傻了眼=mắt choáng váng|l
像模像样=ra dáng/tượng mô tượng dạng|l
僱佣=mướn|l
儿孙满堂=con cháu đầy đàn/con cháu đầy nhà|l
先回到=trước quay về|l
先来后到=tới trước tới sau/thứ tự đến trước và sau/xếp thứ tự đến trước xếp trước, đến sau xếp sau|l
光反射=phản xạ ánh sáng|l
光如镜=sáng như gương|l
光着头=sạch bóng đầu/đầu trọc|l
光着脚=chân trần|l
光膀子=cánh tay trần/quang bàng tử|l
光阴似箭=thời gian qua mau/ngày tháng thoi đưa/thời gian như bóng câu qua cửa|l
兔子不吃窝边草=thỏ không ăn cỏ gần hang|l
入木三分=ăn vào gỗ sâu ba phân/lập luận sắc sảo/bàn tán sâu sắc|l
入门级=cấp độ nhập môn|l
全反射=phản xạ toàn phần|l
全权负责=toàn quyền phụ trách|l
八字打开=mở rộng cửa|l
八字没一撇=làm không chu đáo/chưa đâu vào đâu cả/không đến nơi đến chốn/làm không cẩn thận/làm việc ẩu tả/một nhát đến tai, hai nhát đến gáy|l
八斗之才=bát đấu chi tài/người xuất chúng/nhân tài/người tài giỏi/người rất mực tài hoa|l
八方风雨=bát phương phong vũ|l
八竿子打不着=bắn đại bác cũng không tới/cực kỳ xa/không liên quan/không quen biết/không có quan hệ thân thích/quăng tám sào cũng không tới/tám sào cũng không tới/chẳng chút liên quan/đại bác bắn cũng không tới|l
公布出来=công bố ra|l
公平竞争=cạnh tranh công bằng|l
公诸于世=công khai cho mọi người đều biết/công khai cho thế giới/để thông báo với thế giới|l
公诸于众=công khai/công chư vu chúng|l
公诸同好=chia sẻ sở thích/chung vui/của chung cùng hưởng/rượu ngon mọi người cùng nhấp/tặng thứ mình yêu thích cho người cũng thích cái đó|l
共出动=cùng điều động|l
共同话题=chung chủ đề nói chuyện|l
共同语言=tiếng nói chung/hiểu nhau/ngôn ngữ chung|l
共存亡=cùng tồn vong/cùng chết sống|l
共患难=cùng chung hoạn nạn|l
共生死=chung sinh tử|l
共进退=cùng tiến thối/cùng tiến cùng lui|l
关山迢递=đường sá xa xôi|l
兴头上=cao hứng|l
其他同学=những bạn học khác|l
其利断金=kỳ lợi đoạn kim|l
具体地说=nói cụ thể|l
具体情况=tình huống cụ thể|l
具体操作=thao tác cụ thể|l
具体而微=nhỏ nhưng đầy đủ/cụ thể trong phạm vi nhỏ/có nội dung nhưng quy mô nhỏ|l
养乐多=yakult/nuôi nhạc nhiều/Yakult|l
养家糊口=nuôi sống gia đình|l
内部矛盾=nội bộ mâu thuẫn/mâu thuẫn nội bộ|l
再也不会=sẽ không còn/lại không còn|l
再也不能=cũng không còn có thể|l
再好不过=không thể tốt hơn|l
再生产=tái sản xuất|l
再生父母=tái sinh phụ mẫu/ân nhân cứu mạng/tái sinh phụ mẫu|l
再说下去=lại nói tiếp/nói thêm gì đi nữa/nói thêm gì nữa|l
再进一步=tiến thêm một bước/tái tiến một bước/tiến thêm một bước nữa|l
再造之恩=ân tái tạo/tái tạo ân ơn|l
军事体育=thể thao quân sự/thể dục quân sự|l
军事小说=tiểu thuyết quân sự|l
军事顾问=cố vấn quân sự|l
农民起义=khởi nghĩa nông dân|l
冠古绝今=quan cổ tuyệt kim|l
冠状动脉=động mạch vành|l
冠绝一时=quan tuyệt một đời|l
冥冥中=trong cõi u minh/trong chỗ u minh|l
冥冥之中=từ nơi sâu xa|l
冥渊=minh uyên|l
冥牙=Minh Nha|l
冥花=Minh Hoa|l
冥雄=Minh Hùng|l
冬日可爱=hòa nhã dễ gần|l
冲过来=xông lại|l
冷眼旁观=thờ ơ lạnh nhạt/ngoảnh mặt làm thinh|l
冷酷无情=lãnh khốc vô tình/lạnh lùng và tàn nhẫn/nhẫn tâm|l
准时到达=đến đúng giờ|l
凌绝顶=lên đỉnh cao nhất/lên tuyệt đỉnh|l
几万人=mấy vạn người|l
几何体=khối hình học/lập thể|l
几何图形=hình vẽ hình học/hình hình học|l
几何学=hình học|l
几何级数=cấp số nhân/dãy số nhân|l
几千人=mấy ngàn người|l
几句话=mấy câu/nói mấy câu/mấy câu nói|l
几年级=lớp mấy|l
几无=gần như không/không mấy|l
几时休=khi nào dừng|l
几起几落=lên xuống/thăng giáng/thịnh suy/kỷ khởi kỷ lạc/lên lên xuống xuống|l
凸凹不平=lồi lõm nhấp nhô|l
凹凸不平=gập ghềnh/lồi lõm|l
出乎意外=ngoài dự tính/thật bất ngờ/ngoài mong đợi/bất ngờ|l
出乎意料=ra ngoài ý định/xuất hồ ý liêu/bất ngờ/thình lình/gây ngạc nhiên/không ngờ/ngoài ý muốn|l
出乎预料=ngoài dự liệu/một cách không ngờ/thình lình/vượt qua|l
出乱子=sai lầm/mắc lỗi/hỏng/không chạy/gặp rắc rối/xảy ra sai sót|l
出人意料=ngoài dự liệu/ngoài dự đoán mọi người/không ngờ/bất ngờ|l
出人意表=ngoài dự liệu/xuất nhân ý biểu|l
出人预料=ngoài người ta dự liệu|l
出入境=xuất nhập cảnh|l
出圈儿=quá trớn/quá lố/quá giới hạn/vượt quá/trái với lệ thường/vượt khỏi lệ thường|l
出土文物=đồ cổ đào được|l
出声儿=lên tiếng|l
出岔子=xảy ra sự cố/xảy ra sai sót/sinh biến/phát sinh biến cố|l
出淤泥而不染=trong bùn mà chẳng hôi tanh mùi bùn/gần bùn mà chẳng hôi tanh mùi bùn/ra khỏi bùn mà không bị nhiễm bẩn/Gần bùn mà chẳng hôi tanh mùi bùn|l
出现意外=ngoài ý muốn nổi lên/ngoài ý/xuất hiện chuyện ngoài ý muốn|l
出生年月=ngày tháng năm sinh/năm sinh/Ngày tháng năm sinh|l
出真躯=ra thân thể thật|l
出神入化=xuất thần nhập hóa/tuyệt diệu/tuyệt vời/xuất sắc/cao cả/tráng lệ/nguy nga|l
出门时=lúc ra cửa/khi ra cửa|l
出风头=làm náo động/khoe khoang/khoe mẽ/chơi trội/chơi nổi/quảng cáo/rao hàng|l
分不清=không phân rõ/không nhận rõ|l
分不清楚=không phân biệt được|l
分文不值=không đáng một đồng|l
分文不取=không lấy một xu/một xu cũng không lấy/không lấy một đồng tiền|l
分文不收=không thu một xu|l
分期付款=trả góp/trả tiền phân kỳ/tiền trả phân kỳ|l
分而治之=chia để trị|l
分身无术=phân thân vô thuật|l
分进合击=bao vây tấn công|l
分隔线=đường ngăn cách|l
切下来=cắt đi|l
切中要害=đánh trúng chỗ yếu hại/đánh trúng chỗ yếu|l
切割机=máy cắt kim loại|l
切实可行=có thể thực hành|l
切实际=thiết thực|l
切骨之仇=căm thù cực độ/căm thù đến tận xương tuỷ|l
刑事诉讼=tố tụng hình sự|l
刑事责任=trách nhiệm hình sự|l
刑法学=hình pháp học/Luật Hình sự/Hình pháp học|l
初丧=sơ tang/thời kỳ mới có tang|l
初具规模=bắt đầu có quy mô/quy mô ban đầu|l
初夜权=sơ dạ quyền|l
初生之犊=nghé con mới đẻ/thanh niên dám nghĩ dám làm/nghé sơ sinh|l
初生态=trạng thái mới giải phóng/trạng thái mới sản sinh|l
初生牛犊=nghé con mới đẻ/con nghé mới sinh/nghé con mới sinh|l
初生牛犊不怕虎=nghé con mới đẻ không sợ cọp/con bê mới sinh không sợ hổ/Nghé con không biết sợ cọp|l
初相遇=mới gặp nhau/cuộc gặp gỡ đầu tiên|l
初等教育=giáo dục tiểu học/giáo dục sơ cấp|l
初级中学=trung học sơ cấp/cấp hai/trung học cơ sở|l
初级小学=tiểu học sơ cấp/cấp một/tiểu học cơ sở|l
利欲熏心=hám lợi đen lòng/vàng đỏ nhọ lòng son/tiền bạc, lợi ích làm mê muội tâm can/bị lợi ích làm mê muội|l
别具一格=có một phong cách riêng/phong cách riêng/độc đáo/phong cách đặc biệt/phong cách khác người|l
别开生面=mở ra mặt khác/hoàn toàn mới/kiểu riêng/khác thường/sáng tạo cái mới/lối riêng|l
别开蹊径=con đường riêng/phương pháp riêng/trường phái riêng|l
别忘了=đừng quên|l
别无他法=không còn cách nào khác|l
别无他物=không có vật khác/không còn vật gì khác|l
别无选择=không có lựa chọn nào khác/không còn lựa chọn nào khác|l
别有滋味=có tư vị khác|l
别有用心=có ý khác/dụng tâm kín đáo/ý đồ riêng/có dụng ý xấu/có dụng tâm xấu/có dã tâm/có dụng ý khác/có ý đồ riêng|l
别老是=đừng cứ mãi|l
别胡说=chớ nói nhảm|l
别误会=đừng hiểu lầm|l
别过来=đừng tới đây|l
别难过=đừng khổ sở|l
刮下来=tróc xuống|l
到头来=kết quả là/kết cục là/cuối cùng/rốt cuộc/quay đầu lại|l
到时候=đến lúc đó/đến thời điểm|l
到极点=tới cực điểm/đến cực điểm|l
到此一游=từng du lịch qua đây|l
到此为止=dừng ở đây/đến đây chấm dứt/chấm dứt ở đây|l
到此女=đến cô gái này|l
到此结束=đến đây là kết thúc/đến đây kết thúc|l
制造矛盾=gây mâu thuẫn|l
削发为尼=xuống tóc làm ni cô|l
削尖脑袋=vót nhọn đầu|l
削皮刀=dao lột vỏ/dao gọt vỏ|l
削职为民=tước chức làm dân|l
前俯后仰=tiền phủ hậu ngưỡng/nghiêng nghiêng ngửa ngửa|l
前十名=mười hạng đầu/mười người đứng đầu|l
前后左右=chung quanh/mọi hướng/trước sau trái phải|l
前途无亮=tiền đồ vô lượng|l
前途无量=tiền đồ vô lượng|l
剩余价值=giá trị thặng dư|l
剩我一人=còn lại một mình ta|l
功大于过=công lớn hơn tội|l
功成不居=công lao thuộc về người khác/lập công nhưng công lao không thuộc về bản thân|l
功成身退=việc thành lui thân/công thành thân lui|l
加人一等=gia nhân nhất đẳng/hơn người một bực|l
动一动=động một chút/nhúc nhích|l
动不动=hơi một tí/động bất động/động một tí/hở ra là../hở ra là|l
动之以情=lấy tình động|l
动了动=giật giật|l
动了心=động tâm|l
动刀动枪=động đao động thương|l
动力系统=hệ thống động lực|l
动来动去=nhích tới nhích lui|l
动物纤维=sợi động vật|l
动脉硬化=xơ cứng động mạch|l
动起手来=động thủ|l
动过手脚=từng giở trò|l
劫后余生=sống sót sau tai nạn|l
劳什子=đồ bỏ/đồ vứt đi|l
劳动合同=hợp đồng lao động/hợp đồng giữa người sử dụng lao động và người lao động điều chỉnh tiền lương và các điều kiện|l
劳动对象=đối tượng lao động|l
劳动强度=cường độ lao động|l
劳动改造=cải tạo lao động|l
劳动模范=chiến sĩ thi đua|l
劳动资料=tư liệu lao động|l
劳改犯=tội phạm đang bị cải tạo|l
劳改队=đội cải tạo lao động/đội cải cách lao động|l
势单力孤=thế đơn lực cô/thế đơn sức bạc|l
势单力薄=thế đơn lực bạc|l
勃然变色=đột nhiên biến sắc/tái người|l
勤俭节约=cần kiệm tiết ước/cần kiệm và tiết kiệm/siêng năng và tiết kiệm|l
勤工俭学=làm việc ngoài giờ/vừa học vừa làm|l
勿忘=chớ quên/chớ/đừng/không nên - quên|l
勿扰=chớ quấy rầy/làm phiền|l
匀速运动=chuyển động đều|l
包围起来=bao vây lại|l
包揽词讼=bao vụ kiện|l
化为灰烬=hóa thành tro bụi|l
化学分析=phân tích hoá học|l
化学反应=phản ứng hoá học/phản ứng hóa học|l
化学变化=sự thay đổi hoá học/sự biến hoá hoá học|l
化学性质=tính chất hoá học|l
化学武器=vũ khí hoá học|l
化学纤维=sợi hoá học/sợi nhân tạo|l
化学肥料=phân hoá học/phân bón hoá học|l
化成灰=hóa thành tro|l
化敌为友=hóa thù thành bạn/hóa địch thành bạn|l
化神之境=Hóa Thần Chi Cảnh|l
化腐朽为神奇=hóa mục nát thành thần kỳ|l
化身为=hóa thân thành/hóa thân làm|l
化道之力=Hóa Đạo chi lực|l
化零为整=gom thành nhóm/tập hợp thành nhóm|l
化骨绵=hóa cốt miên|l
北冥家=Bắc Minh gia|l
北回归线=chí tuyến Bắc|l
北方方言=phương ngôn phương bắc/tiếng miền bắc/thổ ngữ phương bắc|l
北方话=tiếng Bắc|l
北洋军阀=quân phiệt Bắc dương|l
十三姨=thập tam di/dì mười ba|l
十二指肠=ruột đầu/tá tràng/đoạn đầu ruột non nối với dạ dày|l
十位数=mười chữ số/mười con số|l
十八弯=mười tám ngã rẽ|l
十八般兵器=thập bát ban binh khí/mười tám món binh khí|l
十八般武艺=thập bát ban võ nghệ/các kiểu kỹ năng/các ngành nghề|l
十几人=mười mấy người|l
十几年来=mười mấy năm qua|l
十分关心=hết sức quan tâm|l
十分满意=hết sức hài lòng|l
十分高兴=hết sức cao hứng|l
十四行诗=thơ mười bốn hàng|l
十多人=hơn mười người|l
十字街头=ngã tư phố/ngã tư đường|l
十字路口=ngã tư đường/ngã tư|l
十成把握=mười thành nắm chắc/một trăm phần trăm tự tin|l
十指连心=tay đứt ruột xót/mười ngón tay liền với lòng bàn tay|l
十样锦=cây cẩm chướng/hoa cẩm chướng|l
十绝毒=thập tuyệt độc|l
十荡十决=đánh đâu thắng đó/thập đãng thập quyết|l
十足把握=hoàn toàn chắc chắn|l
千变万化=thiên biến vạn hóa/thay đổi khôn lường|l
千叮咛万嘱咐=dặn đi dặn lại|l
千层底=đế giày|l
千层浪=ngàn cơn sóng|l
千日红=cúc bách nhật/giống rau dền|l
千百年来=trăm ngàn năm qua|l
千篇一律=liên miên bất tận/nghìn bài một điệu/bài nào như bài nấy/rập theo một khuôn khổ|l
千蛾之术=Thiên Bướm Chi Thuật|l
千遍万遍=thiên biến vạn biến/ngàn lần vạn lần|l
千金难买=ngàn vàng khó mua|l
升官发财=thăng quan phát tài/để được thăng chức và đạt được sự giàu có|l
升旗仪式=lễ nâng cờ/lễ chào cờ/Lễ thượng cờ|l
升旗手=người kéo cờ|l
升结肠=ruột trên|l
半中腰=nửa đường/nửa chừng/giữa chừng/dở chừng|l
半句话=nửa câu/nửa câu nói|l
半大不小=không lớn không nhỏ|l
半山腰=giữa sườn núi|l
半工半读=vừa học vừa làm|l
半开化=bán khai|l
半开门儿=gái điếm kín/gái điếm chìm/gái gọi/đĩ lậu|l
半懂不懂=nửa hiểu nửa không|l
半数以上=nhiều hơn phân nửa|l
半机械化=nửa cơ giới hoá|l
半空中=giữa không trung/lưng chừng trời/giữa trời/không trung|l
半路上=trên nửa đường/nửa đường|l
半路出家=giữa đường xuất gia/thay đổi giữa chừng/đổi nghề giữa chừng/nửa chừng xuất gia|l
半身不遂=bán thân bất toại/bệnh liệt nửa người|l
单打一=chỉ tập trung làm một việc/kinh doanh một nghề|l
卖关子=thừa nước đục thả câu|l
卖友求荣=bán bạn cầu vinh|l
卖国求荣=bán nước cầu vinh/mại quốc cầu vinh|l
卖来卖去=bán qua bán lại|l
南回归线=đường hồi quy nam/chí tuyến nam|l
南来北往=nam lai bắc vãng/từ nam chí bắc|l
南腔北调=giọng trọ trẹ/nam xoang bắc điệu/giọng nam điệu bắc|l
博古通今=thông kim bác cổ/thông hiểu mọi việc xưa nay/học sâu biết rộng/thông xưa hiểu nay|l
占为己有=chiếm thành của mình|l
占多数=chiếm đa số|l
即使如此=ngay cả như vậy|l
即便如此=dù vậy|l
即日起=từ bây giờ|l
卷土重来=ngóc đầu trở lại/ngóc đầu/trở lại/kéo nhau trở lại/trở lại xâm lược/quyển thổ trọng lai/quay đầu trở lại|l
卷铺盖=cuốn gói|l
历久不衰=thật lâu không giảm|l
历来如此=từ xưa giờ đã như vậy|l
压下来=áp xuống tới/đè xuống|l
压在心底=dằn xuống đáy lòng|l
压抑着=đè nén|l
原因无他=bởi vì|l
原始积累=tích luỹ ban đầu/tích luỹ nguyên thuỷ/tích lũy ban đầu|l
原子反应堆=lò phản ứng nguyên tử|l
原封不动=còn nguyên/nguyên xi/y nguyên|l
原来如此=thì ra là thế/thì ra là như vậy|l
去伪存真=bỏ đi giả giữ lại thực|l
去去就来=đi một chút sẽ trở lại|l
又会有=lại sẽ có|l
又哭又闹=vừa khóc vừa gào|l
又快又好=vừa nhanh lại còn tốt/nhanh chóng và tốt|l
又惊又喜=vừa mừng vừa sợ|l
又打又骂=vừa đánh vừa mắng/chửi/vừa đánh vừa chửi|l
又有何难=lại có gì khó/thì có khó khăn gì|l
又爱又怕=vừa thương vừa sợ|l
又臭又长=vừa thối vừa dài|l
又饥又渴=vừa đói vừa khát|l
又高又大=vừa cao vừa lớn|l
又高吭=lại giọng cao|l
双管齐下=hai bút cùng vẽ/tiến hành đồng bộ|l
反反复复=lặp đi lặp lại/phản phản phục phục/liên tục nhiều lần|l
反回头=quay đầu lại|l
反清复明=phản Thanh phục Minh|l
反科学=phản khoa học|l
反老还童=cải lão hoàn đồng|l
反装甲=chống bọc thép/phản trang giáp|l
反过来说=ngược lại/mặt khác|l
反间计=kế phản gián|l
反震之力=lực phản chấn|l
反面人物=nhân vật phản diện|l
发上来=phát lên|l
发了狂=nổi cơn điên|l
发了狠话=phát ngoan thoại|l
发了疯=phát điên|l
发人深省=khiến người tỉnh ngộ|l
发令枪=súng lệnh/súng tín hiệu/phát súng lệnh|l
发传真=gửi fax|l
发出声响=phát ra tiếng vang|l
发出声音=phát ra âm thanh|l
发嗲=làm nũng/nũng nịu/làm dáng/làm đỏm|l
发声明=phát thanh minh|l
发大财=phát đại tài/giàu to|l
发奋图强=vươn lên hùng mạnh/nổ lực làm cho nước mạnh/vươn lên hùng cường|l
发如雪=tóc như tuyết|l
发家致富=phát tài|l
发展中国家=quốc gia đang phát triển/nước đang phát triển|l
发展史=lịch sử phát triển|l
发展壮大=phát triển lớn mạnh/phát triển và phát triển|l
发工资=phát tiền lương|l
发慈悲=rủ lòng thương|l
发懵=choáng váng|l
发明家=nhà phát minh/người sáng chế|l
发横财=kiếm bộn|l
发洋财=phát tài/của bất ngờ|l
发生器=máy phát|l
发生地=phát sinh|l
发生意外=xảy ra bất trắc|l
发神经=lên cơn/điên/điên lên/điên cuồng|l
发竖=tức giận vô cùng|l
发红包=phát hồng bao|l
发纵指示=xua chó săn mồi/chỉ huy/điều hành|l
发自内心=xuất phát từ nội tâm|l
发表意见=phát biểu ý kiến|l
发言人=phát ngôn viên/người phát ngôn/phát ngôn nhân|l
发言权=quyền lên tiếng/quyền phát ngôn|l
发财树=cây phát tài|l
发财梦=mộng phát tài/giấc mơ phát tài|l
发财致富=phát tài làm giàu/ăn nên làm ra/làm giàu|l
发货地=nơi giao hàng|l
发起人=người đề xuất/người phát khởi|l
发达国家=quốc gia phát đạt|l
发过来=phát tới|l
发酒疯=say khướt/say nhè/say bí tỉ/say mèm/say mềm|l
发高烧=phát sốt/lên cơn sốt/nóng sốt|l
取回来=thu hồi lại|l
受不了=chịu không được/chịu không nổi/không chịu nổi/không chịu được|l
受了伤=bị thương|l
受到牵连=bị liên lụy|l
受到重视=được coi trọng|l
受到限制=bị hạn chế|l
受得了=chịu được/chịu đựng được/Có thể chịu được|l
受气包=gặp cảnh khốn cùng/túi trút giận|l
受的了=chịu được|l
受益匪浅=được ích lợi không nhỏ|l
受苦受难=chịu khổ chịu khó/đau khổ|l
受话器=ống nghe|l
受限于=bị giới hạn|l
变了又变=thay đổi liên tục/biến đổi liên tục|l
变了样=thay đổi|l
变则通=biến tắc thông|l
变动不居=biến động bất cư|l
变化万端=thay đổi lớn|l
变化多端=biến hóa đa đoan/thay đổi thất thường/biến hoá nhiều/thay đổi như chong chóng|l
变化无常=biến đổi thất thường/biến hoá nhiều|l
变化无穷=biến hoá vô cùng/biến hóa không ngừng/thay đổi là vô tận|l
变化莫测=biến hóa khó lường/thay đổi khó lường/thay đổi liên tục/luôn thay đổi/thay đổi thất thường|l
变态反应=phản ứng dị ứng|l
变来变去=đổi tới đổi lui|l
变法儿=tìm cách/thực hiện chính sách mới/nghĩ cách khác/tìm cách khác|l
变温动物=động vật máu lạnh|l
变稀=trở nên loãng|l
口头上=trên miệng/trên đầu môi|l
口干舌燥=miệng đắng lưỡi khô|l
口沫横飞=nước miếng tung bay/văng nước miếng/nước bọt tung tóe|l
口舌之利=miệng lưỡi lợi hại|l
口齿清楚=ăn nói rõ ràng|l
古为今用=lấy xưa dùng nay/lấy xưa phục vụ nay/xưa làm nay dùng|l
古今中外=cổ kim nội ngoại/từ cổ chí kim, trong nước và ngoài nước|l
古往今来=từ xưa đến nay/từ cổ chí kim/tự cổ chí kim/xưa nay|l
古稀之年=tuổi thất tuần|l
另一家=một nhà khác|l
另想办法=nghĩ biện pháp khác|l
另辟蹊径=mở ra lối riêng/tìm con đường riêng/lánh ích hề kính|l
只字不提=không nhắc tới một lời|l
只字未提=không nói tới một chữ|l
只此一家=chỉ một nhà ấy/chỉ thử nhất gia/duy nhất thằng này|l
叮当猫=Mèo lục lạc/{Mèo lục lạc}|l
叮铃叮铃=đinh đong đinh đong|l
可丁可卯=tương đối/tạm/khá/đủ xài/liêm chính/nghiêm túc tuân thủ chế độ|l
可人儿=khả nhân nhi/ý trung nhân|l
可信度=có độ tin cậy/độ tin cậy|l
可再生=có thể tái sinh/có thể sống lại|l
可动摇=có thể lay động|l
可取之处=chỗ thích hợp|l
可可儿的=vừa lúc/kịp/ngay khi/đúng lúc/vừa khi/không sớm cũng không muộn|l
可可粉=bột ca cao|l
可可西里=Khả Khả Tây Lý/Hoh Xil hay Kekexili, khu bảo tồn thiên nhiên rộng lớn trên cao nguyên Thanh Hải-Tây Tạng 青藏高原 [Qing1 Zang4 gao1 yuan2]|l
可圈可点=biết tròn biết méo|l
可多可少=có thể nhiều có thể ít|l
可大可小=có thể lớn có thể nhỏ|l
可容下=có thể chứa được|l
可容忍=có thể tha thứ/chịu được|l
可尔必思=Calpis|l
可干不来=lại không làm được|l
可想而知=có thể nghĩ/có thể tưởng tượng được|l
可想过=có bao giờ nghĩ tới|l
可无事=có thể vô sự|l
可有可无=có cũng được mà không có cũng không sao/có cũng được không có cũng được/có cũng được mà không có cũng được|l
可歌可泣=xúc động lòng người/vui buồn lẫn lộn/khả ca khả khấp|l
可比价格=chắc giá/giá không đổi/giá cố định|l
可比性=khả năng so sánh|l
可男可女=có thể nam có thể nữ|l
可疑人物=nhân vật khả nghi|l
可看性=tính đáng xem|l
可真会=thật là biết|l
可真多=cũng thật nhiều|l
可真损=cũng thật độc|l
可真甜=thật là ngọt|l
可紧可松=có thể chặt có thể lỏng|l
可耕地=có thể canh tác|l
可虚可实=có hư có thực|l
可见一斑=có thể thấy được chút ít/có thể thấy được lốm đốm|l
可见度=tầm nhìn/tính rõ ràng/tính rõ rệt/tính minh bạch|l
可进可退=có tiến có thối|l
可逆反应=phản ứng thuận nghịch|l
号啕大哭=khóc lóc thảm thiết/kèn khóc lớn|l
叽哩咕噜=lầm nhầm/lầm thầm/thì thầm/lộc cộc/thì thầm|l
吃不上=không kịp ăn/không có gì để ăn/ăn thiếu món/hụt ăn/không ăn được/ăn không nổi|l
吃不下=ăn không vô|l
吃不了兜着走=chịu không nổi|l
吃不来=ăn không vô/không thích ăn/ăn không quen|l
吃不消=không chịu đựng nổi/ăn không tiêu/không chịu nổi/chịu không nổi/chịu không thấu|l
吃不饱=ăn không đủ no|l
吃了亏=ăn phải cái lỗ vốn/cật liễu khuy/bị thua thiệt/bị thiệt thòi|l
吃了饭=ăn cơm|l
吃人肉=ăn thịt người|l
吃力不讨好=tốn công mà không có kết quả|l
吃吃喝喝=ăn ăn uống uống/vui chơi giải trí/ăn uống tiệc tùng|l
吃吃笑=khúc khích cười|l
吃吃饭=ăn chút cơm|l
吃哑巴亏=ngậm bồ hòn/không nói nên lời/ngậm mà nghe/ngậm đắng nuốt cay|l
吃回扣=ăn hoa hồng|l
吃多大亏=bị thua thiệt nhiều|l
吃大亏=thiệt thòi lớn|l
吃大户=ăn hôi/cướp của nhà giàu/hôi của/chia thành lô/chia thành phần/cướp của nhà giàu|l
吃大锅饭=ăn chung nồi/khoán trắng|l
吃好饭=ăn xong cơm|l
吃完饭=cơm nước xong xuôi/cơm nước xong|l
吃官司=bị kiện/dính líu đến pháp luật|l
吃小灶=chăm sóc đặc biệt|l
吃尽苦头=chịu nhiều đau khổ|l
吃干饭=bất tài/ăn cơm khô|l
吃得下=ăn được/nuốt trôi|l
吃得来=ăn được/quen ăn/ăn vô|l
吃得消=chịu nổi/chịu đựng được|l
吃得饱=ăn đủ no|l
吃拿卡要=ăn hối lộ/cật nã tạp yếu|l
吃斋念佛=ăn chay niệm Phật|l
吃晚饭=ăn cơm chiều/ăn cơm tối|l
吃暴亏=bị thiệt thòi|l
吃火锅=ăn lẩu/cú cản bóng/cú chặn bóng/chặn bóng|l
吃现成饭=ăn sẵn/hưởng thành quả lao động của người khác/ngồi mát ăn bát vàng|l
吃瓦片儿=ăn mảnh ngói/sống nhờ cho thuê nhà|l
吃白饭=ăn không ngồi rồi/ăn cơm trắng|l
吃老本=sống bằng tiền dành dụm/sống nhờ thế lực cũ/sống nhờ thành tích trong quá khứ|l
吃苦头=chịu đau khổ/chịu khổ|l
吃豆腐=ăn đậu hũ/sỗ sàng/giễu/chọc/ghẹo/viếng tang|l
吃败仗=bị đánh bại|l
吃起醋来=ghen|l
吃软饭=ăn bám/ăn cơm bao/ăn cơm bao (trai bao)/bám váy đàn bà|l
吃过亏=thua thiệt qua/đã bị thua thiệt/bị thua thiệt/bị thiệt thòi|l
吃过饭=ăn cơm xong|l
吃里爬外=chân ngoài dài hơn chân trong/ăn bên trong, leo ra ngoài/ăn lương ở một nơi lại ngầm đi làm cho nơi khác/cật lý ba ngoại/ăn cây táo rào cây sung|l
吃错药=uống nhầm thuốc|l
吃闲饭=ăn không ngồi rồi|l
吃零嘴=ăn quà vặt/ăn vặt|l
吃饭时间=thời gian ăn cơm|l
吃饭问题=vấn đề ăn cơm|l
吃香喝辣=ăn ngon uống sướng/cật hương hát lạt/ăn ngon mặc đẹp|l
各不相同=không giống nhau|l
各不相让=không ai nhường ai|l
各个击破=tiêu diệt từng bộ phận/đập tan từng cái|l
各凭本事=đều bằng bản sự/bằng bản lãnh của mình|l
各取所需=theo như nhu cầu/cần thiết của mình/theo như nhu cầu mỗi bên|l
各回各院=đều về các viện|l
各奔前程=đều có tương lai riêng/đường ai nấy đi/mỗi người một ngả|l
各就各位=ai vào chỗ nấy/mỗi người đều có vị trí và cương vị riêng/mỗi người vào vị trí của mình/các tựu các vị|l
各展=cùng thi triển/cùng dùng|l
各式各样=đủ loại kiểu dáng/đủ kiểu/đủ loại/đủ kiểu đủ loại|l
各形各色=các hình các sắc|l
各忙各=mỗi người làm việc riêng|l
各怀鬼胎=mỗi người đều có mục đích riêng/từng người mang ý xấu riêng|l
各教=các giáo|l
各显神通=các hiển thần thông|l
各有所好=mỗi người mỗi sở thích|l
各界人士=người của mọi tầng lớp|l
各种各样=đủ loại/đủ kiểu/khác nhau/mọi loại|l
各色人等=các loại người|l
各色各样=đủ loại màu sắc hình dạng|l
各行其是=mạnh ai nấy làm/làm theo điều mình cho là đúng/người nào làm theo ý người ấy|l
各行各业=các ngành các nghề/mọi ngành mọi nghề|l
各街道=mỗi con phố/tất cả các đường phố|l
各负其责=trách nhiệm của mình|l
各过各的=ai làm chuyện người ấy|l
各领风骚=tất cả tỏa sáng|l
吆五喝六=la lối om sòm|l
合上眼=nhắm mắt lại|l
合不拢嘴=không ngậm miệng được/cười toe tóe/hợp bất long chủy/không ngậm mồm vào được|l
合不拢腿=khép không được chân|l
合为一体=hợp làm một thể|l
合久必分=hợp lâu tất phân|l
合乎情理=hợp tình lý|l
合二为一=hợp hai làm một|l
合作社=hợp tác xã|l
合家欢=ảnh gia đình/hình gia đình/ảnh cả gia đình/ảnh cả nhà|l
合成纤维=sợi nhân tạo/sợi tổng hợp|l
合纵连横=hợp tung liên hoành|l
合而为一=hợp lại làm một|l
吊儿郎当=cà lơ phất phơ/linh tinh lang tang/ba lăng nhăng|l
吊膀子=chọc ghẹo/trêu chọc/chòng ghẹo|l
吊起来=treo lên/treo ngược lên|l
同人小说=đồng nhân tiểu thuyết/tiểu thuyết đồng nhân|l
同工同酬=cùng làm cùng hưởng/làm cùng một việc, hưởng lương ngang nhau|l
同态复仇=trả thù đồng đẳng|l
同时在线=cùng online|l
名利双收=được cả danh và lợi|l
名噪一时=tên nổi như cồn|l
名声不好=thanh danh không tốt/thanh danh bất hảo|l
名存实亡=chỉ còn trên danh nghĩa/danh nghĩa/tồn tại trên danh nghĩa/danh nghĩa thì còn, thực tế đã mất/danh tồn thật vong|l
后辈小子=hậu bối tiểu tử|l
君临天下=quân lâm thiên hạ|l
君主专制=quân chủ chuyên chế|l
君子一言=quân tử nhất ngôn/quân tử nhứt ngôn|l
君子之交=quân tử chi giao|l
君莫问=Quân Mạc Vấn|l
含糊不清=mơ hồ không rõ/mập mờ không rõ|l
启动资金=tài chính khởi động|l
启蒙运动=phong trào Khải Mông/phong trào tuyên truyền giáo dục|l
吸引住=hấp dẫn lấy|l
吸风饮露=hít gió uống sương/hít vào sương uống|l
吹冷风=nói mát/châm chọc|l
吾兄=huynh của ta|l
告一段落=có một kết thúc|l
告状信=thư tố cáo|l
告老还乡=cáo lão hồi hương/cáo lão về quê|l
呐喊声=tiếng hò hét/tiếng reo hò|l
呜呜=ô ô/boo hoo|l
呜呜咽咽=nghẹn ngào|l
呜呜声=tiếng ô ô|l
呜呼哀哉=ô hô ai tai/ô hô thương thay/đi đời nhà ma|l
周围环境=cảnh vật chung quanh/hoàn cảnh chung quanh|l
周围神经=thần kinh ngoại biên|l
呼之不应=hô mà không ai đáp|l
呼吸器=bình ô xy|l
呼吸困难=hô hấp khó khăn/sự khó thở/khó thở|l
呼吸相通=ý nghĩ như nhau/lợi hại tương quan/cùng hội cùng thuyền/đồng hội đồng thuyền|l
呼吸系统=hệ hô hấp|l
呼吸道=đường hô hấp|l
呼呼大睡=nằm ngáy o o/ngủ say như chết|l
呼来喝去=đến kêu đi hét/luôn quát bảo/hô tới quát lui|l
命不由己=mệnh bất do kỷ|l
命中注定=mệnh trung chú định|l
咆哮地=gầm thét|l
咆哮声=tiếng gầm gừ|l
咆哮如雷=gào thét như sấm|l
咆哮起来=gầm hét lên|l
和好如初=hòa hảo như lúc ban đầu|l
和气生财=hòa khí sinh tài/hòa khí sinh tài/hoà thuận thì phát tài|l
和谐社会=xã hội hài hòa/một xã hội hài hòa|l
咫尺之遥=chỉ cách một chút|l
咬住不放=cắn không buông|l
咬字儿=đọc rõ từng chữ|l
咬文嚼字=nghiền ngẫm từng chữ một/tỉa tót câu chữ/giảo văn tước tự|l
咬着牙=cắn răng|l
咬紧牙=cắn chặt răng|l
咬紧牙关=cắn chặt răng/cắn chặt hàm răng/cắn chặt hàm răng|l
咬起来=cắn|l
哈哈大笑=cười ha ha|l
哈的一笑=cười ha ha một tiếng|l
哈着白气=thở ra khói trắng|l
哈着腰=xoay người|l
哪句=câu nào|l
哪够=sao đủ/câu nào|l
哪敢=nào dám|l
哪有什么=nào có cái gì|l
哪里话=chuyện này|l
哪门子=cái gì/gì|l
哭丧着脸=vẻ mặt cầu xin/buồn rười rượi/như đưa đám/vẻ mặt đưa đám|l
哭笑不得=dở khóc dở cười/nửa cười nửa mếu|l
唇红齿白=môi hồng răng trắng/xinh đẹp/đẹp đẽ/môi đỏ răng trắng|l
售后服务=phục vụ hậu mãi|l
售尽=bán hết sạch|l
售票处=chỗ bán vé/nơi bán vé/quầy vé|l
售货员=người bán hàng/nhân viên bán hàng|l
唯今之计=kế sách hiện thời|l
唯利是图=hám lợi/lợi ích tối thượng|l
唯名论=duy danh luận/thuyết duy danh/chủ nghĩa duy danh|l
唯唯=vâng vâng/dạ dạ|l
唯唯诺诺=khúm núm/vâng vâng dạ dạ/bảo sao nghe vậy|l
唯天可表=duy thiên khả biểu|l
唯我主义=chủ nghĩa duy ngã|l
唯我独尊=duy ngã độc tôn/Duy Ngã Độc Tôn/mình ta vô địch|l
唱反调=làm trái lại/hát ngược giọng/làm ngược lại/chủ trương ngược lại|l
唱独角戏=làm đơn độc/làm một mình|l
唱白脸=hát mặt trắng/vai chính diện/vai phản diện|l
唱红脸=hát mặt đỏ/vai phản diện|l
唱起来=hát lên|l
啃上=gặm phải|l
啃青=bán lúa non/ăn lúa non|l
商业价值=giá trị buôn bán|l
商量一下=thương lượng một chút|l
商量余地=chừa chỗ thương lượng/chỗ thương lượng|l
啧舌=chặc lưỡi|l
啸之声=tiếng khóc|l
啸起=huýt lên|l
喝一喝=uống một chút|l
喝不喝=uống hay không|l
喝倒彩=khen ngược/tiếng thét/tiếng huýt|l
喝彩声=âm thanh ủng hộ/tiếng ủng hộ|l
喝醉酒=uống say/uống rượu say|l
嗲嗲=ỏn ẻn/gập ghềnh|l
嗲声嗲气=ỏn à ỏn ẻn|l
嘀呜=ò e|l
嚣声=tiếng ồn ào|l
嚣张气焰=kiêu căng phách lối/thái độ quá khích|l
囊中之物=vật trong bàn tay/vật trong túi|l
囊中物=vật trong túi/dễ như chơi/dễ như trở bàn tay/dễ như ăn cháo|l
四不象=Tứ Bất Tượng|l
四亿人=bốn trăm triệu người|l
四仰八叉=ngã chổng vó/ngã chổng vó lên trời|l
四变八=bốn biến tám|l
四处寻找=tìm kiếm khắp nơi|l
四大美女=tứ đại mỹ nữ|l
四季如春=bốn mùa như mùa xuân|l
四海为家=bốn biển là nhà|l
四海之内皆兄弟=tứ hải giai huynh đệ/trong bốn biển đều là huynh đệ/Anh em bốn biển một nhà|l
四环素=streptomisin|l
四维时空=không gian 4 chiều|l
回家路上=trên đường về nhà|l
回想起来=hồi tưởng lại|l
回过头来=quay đầu/quay đầu lại|l
团团围住=bao bọc vây quanh|l
团结起来=đoàn kết lại|l
困难重重=khó khăn chồng chất/rất nhiều khó khăn/Muôn vàn khó khăn/khó khăn muôn trùng|l
固定价格=giá cố định/giá không đổi|l
固定资产=tài sản cố định|l
固定资金=vốn cố định|l
固步自封=bảo thủ/thủ cựu/giậm chân tại chỗ/chùn chân bó gối|l
固若金汤=vững như thành đồng/phòng thủ kiên cố/vô cùng kiên cố/vách sắt thành đồng/cố nhược kim thang/vững như thành đồng vách sắt|l
国之重器=quốc chi trọng khí|l
国恨家仇=hận nước thù nhà/quốc hận gia thù|l
国有财产=tài sản nhà nước/Tài sản nhà nước|l
国步艰难=vận nước gian nguy|l
图文并茂=văn hay chữ đẹp/đồ văn tịnh mậu/văn hay tranh đẹp|l
圆不圆=có tròn hay không|l
圆周运动=chuyển động tròn|l
土不拉几=thổ bất lạp kỷ|l
土之国=Thổ chi quốc|l
土之盾=Thổ Chi Thuẫn|l
土地改革=cải cách ruộng đất|l
土木工程=công trình bằng gỗ/công trình thổ mộc|l
土疙瘩=cục đất/thổ ngật đáp|l
土老财=thổ lão tài|l
在世界上=tại trên thế giới|l
在你看来=theo ý của ngươi/theo ý của huynh/dưới cái nhìn của ngươi|l
在历史上=trong lịch sử|l
在思想上=về mặt tư tưởng|l
在我看来=trong mắt của ta/dưới cái nhìn của ta|l
在此期间=tại trong lúc này/trong lúc ở chỗ này/trong lúc này|l
在表面上=ở ngoài mặt|l
地动山摇=đất rung núi chuyển/thanh thế to lớn/thế lực to lớn|l
地揽=ôm|l
坐便器=xí bệt|l
坐冷板凳=ăn không ngồi chờ/bị ghẻ lạnh/bị đối xử lãnh đạm|l
坐北朝南=tọa bắc triều nam|l
坐如钟=ngồi như chuông|l
坐观成败=mặc người thắng bại/bàng quan lạnh nhạt/cháy nhà hàng xóm bình chân như vại/sống chết mặc bây|l
坑坑洼洼=mấp mô/gồ ghề/lồi lõm/gập ghềnh/xóc/khanh khanh oa oa/loang loang lổ lổ|l
坑蒙拐骗=hãm hại lừa gạt/lừa bịp/khanh mông quải phiến|l
坚实基础=nền móng vững chắc|l
坛坛罐罐=xoong chảo chum vại/nồi niêu chum vại/dụng cụ gia đình|l
城下之盟=hiệp ước cầu hoà/điều ước bất đắc dĩ|l
基本建设=kiến thiết cơ bản/xây dựng cơ bản|l
基本矛盾=mâu thuẫn cơ bản|l
基础代谢=sự thay thế cơ sở|l
基础教育=giáo dục cơ sở|l
堪一握=kham một nắm|l
填补空缺=điền vào chỗ trống|l
增加一倍=gia tăng gấp đôi|l
壁立千仞=vách đá sừng sững/tường đứng ngàn|l
声名显赫=thanh danh hiển hách|l
声如洪钟=âm thanh như chuông lớn/âm thanh như chuông hồng|l
处于下风=ở vào hạ phong|l
处变不惊=gặp chuyện không hoảng/không sợ hãi/giữ bình tĩnh khi đối mặt với các sự kiện|l
处理不当=xử lý không thích đáng|l
复杂劳动=lao động phức tạp|l
外强中干=ngoài mạnh trong yếu/miệng cọp gan thỏ|l
外焦里嫩=kinh ngạc|l
多一事不如少一事=nhiều một chuyện không bằng bớt một chuyện|l
多不多=nhiều hay không/có nhiều hay không|l
多吃多占=thôn tính/tiếm đoạt/thu vén cá nhân|l
多多保重=nhiều hơn bảo trọng|l
多多关照=chiếu cố nhiều hơn/chăm sóc nhiều hơn|l
多如牛毛=nhiều vô số kể/quá nhiều/cực nhiều/nhiều vô số|l
多少年来=bao nhiêu năm rồi|l
多年未见=nhiều năm chưa gặp|l
多愁善感=đa sầu đa cảm|l
多愁多病=đa sầu đa bệnh|l
多早晚=bao giờ/lúc nào/khi nào|l
多样化=đa dạng hóa|l
多样性=tính đa dạng|l
多此一举=vẽ vời thêm chuyện/vẽ vời cho thêm chuyện ra/làm điều thừa/uổng công vô ích|l
多灾多难=nhiều tai nạn/thường xảy ra tai nạn/lắm tai nạn|l
多管闲事=xen vào việc của người khác/quản việc không đâu|l
多舛=nhiều thăng trầm/làm nhiều điều sai trái/đa suyễn/bao thăng trầm|l
多行不义=làm nhiều chuyện bất nghĩa|l
多足动物=động vật nhiều chân|l
多边贸易=mậu dịch nhiều phía|l
多重人格=đa nhân cách|l
夜不闭户=đêm không cần đóng cửa|l
夜冥=Dạ Minh|l
夜凉如水=đêm lạnh như nước|l
夜的黑=bóng tối của màn đêm|l
夜长梦多=đêm dài lắm mộng/đêm dài nhiều mộng|l
够不上=không đủ trình độ|l
够不着=với không tới|l
够交情=thắm thiết/nhiệt tình/chí tình/tận tình/tử tế/bạn chí cốt/bạn bè thân thiết|l
够受的=quá sức/quá chừng/quá lắm|l
够得上=đạt đến/đạt tới|l
够得着=với tới/chạm tới|l
够意思=đủ ý tứ|l
够朋友=bạn chí cốt/bạn thân/bạn tâm tình|l
大不一样=rất khác nhau/không hề cùng dạng|l
大不了=cùng lắm thì/đáng lo/ghê gớm/chẳng qua/chỉ là/đáng ngại/quá mức/chỉ là, cùng lắm là|l
大为改观=thay đổi rất nhiều|l
大事不好=việc lớn không tốt|l
大体上=trên đại thể|l
大动干戈=làm to chuyện/gây chiến/đại động can qua/làm lớn chuyện|l
大包大揽=đảm nhiệm nhiều việc/ôm đồm nhiều việc|l
大变样=đại biến dạng/hoàn toàn biến dạng|l
大吃一顿=có một bữa cơm no đủ/ăn một bữa/ăn một bữa no nê|l
大吃大喝=ăn uống thả cửa/tọng/ngốn/ăn uống thả cửa/bữa tiệc lớn/yến tiệc lớn/đại cật đại hát/ăn uống thỏa thuê|l
大吵大闹=cãi lộn/tranh luận ầm ĩ/tranh cãi kịch liệt/vênh váo/ngạo mạn|l
大处着眼=nhìn xa trông rộng/tầm nhìn xa rộng|l
大好机会=cơ hội thật tốt|l
大小不一=lớn nhỏ không đều/to nhỏ không đều|l
大小不等=lớn nhỏ không giống nhau|l
大幅度提高=đề cao mạnh/tăng lên rất cao|l
大当家=Đại đương gia/đại đương gia|l
大快朵颐=ăn như gió cuốn/đại khoái đóa di|l
大方之家=nhà chuyên môn/người hiểu đạo lý|l
大暴走=đại bạo tẩu|l
大权在握=đại quyền trong tay/nắm quyền/cầm quyền/nắm đại quyền|l
大树下=dưới đại thụ/dưới cây lớn|l
大模大样=ngông nghênh/dáng điệu nghênh ngang|l
大比分=điểm số lớn|l
大气环境=môi trường khí quyển|l
大汗淋漓=mồ hôi đầm đìa|l
大清早=sáng sớm|l
大灾之年=năm thiên tai lớn|l
大灾难=đại tai nạn|l
大男大女=quá lứa lỡ thì|l
大禹治水=Đại Vũ trị thủy|l
大笑话=chuyện cười lớn|l
大脑皮层=vỏ đại não|l
大脑神经=thần kinh đại não|l
大腹便便=bụng phệ/phệ/béo phệ|l
大补之物=vật đại bổ|l
大起大落=thay đổi rất nhanh/thay đổi nhanh chóng/lên lên xuống xuống/đại khởi đại lạc/lên voi xuống chó|l
大跌眼镜=mở rộng tầm mắt|l
大闹一场=đại náo một trận|l
大雨滂沱=mưa như trút nước/mưa lớn/Mưa to gió lớn|l
天下一家=thiên hạ nhất gia/thiên hạ một nhà|l
天下为公=thiên hạ vi công|l
天下第一=thiên hạ đệ nhất/đệ nhất thiên hạ|l
天不怕=không sợ trời/trời không sợ|l
天之府=Thiên Chi Phủ|l
天人合一=thiên nhân hợp nhất|l
天体力学=thiên thể lực học|l
天各一方=mỗi người một nơi|l
天后级=thiên hậu cấp|l
天地万物=thiên địa vạn vật|l
天外天=thiên ngoại thiên|l
天外有天=thiên ngoại hữu thiên/vô tận|l
天姿国色=thiên tư quốc sắc|l
天已晚=trời đã muộn|l
天开眼=trời mở mắt|l
天方夜=Thiên Phương Dạ|l
天无境=Thiên Vô Cảnh|l
天朗气清=trời sáng khí trong/trời sáng mây trong/bầu trời trong xanh|l
天灾人祸=thiên tai nhân hoạ/thiên tai nhân họa/thiên tai và thảm họa nhân tạo|l
天然免疫=miễn dịch tự nhiên|l
天理不容=thiên lý bất dung/đạo trời không tha|l
天理何在=thiên lý ở đâu|l
天色已晚=sắc trời đã tối|l
天选之子=thiên tuyển chi tử|l
天造地设=trời đất tạo nên/tạo hoá gây dựng|l
天隔地远=thiên soa địa viễn|l
太不像话=quá không ra gì|l
太不容易=quá khó khăn|l
太二了=quá đần|l
太多了=nhiều lắm/quá nhiều/quá nhiều rồi|l
太多说=quá nhiều lời|l
太好了=thật tốt quá/tuyệt vời/thật tuyệt vời/rất tốt|l
太岁头上=trên đầu thái tuế|l
太想家=quá nhớ nhà|l
太沉重=quá nặng nề/quá nặng nề|l
太爽了=quá sung sướng/quá đả|l
太紧张=quá khẩn trương/quá sốt sắng|l
太过分=quá mức|l
太难受=rất khó chịu/quá khó chịu|l
失血过多=mất máu quá nhiều|l
头头是道=đạo lý rõ ràng/rõ ràng mạch lạc/rõ ràng đâu ra đấy/nói mạch lạc rõ ràng đâu ra đấy/mạch lạc rõ ràng|l
头昏脑涨=hoa mắt váng đầu|l
头昏脑胀=đầu óc quay cuồng/đầu óc choáng váng|l
头脑发热=đầu óc phát sốt/ấm đầu|l
头脑清楚=đầu óc minh mẫn|l
夷为平地=san thành bình địa|l
夷然=bình thản tự nhiên/bình tĩnh|l
夹层玻璃=kính kép/thuỷ tinh trip-lec|l
夹起来=gắp lên|l
夹道欢迎=xếp hàng hai bên đường đón tiếp/kẹp chào đón/xếp hàng chào đón|l
奉系军阀=Quân Phiệt Fengtian/Bè phái Fengtian|l
套近乎=lôi kéo làm quen/làm quen/lôi kéo làm quen (*nghĩa xấu)/thấy sang bắt quàng làm họ|l
女扮男装=nữ giả nam trang|l
奴隶制度=chế độ nô lệ|l
奴隶社会=xã hội nô lệ|l
好上加好=tốt càng thêm tốt/tốt hơn và tốt hơn|l
好不好=có được hay không/được không|l
好不容易=thật vất vả|l
好为人师=thích lên mặt dạy đời/lên mặt đàn anh/lên mặt kẻ cả/thích làm thầy thiên hạ/muốn làm cha thiên hạ|l
好久不见=đã lâu không gặp|l
好了吧=tốt đi/xong chưa|l
好事多磨=làm việc tốt thường gian nan/việc tốt thường hay gặp trắc trở/muốn làm tốt một việc phải qua nhiều gian nan vất vả/thật bận rộn sao/muốn làm việc tốt phải gặp nhiều khó khăn|l
好人好事=người tốt việc tốt/những người tốt và những điều tốt đẹp/những con người đáng khâm phục và những việc làm gương mẫu|l
好人家=người trong sạch|l
好去处=nơi đến tốt đẹp/nơi để đi|l
好吃好喝=ăn ngon uống sướng/tham ăn tham uống/sành ăn/thích ăn ngon/thích ăn uống|l
好听话=lời dễ nghe/thật nghe lời|l
好善乐施=mạnh thường quân/nhà tài trợ/người thích làm việc thiện/người làm phước|l
好声好气=ôn tồn/hoà nhã/nhã nhặn/dịu dàng/nhẹ nhàng/ôn hoà|l
好多钱=thật nhiều tiền|l
好天儿=trời đẹp/trời trong/đẹp trời/bầu trời quang đãng|l
好奇心=lòng hiếu kỳ/quan tâm/chú ý/thích thú/ham tìm tòi/ham học hỏi/tò mò/hiếu kỳ|l
好好儿=tốt lành/êm đẹp/tốt tươi/tốt/cố gắng hết lòng/cố gắng hết sức/dốc sức/thoả thích|l
好威风=thật là uy phong|l
好容易=khó khăn/khó khăn lắm/không dễ/vất vả/không dễ dàng/vất vả lắm/thật dễ dàng|l
好山好水=hảo sơn hảo thủy|l
好开心=thật vui vẻ|l
好彩头=điềm tốt|l
好得多=tốt hơn nhiều|l
好心肠=tốt bụng|l
好怀念=thật hoài niệm|l
好性儿=tính tốt/hiền lành|l
好想你=rất nhớ ngươi|l
好想学=thật muốn học|l
好想家=thật nhớ nhà|l
好意思=có ý tốt/ý tốt/không biết xấu hổ/không biết ngượng/không biết thẹn/có ý/không ngại ngùng|l
好感度=độ thiện cảm|l
好战份子=phần tử hiếu chiến|l
好收成=thu hoạch tốt|l
好日子=ngày tốt lành/ngày lành/ngày lành tháng tốt/ngày cưới/ngày vui/ngày kết hôn/cuộc sống tốt đẹp/cuộc sống sung sướng/cuộc sống hạnh phúc/ngày tốt/ngày thật tốt|l
好时机=thời cơ tốt|l
好来好去=mở đầu tốt đẹp, kết thúc tốt đẹp/đầu xuôi đuôi lọt|l
好极了=thật tốt/tốt quá/tốt lắm|l
好样儿的=người có chí/người giỏi/người gan dạ/người giỏi giang|l
好梦难圆=mộng đẹp khó thành/việc lý tưởng khó thực hiện|l
好榜样=gương tốt|l
好模好样=đoan trang/một mô hình tốt|l
好气儿=cảm tình/vui lòng/bằng lòng|l
好汉做事好汉当=dám làm dám chịu/hảo hán dũng cảm nhận trách nhiệm về mình|l
好生意=hảo sinh ý|l
好男儿=nam nhi tốt|l
好的开始=khởi đầu tốt|l
好眼力=hảo nhãn lực/thật là tinh mắt/thật tinh tường|l
好管闲事=thích quản nhàn sự/thích quản chuyện người khác/thích chõ mũi vào chuyện người khác|l
好羡慕=thật ghen tị/thật hâm mộ|l
好色的人=người háo sắc/kẻ háo sắc|l
好话说尽=hết lời ngon ngọt|l
好运气=vận khí tốt/số may|l
好高务远=mơ ước hão huyền/mơ ước viển vông/tham vọng viển vông|l
好高鹜远=mơ mộng hão huyền|l
如何是好=như thế nào cho phải|l
如冷电般=như là tia chớp|l
如墨般=như mực|l
如山般=giống như núi|l
如山般重=nặng như núi|l
如意郎君=lang quân như ý/Lang Quân Như Ý|l
如日中天=như mặt trời ban trưa/cực kì hưng thịnh|l
如梦方醒=như ở trong mộng mới tỉnh|l
如水般=như mặt nước|l
如沐春风=như mộc xuân phong/như gió xuân ấm áp|l
如法炮制=bắt chước làm theo/bào chế đúng cách/như pháp pháo chế/bào chế y theo chỉ dẫn|l
如渊底=như đáy vực|l
如电般=như điện|l
如诗如画=như thơ như hoạ|l
如铁盾=như thiết thuẫn|l
如雨刷=như cần gạt nước|l
妻儿老少=vợ chồng con cái/bầu đoàn thê tử|l
娇嗲=điệu đà|l
娇嗲嗲=Kiều Đà Đà|l
娓娓道来=êm tai nói/nói liên tục|l
婆娑起舞=nhảy múa vòng quanh|l
婉言拒绝=nói khéo từ chối/uyển ngôn cự tuyệt|l
婉言谢绝=khéo lời từ chối|l
嫦娥奔月=Thường Nga bôn nguyệt|l
嬉皮士=hippie/híp pi|l
嬉皮笑脸=cười đùa tí tửng/cợt nhả/cười đùa cợt nhả/cười ngỏn ngoẻn|l
子丑寅卯=căn nguyên/nguyên nhân/nguyên lý|l
孜孜=siêng năng/cần cù/cần mẫn/chăm chỉ/mẫn cán/Tư tư/chăm chăm/xa xả|l
孜孜以求=khao khát cầu mong/siêng năng và không mệt mỏi|l
孜然=thì là/cây thì là|l
季风气候=khí hậu gió mùa|l
孤儿寡母=cô nhi quả mẫu|l
孤儿院=cô nhi viện|l
孤雌生殖=sinh sản đơn tính|l
学不学=có học hay không|l
学以致用=học để mà dùng/học để sử dụng|l
学到老=học đến già|l
学前教育=giáo dục mầm non|l
学徒工=học trò/người học nghề|l
学无止境=biển học vô bờ/học tập là vô tận/Biển học vô bờ|l
孰不可忍=không thể nhẫn nhục|l
孰亲孰远=thục thân thục viễn|l
孰多孰少=thục đa thục thiếu|l
孰大孰小=ai lớn ai nhỏ|l
孰弱孰强=ai mạnh ai yếu/ai mạnh ai yếu|l
孰强孰弱=ai mạnh ai yếu|l
孰料=ai ngờ|l
孰是孰非=ai đúng ai sai|l
孰真孰假=cái gì/ai - thật - cái gì/ai - giả|l
孰胜孰负=ai thắng ai thua|l
孰轻孰重=cái gì nhẹ cái gì nặng/thục khinh thục trọng/bên nào nặng bên nào nhẹ|l
孰重孰轻=cái nào nặng cái nào nhẹ/thục trọng thục khinh/bên nào nặng bên nào nhẹ|l
孰高孰低=ai cao ai thấp/thục cao thục thấp|l
宇宙射线=tia vũ trụ/các tia vũ trụ (bức xạ vũ trụ)|l
宇宙空间=không gian vũ trụ|l
宇宙船=tàu vũ trụ|l
宇宙观=vũ trụ quan/thế giới quan|l
宇宙飞船=phi thuyền vũ trụ/tàu vũ trụ|l
宇文化及=Vũ Văn Hóa Cập|l
守土有责=có trách nhiệm bảo vệ lãnh thổ/giữ đất có trách nhiệm/nghĩa vụ bảo vệ tổ quốc|l
守恒定律=đinh luật bảo toàn/định luật bảo toàn|l
守活寡=thủ hoạt quả/thủ hoạt quả (*sống một mình thờ chồng chết)|l
安份守己=an phận thủ thường|l
安步当车=đi bộ cũng như đi xe/đi bộ cũng được/đi bộ còn hơn/thà đi bộ còn hơn|l
完全小学=tiểu học toàn cấp|l
完成度=độ hoàn thành|l
官僚资本=tư bản quan liêu|l
定向培育=nuôi trồng định hướng/lai tạo định hướng/sự gây giống định hướng|l
定性分析=phân tích định tính|l
定情之物=vật đính ước|l
定时炸弹=bom hẹn giờ/bom định giờ/mìn nổ chậm/bị nguy hiểm/rơi vào tình trạng nguy hiểm|l
定睛一看=tập trung nhìn vào/định thần nhìn lại|l
定量分析=phân tích định lượng|l
实不相瞒=thực không dám giấu giếm/thật không giấu diếm/Nói thật không giấu giếm|l
实况转播=tường thuật trực tiếp/truyền hình trực tiếp|l
实报实销=chi bao nhiêu, báo tiêu bấy nhiêu/thanh toán theo thực chi|l
实用价值=giá trị thực dụng|l
实话实说=ăn ngay nói thật/lời ngay nói thật/nói thật|l
家学渊源=gia học uyên thâm|l
家常便饭=chuyện thường ngày/cơm thường/cơm gia đình/chuyện thường/bình thường như cơm bữa/chuyện thường như cơm bữa|l
家庭暴力=bạo lực gia đình|l
家庭环境=hoàn cảnh gia đình/môi trường gia đình|l
家徒四壁=nhà chỉ có bốn bức tường/gia cảnh quá nghèo/nghèo rớt mồng tơi|l
家无担石=thiếu trước hụt sau|l
家累千金=thân đáng ngàn vàng|l
家道中落=gia cảnh sa sút/gia đạo rơi xuống/đi xuống thế giới|l
宽容一点=khoan dung một chút|l
宽敞明亮=rộng rãi sáng ngời/rộng rãi và sáng sủa|l
寂若死灰=yên lặng/yên tĩnh/không một tiếng động|l
密不可分=chặt chẽ không thể tách rời|l
密不透风=kín không kẽ hở/gió thổi không lọt|l
密云不雨=mây dày không mưa/sự việc đã chín muồi mà chưa hành động|l
密切关系=quan hệ mật thiết|l
密切接触=tiếp xúc mật thiết|l
密如雨=dày như mưa|l
密锣紧鼓=chiêng trống rùm beng/khua trống gõ mõ|l
富豪之家=nhà phú hào|l
寒来暑往=hạ qua đông đến/thời gian dần trôi/thời gian qua đi|l
寒风料峭=gió se se lạnh|l
寓教于乐=giáo dục giải trí/ngụ ngôn trong niềm vui|l
寝取=netorare|l
寝食不安=ăn không ngon, ngủ không yên|l
寝食难安=ăn ngủ không yên|l
察觉到=phát giác được/nhận thấy được/nhận ra được|l
寸余=hơn tấc|l
寸断=đứt từng khúc/đau lòng/đau như cắt/đứt đoạn/thốn đoạn|l
寸步不让=một bước cũng không nhường/không nhường nửa bước|l
寸裂=thốn liệt|l
对不=đối không/đúng không|l
对不上=không khớp/không giống/không hợp|l
对不对=đúng hay không/có đúng hay không|l
对不起=thật xin lỗi/có lỗi với/thực xin lỗi/xin lỗi/có lỗi với..|l
对外贸易=ngoại thương/mậu dịch đối ngoại/buôn bán với nước ngoài|l
对对子=đối câu đối|l
对得上=đối được|l
对望一眼=nhìn nhau/liếc nhau một cái|l
对比度=độ tỷ lệ|l
对比联想=liên tưởng so sánh|l
对比色=màu sắc tương phản|l
对的上=xứng đáng|l
对着干=đối nghịch/đối chọi/thi đua/đua|l
对空射击=xạ kích phòng không/cạo xạ phòng không|l
寻呼机=máy nhắn tin/tiếng bíp|l
寻寻觅觅=tìm kiếm thăm dò|l
寻找机会=tìm cơ hội|l
寻衅滋事=tìm cớ gây sự/gây rắc rối|l
封天锁地=Phong Thiên Tỏa Địa|l
封妻荫子=vợ con hưởng đặc quyền|l
封建主义=chủ nghĩa phong kiến/phong kiến|l
封建制度=chế độ phong kiến|l
封建割据=phong kiến cát cứ/chia cắt chiếm đóng|l
封建时代=thời đại phong kiến/thời phong kiến|l
封建社会=xã hội phong kiến|l
封建迷信=phong kiến mê tín|l
封王级=Phong Vương cấp|l
封神演义=Phong Thần Diễn Nghĩa|l
封锁线=tuyến phong tỏa|l
封锁起来=bắt đầu phong tỏa|l
射来射去=bắn qua bắn lui|l
射过去=bắn xuyên qua|l
射过来=bắn tới|l
尊老爱幼=kính già yêu trẻ|l
小不点儿=tiểu bất điểm nhi/nhỏ bé/bé tí/thằng bé con/cu tí|l
小买卖=mua bán nhỏ/buôn bán nhỏ|l
小事化了=chuyện nhỏ hoá không/những điều nhỏ nhặt đã được hóa ra|l
小事化无=chuyện nhỏ hóa không|l
小叮当=Doraemon|l
小吃摊=quầy ăn vặt|l
小打小闹=tiểu đả tiểu nháo/trò đùa trẻ con|l
小本买卖=vốn nhỏ mua bán|l
小笨蛋=đồ đần/thằng nhóc ngốc|l
小花样=bịp bợm cỏn con|l
小蚂蚁=con kiến nhỏ/con kiến nhỏ|l
少不了=thiếu không được|l
少不得=không thiếu được/không thể thiếu|l
少东家=thiếu đông gia/ông chủ nhỏ|l
少之又少=ít càng thêm ít/ít lại càng ít/đã ít lại càng ít|l
少儿不宜=không thích hợp thiếu nhi|l
少女时代=thời thiếu nữ/Girls' Generation|l
少年时代=thời đại thiếu niên|l
少年老成=thiếu niên lão thành/ông cụ non|l
少废话=bớt nói nhảm/ít nói nhảm/Ít nói nhảm/ít nói nhảm|l
少男少女=thiếu nam thiếu nữ|l
少管闲事=bớt lo chuyện người|l
少说两句=nói ít vài ba câu/bớt tranh cãi/bớt tranh cãi một tí|l
少说多做=làm nhiều nói ít|l
少说废话=ít nói lời vô ích/bớt nói nhảm|l
尖溜溜=sắc bén/lanh lảnh|l
尖端放电=phóng điện một chiều|l
尖端科技=khoa học kỹ thuật đỉnh cao|l
尖酸刻薄=chanh chua/chua chát/chua ngoa|l
就事论事=luận sự/bàn việc/tuỳ việc mà xét|l
就行了=là đến nơi/là được rồi/là được|l
就这样办=cứ làm như vậy đi|l
尽人事=làm hết mình|l
尽付东流=phí công nhọc sức/trả hết dòng chảy phía đông|l
尽全力=đem hết toàn lực|l
尽到责任=cố hết trách nhiệm|l
尽我所能=ta tận hết khả năng|l
尽收眼底=thu hết vào mắt|l
尽湿=ướt đẫm|l
尽皆着=tất cả đều|l
尽管如此=mặc dù như thế|l
尽职尽责=tận chức tận trách/tẫn chức tẫn trách/hết chức trách|l
尽释前嫌=quên hết ân oán trước kia|l
尽食=ăn hết|l
层层迭迭=trùng trùng điệp điệp/nhiều lớp|l
层见迭出=xảy ra nhiều lần|l
居高不下=giá cao không hạ|l
屡战=đại chiến|l
屡战屡胜=đánh nhiều thắng nhiều/lũ chiến lũ thắng|l
屡战屡败=khi thắng khi bại/lũ chiến lũ bại|l
屡教不改=dạy mãi không sửa/chỉ bảo nhiều lần mà không sửa chữa|l
屡次三番=năm lần bảy lượt/nhiều lần|l
屡试不中=thi mãi không đậu|l
屡败屡战=khi bại khi thắng|l
山洪暴发=lũ quét|l
山腰上=trên sườn núi|l
岁岁年年=tuế tuế niên niên|l
嶙嶙=đá lởm chởm|l
工于心计=công vu tâm kế|l
工人运动=phong trào công nhân|l
工作狂=cuồng công việc/công việc điên cuồng|l
工作调动=điều động công việc|l
工作难度=độ khó công việc|l
工具化=công cụ hoá|l
工工整整=cẩn thận , nắn nót|l
工艺美术=thủ công mỹ nghệ|l
工部尚书=Công bộ Thượng thư|l
左不过=dù sao cũng/chẳng qua/dù thế nào cũng|l
左膀右臂=phụ tá đắc lực/trợ thủ đắc lực/cánh tay phải cánh tay trái|l
差下人=sai người làm/sai hạ nhân|l
差不=không kém|l
差不多=không sai biệt lắm/xấp xỉ/gần giống nhau/người thường/người bình thường/gần như|l
差不差=kém hay không|l
差不离=xấp xỉ/gần giống|l
差别待遇=phân biệt đối xử/điều trị khác biệt/Đãi ngộ khác biệt/phân biệt đãi ngộ|l
差参=không đều|l
差天共地=sai thiên cộng địa|l
差强人意=tạm được/tạm vừa ý/tạm chấp nhận/tạm hài lòng|l
差得多=kém quá nhiều/sai/kém nhiều|l
差我来=sai ta đến|l
差点儿=hơi kém/hơi dở/hơi tệ/kém một chút/dở/kém/tiếc là/suýt tý nữa/may mà/thiếu một chút|l
差等生=soa đẳng sinh/soa đẳng sinh|l
差远了=kém xa|l
巴不得=ước gì/chỉ mong sao/những mong sao/mong vô cùng|l
巾帼不让须眉=bậc cân quắc không thua đấng mày râu/bậc cân quắc(phụ nữ) không thua đấng mày râu/mày liễu không nhường mày râu|l
师徒关系=quan hệ thầy trò|l
希腊神话=thần thoại Hi Lạp|l
帮你忙=giúp ngươi một chút|l
帮倒忙=làm trở ngại chứ không giúp gì/giúp thêm phiền/giúp hoá phiền/giúp qua loa|l
帮帮忙=giúp đỡ chút/giúp một tay/giúp đỡ|l
常备不懈=luôn luôn sẵn sàng|l
常年累月=năm dài tháng rộng/quanh năm|l
常来常往=thường xuyên qua lại/thăm hỏi thường xuyên|l
常绿植物=loài cây xanh quanh năm|l
常规战争=chiến tranh thông thường|l
常规武器=vũ khí thông thường|l
常言道=thường nói|l
干不干=có làm hay không|l
干什么=làm gì/tại sao/làm cái gì/làm sao|l
干脆利落=gọn gàng mà linh hoạt/dứt khoát/thẳng thắn dứt khoát|l
平下气来=bình tĩnh lại|l
平均分配=bình quân phân phối|l
平庸之辈=hạng người bình thường|l
平等互利=bình đẳng cùng có lợi/bình đẳng và cùng có lợi/lợi ích chung|l
平躺着=nằm ngang|l
平面几何=hình học phẳng|l
年久失修=lâu năm không sửa sang/lâu năm không được sửa chữa/đổ nát|l
年事已大=tuổi đã lớn|l
年事已高=tuổi tác đã cao|l
年代久远=niên đại xa xưa|l
年夜饭=cơm tất niên|l
年少气盛=niên thiếu khí thịnh|l
年岁久远=tuổi tác xa xưa|l
年年岁岁=niên niên tuế tuế|l
年幼无知=trẻ người non dạ/thơ dại/nhỏ dại|l
年纪轻轻=tuổi còn trẻ|l
年老体弱=thân thể suy yếu lâu năm/tuổi già và sức khỏe yếu/già yếu|l
年老体衰=tuổi già sức yếu|l
年老色衰=tuổi già sắc suy/tuổi già và màu sắc suy giảm|l
年过半百=tuổi trên năm mươi/hơn năm mươi tuổi|l
年过花甲=tuổi quá một giáp|l
年近古稀=tuổi gần thất tuần/tuổi tác cổ xưa hiếm|l
并不多=cũng không nhiều|l
并不知道=cũng không biết|l
并不等于=cũng không có nghĩa là|l
并不需要=cũng không cần|l
并发症=bệnh biến chứng|l
并肩作战=kề vai chiến đấu/sát cánh chiến đấu/hợp lực tác chiến|l
幸免于难=may mắn thoát nạn|l
幼儿教育=giáo dục trẻ em/giáo dục trẻ thơ|l
幼吾幼以及人之幼=ấu ngô ấu/dĩ cập nhân chi ấu|l
广东话=tiếng Quảng Đông|l
广为人知=lan truyền rộng rãi/được biết đến rộng rãi|l
广为流传=lưu truyền rộng rãi|l
广开言路=rộng đường ngôn luận/tạo điều kiện để mọi người phát biểu ý kiến|l
广种薄收=thất thu/trồng nhiều thu ít/sản lượng thấp/năng suất kém|l
广而言之=nói chung|l
应变力=sức ứng biến|l
应变能力=năng lực ứng biến|l
应用科学=khoa học ứng dụng|l
底气十足=lực lượng mười phần/mười phần phấn khích|l
廉耻心=lòng liêm sỉ|l
开了门=mở cửa|l
开会时间=thời gian họp|l
开倒车=thụt lùi/rút lui/quay ngược đồng hồ/đi ngược chiều lịch sử/trở về quá khứ|l
开发软件=khai phát nhuyễn kiện|l
开回去=lái trở về|l
开夜车=làm đêm/làm ca ba/làm việc khuya/làm thêm ban đêm/làm thâu đêm/thức suốt đêm|l
开完枪=bắn xong|l
开小灶=thiên vị/mở tiêu chuẩn cao nhất|l
开开心=vui vẻ một chút|l
开开眼=mở mắt một chút|l
开心起来=bắt đầu vui vẻ/vui vẻ|l
开快车=tăng tốc độ/làm nhanh/làm gấp|l
开水烫=bỏng nước sôi|l
开着车=lái xe|l
开锁器=dụng cụ mở khóa|l
开门红=khởi đầu tốt đẹp/khởi đầu thuận lợi/mở đầu tốt đẹp/khai môn hồng|l
异国他乡=tha hương nơi đất khách|l
异国情调=dị quốc tình điều|l
弃械投降=bỏ vũ khí đầu hàng|l
引人关注=làm cho người ta chú ý|l
引以为豪=lấy làm tự hào|l
引体向上=kéo xà đơn|l
引力定律=định luật hấp dẫn|l
引蛇出洞=dẫn xà xuất động/dẫn rắn ra khỏi hang/dụ rắn ra khỏi hang|l
引过去=dẫn qua|l
引领到=dẫn đến|l
弥漫着=tràn ngập|l
弥留之际=thời khắc hấp hối|l
弹回来=bắn trở về|l
弹过去=bắn tới|l
强中弱=cường trung nhược|l
强中更有强中手=kẻ mạnh càng có kẻ mạnh hơn|l
强中自有强中手=cường trung tự hữu cường trung thủ|l
强买强卖=ép mua ép bán/mạnh mua mạnh bán/buộc ai đó mua hoặc bán|l
强人所难=làm khó/ép buộc/gây khó/làm người khác khó chịu|l
强压怒火=kiềm nén lửa giận/cố nén lửa giận|l
强强联合=cường cường liên hợp/liên minh mạnh mẽ|l
强扭的瓜不甜=dưa hái xanh không ngọt|l
强烈反应=phản ứng mãnh liệt|l
强笑道=gượng cười nói|l
强食弱肉=mạnh được yếu thua|l
归一境=Quy Nhất Cảnh|l
归咎于=quy tội/đổ tội/đổ lỗi|l
归属于=thuộc về|l
归心如箭=nóng lòng về nhà/nỗi nhớ nhà canh cánh|l
归根到底=xét đến cùng/cuối cùng|l
当今社会=xã hội hiện nay|l
形同虚设=thùng rỗng kêu to/hình đồng hư thiết|l
形式逻辑=lô-gích hình thức|l
形而上=trừu tượng|l
形而上学=hình nhi thượng học/kinh nghiệm bên ngoài/bộ môn nghiên cứu nguyên lý căn bản của vũ trụ trong lịch sử triết học/siêu hình|l
彩色电视=ti vi màu/truyền hình màu/máy thu hình màu|l
彼众我寡=nó nhiều ta ít|l
彼此彼此=cũng vậy/cũng thế/như nhau|l
彼此间=giữa lẫn nhau|l
待民如子=đãi dân như con|l
很不简单=thật không đơn giản|l
很久以前=trước đây thật lâu|l
很想学=rất muốn học|l
很想笑=rất muốn cười|l
很想说=rất muốn nói|l
很感兴趣=cảm thấy rất hứng thú|l
很早以前=trước kia rất sớm/rất lâu trước đây|l
很浓=rất đậm/rất nồng/đậm|l
很着急=rất gấp|l
很纤=cực kỳ nhọn|l
很难说=rất khó nói|l
很难说服=rất khó thuyết phục|l
很饱=rất no|l
很高吭=rất giọng cao|l
徒劳地=phí công|l
徒子徒孙=đồ tử đồ tôn|l
得之不易=không dễ có|l
得了吧=thôi đi/được rồi a|l
得来不易=được không dễ|l
得步进步=được đằng chân lân đằng đầu|l
得胜回朝=chiến thắng trở về/thắng lợi trở về|l
得过且过=được chăng hay chớ/được ngày nào hay ngày ấy/qua loa cho xong chuyện|l
得饶人处且饶人=tìm chỗ khoan dung mà độ lượng/khuyên người phải có lòng khoan dung/tha cho người được nên tha|l
循名责实=danh xứng với thực|l
循环小数=số lẻ tuần hoàn|l
循环往复=tuần hoàn qua lại|l
循环系统=hệ thống tuần hoàn|l
微一沉=hơi trầm xuống một cái|l
微分学=vi phân học/toán học vi phân|l
微微一笑=mỉm cười/khẽ mỉm cười|l
微生物=vi sinh vật/vi trùng|l
微电脑=microcomputer|l
微笑起来=mỉm cười|l
微红着=ửng đỏ|l
微言大义=ngôn ngữ tinh tế ý nghĩa sâu xa/lời nhẹ nghĩa sâu|l
微颦=khẽ nhăn mày|l
心中有数=trong lòng hiểu rõ/trong lòng có dự kiến trước/lòng đã tính trước|l
心如刀绞=tim như bị đao cắt|l
心怀鬼胎=tâm hoài quỷ thai|l
心无二用=chuyên tâm/dốc lòng|l
心明眼亮=sáng mắt sáng lòng|l
心浮气燥=tâm phù khí táo/thấp thỏm lo âu|l
心肠好=tâm địa tốt|l
心领神会=ngầm hiểu/hiểu ngầm trong lòng/thông suốt/thấm nhuần mọi ý/tâm lĩnh thần hội|l
必不可少=ắt không thể thiếu/thiết yếu/không thể thiếu/cần/cần thiết/tuyệt đối cần|l
必争之地=vùng giao tranh/khu vực giao tranh/vùng tranh chấp|l
必先利其器=tất phải chuẩn bị trước/trước tiên phải lợi dụng/thợ muốn giỏi việc/trước tiên phải làm công cụ sắc bén. ý nói muốn làm tốt một việc/cần phải có sự chuẩn bị tốt.|l
必定会=tất nhiên sẽ/nhất định sẽ|l
必有一伤=tất có một bị thương/tất có một người bị thương|l
必有一死=phải có một chết|l
必有用=tất hữu dụng|l
必杀令=tất sát lệnh|l
必然性=tính tất yếu|l
必然王国=vương quốc tất nhiên|l
必然趋势=khuynh hướng tất nhiên|l
必由之路=con đường duy nhất/đường phải đi/đường phải qua/cách duy nhất/phải/đường duy nhất|l
必经之地=khu vực cần phải đi qua|l
必经之路=đường buộc phải qua/con đường phải đi qua/giống như 必由之路 [bi4 you2 zhi1 lu4]|l
必经之道=con đường ắt phải qua|l
必胜客=Pizza Hut|l
必要劳动=lao động tất yếu|l
必要性=tính tất yếu|l
必要条件=điều kiện tất yếu|l
必需品=nhu yếu phẩm/thứ cần thiết/nhu phẩm cần thiết|l
忆想=hồi tưởng/nhớ lại|l
忙不过来=bận không qua nổi/không giúp được|l
快上来=mau lên đây|l
快如闪电=nhanh như thiểm điện/nhanh như chớp giật|l
快死了=sắp chết/sắp chết rồi|l
快进来=mau vào|l
忽上忽下=chợt cao chợt thấp|l
忽南忽北=chợt nam chợt bắc|l
忽喜忽忧=chợt vui chợt buồn|l
忽左忽右=chợt trái chợt phải|l
忽强忽弱=chợt mạnh chợt yếu|l
忽必烈=Hốt Tất Liệt|l
忽快忽慢=chợt nhanh chợt chậm|l
忽明忽灭=chợt sáng chợt tắt|l
忽略不计=không đáng kể|l
怀恨在心=ghi hận trong lòng/ôm hận trong lòng|l
怀鬼胎=mang ý xấu/mang ý định xấu|l
怎么办=làm sao/làm sao bây giờ/làm cái gì/làm cái đó|l
怎么回事=chuyện gì xảy ra|l
怎么弄=làm sao làm|l
怎办=làm sao/làm/xử lý/lo liệu - sao/thế nào|l
怎敢=sao dám|l
怎知=thế nào biết/nào biết|l
怎能说=làm sao có thể nói|l
思前想后=suy đi nghĩ lại/tư tiền tưởng hậu|l
思想体系=hệ tư tưởng/hình thái ý thức|l
思想动态=động thái tư tưởng/động lực tư tưởng|l
思想家=nhà tư tưởng|l
思想斗争=đấu tranh tư tưởng|l
思来想去=càng nghĩ/nghĩ tới nghĩ lui|l
急公好义=nhiệt tình vì lợi ích chung/hay giúp đỡ người khác|l
急刹车=dừng ngay/dừng nhanh/dừng lập tức/xe thắng gấp|l
急死了=vội muốn chết|l
怦然心动=tim đập thình thịch|l
性命之忧=lo lắng tính mạng/nguy hiểm đến tình mạng|l
性骚扰=quấy rối tình dục/quấy nhiễu tình dục|l
怪不得=trách không được/thảo nào/hèn nào/chẳng trách/chả trách/hèn chi/không nên trách/chẳng thể trách/không trách|l
怪不怪=có trách hay không|l
怪不着=không trách|l
怪模怪样=hình thù cổ quái/quái mô quái dạng/hình thù kỳ quái/dáng dấp kỳ dị/quái dị/quái đản/kì dị quái đản|l
怪石嶙峋=quái thạch lởm chởm|l
怪诞不经=quái đản/không bình thường/quái gở|l
总以为=luôn cho là|l
总价值=tổng giá trị|l
总有一天=một ngày nào đó/sẽ có một ngày|l
总枢纽=trung tâm điều khiển|l
总瓢把子=lão đại đứng đầu|l
总的说来=tổng quát mà nói|l
总预算=tổng dự toán|l
恪尽职守=tận hết chức vụ|l
恶性肿瘤=u ác tính/ung thư/khối u ác tính|l
悄无声息=lặng yên không một tiếng động|l
悄没声儿=im ắng/im lặng|l
悉听尊便=tự nhiên muốn làm gì cũng được|l
悠哉悠哉=thảnh thảnh thơi thơi/thảnh thơi thong thả/nhàn nhã/tự do và không bị giới hạn|l
悠哉游哉=nhàn nhã|l
悠悠万事=muôn công nghìn việc|l
悠悠岁月=năm tháng dài dằng dặc/nắm tháng dài dằng dặc|l
悠悠长夜=đêm dài dằng dặc|l
悠想=du tưởng|l
悠着点=kiềm chế một chút/du trứ điểm|l
您好=ngài hảo/xin chào/chào ngài/Xin chào, chào ngài|l
悲从中来=nỗi bi thống trong tâm trào ra/đau khổ trong lòng/nỗi buồn đến từ đó|l
情急之下=dưới tình thế cấp bách|l
情理之中=hợp tình lý/hợp tình hợp lý|l
情非得已=tình thế bất đắc dĩ/không phải bất đắc dĩ|l
惊诧不已=kinh ngạc không thôi|l
想一见=muốn xem một lần|l
想不到=nghĩ không ra/không thể tưởng được/không ngờ/nào ngờ/nào dè/dè đâu/không nghĩ tới|l
想不干=muốn không làm|l
想不说=không muốn nói|l
想不起来=nghĩ không ra/không nhớ nổi/không nhớ ra được|l
想不通=không nghĩ ra/muốn không thông|l
想不醉=muốn không say|l
想个办法=nghĩ biện pháp/nghĩ một biện pháp|l
想也不想=không chút nghĩ ngợi|l
想也别想=nghĩ cũng đừng nghĩ|l
想了又想=nghĩ đi nghĩ lại|l
想像中=trong tưởng tượng|l
想像出=tưởng tượng ra|l
想像出来=tưởng tượng ra được|l
想像得到=tưởng tượng được/tưởng tượng đến được|l
想将来=nghĩ tương lai|l
想尽办法=nghĩ hết biện pháp/nghĩ tất cả biện pháp|l
想干么=muốn làm gì|l
想干什么=muốn làm gì|l
想当初=nhớ ngày đó/nhớ lúc đầu|l
想当年=nhớ năm đó|l
想当然=nghĩ đương nhiên/chắc hẳn phải vậy|l
想想也是=nghĩ nghĩ cũng là|l
想想看=ngẫm lại xem|l
想来想去=nghĩ tới nghĩ lui|l
想法子=tìm cách/nghĩ cách|l
想活上=muốn sống tới|l
想碰瓷=muốn ăn vạ|l
惹不起=không thể trêu vào/không chọc nổi/không trêu chọc nổi|l
惹人爱=làm cho người thích|l
惹出来=gây ra|l
惹是生非=gây chuyện thị phi/gây rắc rối/sinh sự/gây chuyện phiền toái/nhạ thị sinh phi|l
惹是非=gây chuyện/gây rắc rối/gây sự|l
惹麻烦=gây phiền toái|l
惺惺作态=làm bộ làm tịch/làm bộ làm dạng|l
愈动愈急=càng động càng gấp|l
愈吵愈烈=dũ sảo dũ liệt/càng lúc càng ồn ào|l
愈想=càng nghĩ|l
愈想愈气=càng nghĩ càng tức giận|l
愈战愈勇=càng chiến càng mạnh|l
愈来愈多=càng ngày càng nhiều|l
愈来愈热=càng lúc càng nóng|l
愈演愈烈=càng ngày càng nghiêm trọng/dũ diễn dũ liệt/càng lúc càng kịch liệt|l
愈烧愈旺=càng cháy càng mạnh|l
愈烧愈烈=càng cháy càng mãnh liệt|l
愈盛=càng thịnh/càng mạnh mẽ|l
愈红=càng đỏ|l
意下如何=ý như thế nào|l
意想不到=không tưởng được/không tưởng tượng nổi|l
意料中=trong dự liệu|l
意料之中=trong dự liệu|l
意料之外=ngoài ý liệu/bất ngờ|l
意识形态=hình thái ý thức|l
感动不已=cảm động không thôi|l
感受一下=cảm thụ một chút|l
感同身受=cảm đồng thân thụ/cảm động lây/cảm kích khác nào chính mình chịu ơn|l
感性认识=nhận thức cảm tính|l
感情作用=xử sự theo cảm tính|l
感慨系之=tức cảnh sinh tình|l
感激不尽=vô cùng cảm kích|l
感觉器官=giác quan/cảm quan/cơ quan cảm giác|l
感觉得到=cảm giác được|l
慎之又慎=cực kỳ thận trọng/thận chi hựu thận|l
慕容家=Mộ Dung gia|l
慢一拍=chậm một nhịp|l
慢性子=tính chậm chạp/người chậm chạp|l
慢慢说=từ từ nói|l
慧眼独具=tuệ nhãn cao siêu|l
憋不住=không nín được/không nhịn được/nhịn không nổi/nhịn không được|l
憧憧=lắc lư/đung đưa/lay động/thấp thoáng/đu đưa/rung rinh/lập loè/lung linh/bập bùng|l
懵圈=mơ hồ|l
懵懵=tỉnh tỉnh|l
懵懵懂懂=hồ hồ đồ đồ/tỉnh tỉnh mê mê/sự hiểu biết/Mù mà mù mờ ;ngu nga ngu ngơ|l
戊戌变法=biến pháp Mậu Tuất|l
成一系=thành một hệ|l
成人教育=giáo dục dành cho người lớn/giáo dục bổ túc|l
成何体统=còn thể thống gì|l
成天到晚=từ sáng đến tối|l
成就感=cảm giác thành tựu/cảm giác thành công|l
成年累月=quanh năm suốt tháng|l
我中有你=trong ta có ngươi/tôi có bạn/tôi có anh|l
我爱你=ta yêu ngươi/anh yêu em|l
戴起来=mang lên|l
戴面具=mang mặt nạ|l
所到之处=chỗ đến/đến mức|l
所问非所答=sở vấn phi sở đáp|l
手一缩=co tay một cái|l
手到擒来=dễ như trở bàn tay/bắt vào tay|l
手头紧=tình hình kinh tế căng thẳng|l
手拿着=tay cầm|l
扑上去=nhào tới|l
扑上来=nhào lên|l
扑下去=nhào xuống/đập xuống|l
扑尔敏=chlorpheniramine|l
扑面而来=đập vào mặt/phả vào mặt|l
扑鼻而来=xông vào mũi|l
打一赌=đánh cá một cái|l
打光棍=cô độc/ở độc thân|l
打光棍儿=độc thân/sống độc thân|l
打入冷宫=đày vào lãnh cung/biếm lãnh cung/cất vào/cất đi|l
打冷战=rùng mình/run cầm cập/ớn lạnh|l
打冷枪=bắn lén/ném đá giấu tay/bắn tỉa|l
打击乐器=nhạc cụ gõ/bộ gõ|l
打击报复=trả đũa/trả miếng|l
打击目标=mục tiêu đả kích|l
打前站=đi tiền trạm/mở đường|l
打前锋=đánh tiên phong|l
打发走=đuổi đi|l
打呼噜=ngáy ngủ/ngáy|l
打嘴仗=cãi nhau/cãi lộn|l
打嘴炮=đánh pháo miệng|l
打圈子=lượn vòng/bay vòng/luẩn quẩn/lẩn quẩn|l
打基础=đặt nền móng/đặt nền tảng/làm móng/xây móng/chuẩn bị/trụ cột/đánh cơ sở|l
打天下=đánh thiên hạ/giành chính quyền/đoạt chính quyền/cướp chính quyền/bắt đầu sự nghiệp|l
打头炮=bắn phát đầu/nói trước/phát biểu trước/hành động trước/làm trước|l
打头风=ngược gió/gió ngược|l
打字员=tên nhân viên|l
打字机=máy chữ/máy đánh chữ|l
打官司=thưa kiện/lên tòa án/kiện/đi kiện/kiện tụng|l
打定主意=hạ quyết tâm/kiên quyết/quyết định/quyết định chủ ý|l
打富济贫=cướp của người giàu chia cho dân nghèo|l
打对家=đánh đối diện|l
打平手=ngang tài ngang sức/đồng tài đồng sức/không phân cao thấp/hoà nhau|l
打开门=mở cửa|l
打得火热=thân nhau/quan hệ mật thiết|l
打成一片=hoà mình/hoà thành một khối/kết thành một khối|l
打成平手=bất phân thắng bại/ngang nhau/đánh ngang tay|l
打打气=động viên một chút|l
打打闹闹=cãi nhau ầm ĩ/cãi nhau ầm ĩ/đánh lộn|l
打扮起来=chưng diện|l
打把势=luyện võ/tập võ/múa may/hoa tay múa chân|l
打拍子=gõ nhịp/chỉ huy dàn nhạc/đánh nhịp|l
打挺儿=giẩy nẩy/giãy nãy/nẩy/ưỡn người|l
打摆子=co giật/sốt/sốt rét|l
打斗声=tiếng đánh nhau|l
打来打去=đánh tới đánh lui|l
打架斗殴=đánh nhau ẩu đả/đánh nhau|l
打比方=đưa ra so sánh|l
打游戏=chơi game|l
打火机=cái bật lửa/hộp quẹt/bật lửa/máy lửa|l
打照面儿=gặp mặt/gặp nhau/lộ diện/xuất hiện|l
打牙祭=bữa ăn ngon|l
打电话=gọi điện thoại/gọi điện|l
打白条=cấp/chứng từ/hoá đơn/hóa đơn|l
打短儿=làm công ngắn hạn/làm thuê ngắn hạn|l
打砸=đập/đập vỡ|l
打秋风=làm tiền/tống tiền|l
打翻身仗=khắc phục khó khăn|l
打补丁=vá víu|l
打败仗=bại trận/thua trận/thất trận|l
打过仗=đánh trận/đánh giặc|l
打通关=đánh thông quan/oẳn tù tì/một hai ba/uống rượu theo tua|l
打造出=chế tạo ra|l
打野外=đi dã ngoại/tập dã chiến|l
打问号=đánh dấu hỏi/đặt dấu hỏi/nghi ngờ|l
打预防针=phòng hờ|l
打鸣儿=gà gáy|l
扛下去=tiếp tục gánh vác|l
扛下来=tiếp tục chống đỡ|l
扛不住=gánh không được|l
执子之手=nắm lấy tay người/bàn tay của người cầm con/cố chấp nắm tay/bên nhau tới già|l
执法机关=cơ quan chấp pháp|l
扫地出门=đuổi ra khỏi cửa/đuổi ra khỏi nhà/bị cướp sạch của cải, đuổi ra khỏi nhà/trắng tay|l
扫堂腿=Tảo Đường thối|l
扫完码=quét mã xong|l
扫来扫去=quét tới quét lui|l
扫过来=quét tới|l
扭亏为盈=dần dần có lãi|l
扭到脚=trật chân|l
扭捏作态=vẻ gượng ép|l
扭来扭去=uốn qua uốn lại/uốn tới ẹo lui|l
扭过头=nghiêng đầu sang chỗ khác/nghiêng đầu qua chỗ khác|l
扭过头去=nghiêng đầu đi/nghiêng đầu sang chỗ khác|l
扭过头来=nghiêng đầu lại|l
扭过来=quay lại|l
扶起来=nâng đỡ/đỡ dậy|l
批改作业=chấm bài tập|l
批示着=phê chuẩn|l
找来找去=tìm tới tìm lui|l
技不如人=tài nghệ không bằng người|l
技术革新=cải tiến kỹ thuật/đổi mới kỹ thuật|l
抄录下来=chép lại|l
抄近路=đi tắt/đi đường tắt|l
投怀送抱=ôm ấp yêu thương/yêu thương nhung nhớ/nhảy vào ôm lấy ngực/đầu hoài tống bão|l
抖了起来=run lên|l
抖动着=lay động|l
抗干扰=kháng quấy nhiễu|l
抗拒从严=kháng cự sẽ nghiêm trị|l
抗拒火环=Kháng Cự Hỏa Hoàn|l
抠抠搜搜=keo keo kiệt kiệt|l
抠搜=móc/gảy/keo kiệt/bủn xỉn/bần tiện/ì ạch/ì à ì ạch|l
抠门儿=keo kiệt/bủn xỉn/hẹp hòi/bần tiện|l
抢劫犯=tội phạm ăn cướp/tên cướp|l
抢救工作=công việc cấp cứu|l
抢走了=đoạt đi rồi/cướp đi/đoạt đi|l
抢过来=đoạt tới|l
报上名来=xưng tên ra|l
抬头不见低头见=ngẩng đầu không thấy cúi đầu thấy/ngẩng đầu không thấy cúi đầu gặp|l
抬起头来=ngẩng đầu lên|l
抬轿子=khiêng kiệu/tâng bốc/nịnh hót/bợ đỡ|l
抱佛脚=ôm chân phật/nước tới chân mới nhảy/nước tới trôn mới nhảy/không chịu chuẩn bị trước/ngày thường không thắp hương, cuống lên mới ôm chân Phật|l
抱粗腿=bám đít/bợ đít/ôm chân/liếm gót|l
抽丝剥茧=kéo tơ bóc kén/cẩn thận thăm dò|l
抽冷子=thình lình/nhân lúc bất ngờ/bất thình lình|l
抽出来=rút ra|l
抽壮丁=bắt lính/bọn đầu gấu|l
抽时间=bớt thời gian/rút thời gian/rút thì gian|l
抽气机=bơm hơi|l
抽油烟机=máy hút khói|l
抽筋剥皮=rút gân lột da/bóc lột tàn khốc/bóc lột tận xương tuỷ|l
抽象代数=đại số trừu tượng/Đại số trừu tượng|l
抽起来=hút|l
抽进去=hút vào|l
抽风机=quạt hút|l
抽鼻子=sụt sịt cái mũi/khụt khịt/hít vào/hít/sổ mũi|l
拆东墙补西墙=bóc tường đông bổ tường tây/phá hủy bức tường phía đông để bổ sung cho bức tường phía tây/Cướp Peter để trả cho Paul|l
拆墙脚=dỡ chân tường/sập tiệm, làm hỏng, phá|l
拉下脸=không nể mặt/không nể nang/không kiêng nể/xụ mặt/sa sầm mặt/sầm mặt/xệ mặt xuống|l
拉下脸来=xệ mặt xuống|l
拉不下=kéo không xuống|l
拉不下脸=hạ mặt không được/không thể kéo mặt xuống/vì thể diện/không thể mất mặt/không tiện nói|l
拉不动=kéo không nhúc nhích|l
拉了一把=kéo một cái|l
拉偏手儿=ra tay trợ giúp/ra tay tương trợ|l
拉关系=chắp nối/hàn gắn mối quan hệ/xây dựng quan hệ/kết thân/làm thân/lập quan hệ|l
拉后腿=níu áo/níu chân/kéo chân sau|l
拉回去=kéo trở về|l
拉回来=kéo trở về|l
拉大旗作虎皮=mượn oai hùm|l
拉帮结伙=kéo bè kéo cánh/tụm năm tụm bảy/âm mưu lừa gạt/thông đồng|l
拉开距离=kéo dài khoảng cách|l
拉拉扯扯=lôi lôi kéo kéo/do dự/không dứt khoát/cù cưa cù nhằng/lằng nhà lằng nhằng|l
拉拉杂杂=lộn xà lộn xộn|l
拉过来=kéo qua|l
拍手叫好=vỗ tay bảo hay|l
拍打着=vuốt/vỗ/ném|l
拒不回答=kháng cự không trả lời|l
拒之门外=cự tuyệt ở ngoài cửa/chận ngoài cửa/đẩy ra khỏi cửa|l
拒人千里=cự người ngàn dặm/từ chối mọi người một ngàn dặm|l
拒绝者=người cự tuyệt|l
拖回来=kéo về|l
拖拽=lôi kéo|l
招呼客人=chào hỏi khách khứa/chào hỏi khách nhân|l
招架不住=chống đỡ không được/không chống đỡ được|l
拥军优属=ủng hộ bộ đội/ưu đãi gia đình quân nhân cách mạng|l
拥抱着=ôm ấp lấy/ôm|l
拥政爱民=ủng hộ chính quyền, yêu mến nhân dân|l
拥有权=quyền sở hữu|l
拥而上=chen nhau mà lên|l
拧成一股绳=bện thành một sợi dây thừng|l
拱手听命=cúi đầu phục tùng/chắp tay nghe lệnh|l
拱手而降=bó tay đầu hàng/chắp tay và rơi xuống|l
拱肩缩背=co ro/co rút/rút người|l
拼下去=tiếp tục đấu|l
拼不过=không đấu lại|l
拼了命=liều mạng|l
拼到底=chiến đấu tới cùng|l
拼刺刀=giáp lá cà/lưỡi lê/phí lưỡi lê|l
拼尽老命=liều hết cả cái mạng già|l
拼死一搏=liều mạng một lần|l
拼老命=liều mạng già/liều cái mạng già|l
拼起命=liều mạng|l
拼音字母=chữ cái/bảng chữ cái La Tinh|l
拼音文字=bảng chữ cái/chữ ghép âm/văn tự phiên âm|l
拾人牙慧=bắt chước lời người khác/học mót/lặp lại/ăn mót ăn nhặt|l
拾起来=nhặt lên|l
拾遗补缺=bổ sung|l
拾阶=mười bậc|l
拾音器=bộ phối hợp/bộ phận thu âm trong máy hát điện|l
拿不出手=không lấy ra được|l
拿不动=cầm không được/cầm không nổi|l
拿不起来=không cầm lên được|l
拿回去=lấy về|l
拿大头=cầm đầu|l
拿的出手=lấy ra được|l
拿腔作调=giả vờ giả vịt|l
拿腔拿调=giả giọng điệu/nã khang nã điệu|l
拿起枪=cầm lấy súng|l
持续上升=không ngừng tăng lên|l
按劳分配=phân phối theo lao động/hưởng theo lao động|l
按摩师=thợ đấm bóp|l
按理说=theo lý thuyết|l
按规定=theo quy định|l
按需分配=phân phối theo nhu cầu/hưởng theo nhu cầu|l
挑刺儿=chỉ trích/xoi mói/bới móc|l
挑大梁=diễn chính/nhân vật chính/công việc chính/công việc quan trọng|l
挑字眼儿=bới lông tìm vết|l
挑选出=chọn lựa ra|l
挤时间=tập trung thời gian|l
挤眉溜眼=tễ mi lưu nhãn|l
挤进来=chui vào|l
挥之不去=vung đi không được/lái đi không được|l
挥汗如雨=đổ mồ hôi như mưa|l
挥汗成雨=người đông như kiến/mồ hôi như mưa|l
挨肩擦膀=kề vai áp má|l
挨饿受冻=ăn đói mặc rách|l
振作起来=tỉnh lại/tỉnh lại đi|l
捅马蜂窝=chọc tổ ong vò vẽ|l
捉下来=tóm lại|l
捉迷藏=chơi trốn tìm/chơi trốn kiếm/bịt mắt bắt dê/trò chơi bịt mắt bắt dê/đánh đố/đánh lừa|l
捏一把汗=mướt mồ hôi/toát mồ hôi/đổ mồ hôi hột|l
捏了一把汗=lau một vệt mồ hôi|l
捏动着=nắn lấy|l
捏着鼻子=nắm lỗ mũi/bóp mũi lại|l
捏肩=nắn vai|l
捞起来=vớt lên|l
捡便宜=kiếm tiện nghi/kiếm lợi|l
捡回来=kiếm về|l
捡破烂=nhặt ve chai|l
捡破烂儿=lượm ve chai/nhặt ve chai|l
捡起来=nhặt lên|l
捧上天=nâng lên trời|l
捧腹大笑=phình bụng cười to|l
掉价儿=hạ giá|l
排名顺序=thứ tự xếp hạng|l
排成一列=xếp thành một hàng|l
排水系统=hệ thống thoát nước|l
接下来=sau đó|l
接人待物=đối đãi người|l
接力赛跑=chạy tiếp sức/thi chạy tiếp sức|l
接受度=độ chấp nhận|l
接合处=chỗ tiếp hợp|l
接听电话=nghe điện thoại|l
接回去=đón về|l
接头儿=chỗ nối/chỗ chắp/chỗ vá|l
接待员=nhân viên tiếp tân/nhân viên lễ tân/tiếp tân|l
接待处=nơi tiếp đãi|l
接待站=trạm tiếp đón/trạm tiếp đãi|l
接电话=nghe/nghe điện thoại/tiếp điện thoại|l
接着就是=tận lực bồi tiếp/tiếp theo chính là|l
接风洗尘=bày tiệc mời khách|l
控制中心=trung tâm khống chế|l
控制系统=hệ thống điều khiển/hệ thống khống chế|l
推本溯源=tìm nguyên nhân/truy đến tận gốc|l
掩护着=che chở lấy/che giấu|l
掩盖着=che giấu/che dấu|l
提神醒脑=đề thần tỉnh não|l
插不上=không nhúng vào|l
揭不开锅=đói/không có gì ăn/đói meo|l
揭老底=lộ tẩy/lộ nội tình|l
搞不懂=không hiểu rõ/không hiểu nổi|l
搞不清=không biết rõ/không làm rõ được|l
搞不清楚=không làm rõ ràng được|l
搞好关系=giữ gìn mối quan hệ|l
搞对象=yêu đương|l
搞小动作=giở trò|l
搞清楚=làm rõ ràng/làm rõ|l
搞砸=làm hỏng/làm hư|l
搬砖砸脚=gậy ông đập lưng ông/đến boomerang|l
搭便车=đi nhờ xe/đi quá giang|l
搭配着=phối hợp|l
摆排场=khoe khoang/phô trương hình thức/khoe mẽ|l
摆放着=trưng bày/bày đặt/để/bầy đặt|l
摆样子=làm ra vẻ/cố tình giả vờ|l
摆谱儿=chú trọng bề ngoài/phô trương hình thức/khoe mẽ|l
摆阔气=sống xa xỉ/phô bày không khí|l
摆龙门阵=nói chuyện phiếm/tán gẫu/chat/tán dóc/nói chuyện trên trời/bịa chuyện/chuyện tầm phào/nói huyên thuyên|l
摇摆不定=đung đưa không ngừng|l
摇着头=lắc đầu|l
摘下来=hái xuống|l
摸一摸=kiểm tra/sờ một cái|l
摸上去=sờ lên|l
摸不到=sờ không tới/không sờ tới|l
摸不清=không mò ra|l
摸不着=sờ không được/không sờ được|l
摸不着头脑=không nghĩ ra/bó tay/không tìm được manh mối|l
摸不透=đoán không ra|l
摸了摸=sờ sờ/sờ lên|l
摸出来=mò ra/móc ra|l
摸出烟来=lấy thuốc lá ra|l
摸得着=sờ được|l
摸得门清=mò đến rõ ràng/mạc đắc môn thanh|l
摸摸头=sờ đầu một cái|l
摸摸底=dò xét một chút/tìm hiểu một chút/nắm rõ một chút|l
摸来摸去=sờ tới sờ lui|l
摸清楚=thăm dò rõ ràng/mạc thanh sở|l
摸爬滚打=sờ soạng lần mò/mạc ba cổn đả|l
摸着石头过河=mò đá quá sông|l
摸门儿=tìm ra phương pháp/tìm ra giải pháp/tìm ra cách thức|l
摸黑儿=lò mò/làm việc trong đêm/làm đêm/mò mẫm|l
撑不下去=không chịu đựng nổi|l
撑杆跳=nhảy sào/giữ cần nhảy/sào huyệt|l
撑杆跳高=nhảy sào|l
撑眉努眼=nhướng mày trừng mắt|l
撑过去=chịu đựng được|l
撒手不干=khoanh tay đứng nhìn|l
撒手西归=nhắm mắt xuôi tay|l
撒酒疯=mượn rượu làm càn/nát rượu/say rượu|l
撕声裂肺=tê thanh liệt phế|l
撕天裂地=tê thiên liệt địa|l
撕心裂肺=tê tâm liệt phế/tan nát cõi lòng|l
撕破脸=vạch mặt/trở mặt|l
撕破脸皮=vạch mặt/không nể mặt mũi|l
撕筋=bong gân|l
操之过切=nóng vội/làm cho nó quá mức|l
操作台=bàn điều khiển/bàn làm việc/thao tác thai|l
操作系统=hệ điều hành/Operating system|l
操作规程=quy trình thao tác|l
操刀必割=cầm dao tất cắt|l
操纵台=bàn điều khiển/đài điều khiển|l
擒之=bắt lấy/tóm lại|l
擦一擦=lau một chút|l
擦不净=lau không sạch|l
擦不干=lau không khô|l
擦屁股=chùi đít/hốt cứt cho ai|l
擦来擦去=cọ qua cọ lại|l
擦肩而过=gặp thoáng qua|l
擦身而过=sượt qua người|l
擦黑儿=sẩm tối/sập tối/chạng vạng/nhá nhem tối/chập tối/lúc nhọ mặt người|l
攘外必先安内=diệt bên ngoài thì trước hết phải yên bên trong|l
攘臂=xắn tay áo|l
放一放=thả một chút|l
放下架子=bỏ lòng kiêu ngạo/phóng hạ giá tử|l
放任不管=bỏ mặc không quan tâm|l
放冷箭=bắn lén/bắn tên trộm/hại ngầm|l
放冷风=tung tin nhảm/gieo rắc luận điệu xấu|l
放在心上=để ở trong lòng|l
放在眼里=để vào mắt/để ở trong mắt|l
放声大哭=lớn tiếng khóc/khóc/để nói|l
放大器=máy khuếch đại/dụng cụ phóng to thu nhỏ/phóng đại khí|l
放大镜=kính lúp/kính phóng đại|l
放宽心=thoải mái tinh thần/buông lỏng tinh thần/rộng lượng|l
放射性元素=nguyên tố phóng xạ/nguyên tố có tính phóng xạ|l
放开手=buông tay ra|l
放心不下=không yên lòng|l
放暑假=được nghỉ hè|l
放暗箭=phóng ám tiễn/tập kích sau lưng|l
放热反应=phản ứng tỏa nhiệt|l
放狠话=nói dọa|l
放的下=bỏ được|l
放空枪=nói khoác|l
放空炮=nói suông/nói không không/lời nói trống rỗng|l
放赈=hàng cứu trợ/cứu trợ|l
放过来=phóng tới|l
放进来=bỏ vào đến/dẫn dụ đến|l
放长线钓大鱼=thả dây dài câu cá lớn/đặt dây dài câu cá lớn/dùng dây câu dài để câu được con cá lớn/một kế hoạch dài hạn cho lợi nhuận lớn|l
放马后炮=thả ngựa sau pháo|l
政治避难=tị nạn chính trị|l
故作姿态=giả bộ/làm ra vẻ|l
敌不动=địch không động|l
敌不过=đánh không lại|l
敌众我寡=địch nhiều ta ít|l
敌得过=địch nổi|l
敌我矛盾=mâu thuẫn địch ta|l
敌敌畏=thuốc trừ sâu DDVP|l
救下人来=cứu người ra|l
救下来=cứu được|l
救命之恩=ân cứu mạng|l
救命稻草=cây cỏ cứu mạng/nhánh cỏ cứu mạng|l
救回来=cứu trở về|l
救火队员=đội viên cứu hỏa|l
救过来=cứu lại|l
救难船=thuyền cứu nạn/tàu kéo/tàu cứu nạn|l
敢作敢为=dám nghĩ dám làm/cảm tác cảm vi|l
敢作敢当=dám làm dám chịu/mình làm mình chịu|l
敢做敢当=dám làm dám chịu|l
敢想敢干=dám nghĩ dám làm|l
敢想敢说=dám nghĩ dám nói|l
敢说话=dám nói chuyện|l
数不到=đếm không tới|l
数不多=số không nhiều/không nhiều|l
数不尽=vô số|l
数不清=đếm không hết/hằng hà/đếm không hết|l
数不甚数=đếm không hết|l
数不着=chưa thể kể đến/không đủ tiêu chuẩn/chưa đủ cỡ|l
数不胜数=nhiều vô số kể/sổ bất thắng sổ/vô số kể/nhiều đếm không xuể/đếm không xuể|l
数了数=đếm/đếm đếm|l
数以万计=đến hàng vạn mà tính/tính bằng đơn vị hàng nghìn/đến hàng mấy chục ngàn|l
数以亿计=hàng trăm triệu|l
数以十万计=số lượng hàng trăm ngàn|l
数以千计=lấy ngàn mà tính|l
数以百计=tính ra hàng trăm/hàng trăm .../số lượng hàng trăm|l
数得上=ít có|l
数得清=đếm rõ được|l
数得着=phải tính đến/phải kể đến/được tính là|l
数据恢复=phục hồi dữ liệu|l
数来数去=đếm tới đếm lui|l
数般=vài loại|l
数过来=đếm đi qua|l
敲一敲=gõ gõ|l
敲下去=đập xuống|l
整体实力=thực lực tổng hợp|l
整各=toàn bộ|l
整理出来=sửa sang lại|l
整装待发=chờ xuất phát/nai nịt gọn gàng chờ xuất phát|l
整齐划一=đều nhịp/chỉnh tề như một|l
整齐有序=chỉnh tề|l
文不加点=viết một hơi không ngừng/viết một hơi/viết một mạch/văn viết một mạch không sửa chữa dập xoá|l
文不对题=lạc đề/hỏi một đàng trả lời một nẻo|l
文件格式=loại văn bản|l
文字改革=cải cách văn tự/cải cách chữ viết|l
文景之治=Văn Cảnh chi trị|l
文武兼备=văn võ kiêm toàn|l
文艺复兴=văn hoá phục hưng|l
文艺批评=phê bình văn nghệ|l
文过饰非=che đậy lỗi lầm/che giấu khuyết điểm/lấp liếm sai lầm|l
文风不动=không chút động đậy/không nhúc nhích|l
断了腿=gãy chân|l
新专辑=album mới|l
新年好=chúc mừng năm mới|l
新年快乐=chúc mừng năm mới|l
新花样=trò mới/trò gian trá|l
旁系亲属=bàng hệ/anh em họ thuộc chi khác/bà con thân thích dòng bên/cùng họ khác chi|l
旖念=ý niệm|l
无一不备=không gì thiếu|l
无一不精=không gì không giỏi|l
无一不缺=không thiếu một cái|l
无一不能=không gì không thể|l
无一不通=không gì không biết|l
无一例外=đều không ngoại lệ|l
无中生友=vô trung sinh "hữu"|l
无主之地=nơi vô chủ|l
无主之物=vật vô chủ|l
无事不来=không có việc thì chẳng đến|l
无产阶级=giai cấp vô sản/vô sản|l
无人之境=chỗ không người|l
无人机=drone/máy bay không người lái|l
无人问津=không ai quan tâm/không ai hỏi/không quan tâm đến bất cứ ai|l
无从下手=không có chỗ xuống tay/không có đường nào/vô tòng hạ thủ|l
无他物=không có vật gì khác|l
无以复加=tột đỉnh/không hơn được nữa/vô dĩ phục gia|l
无价之宝=vô giới chi bảo/bảo vật vô giá|l
无休无止=không ngừng không nghỉ/vô hưu vô chỉ/không ngừng nghỉ|l
无休止=không ngừng nghỉ|l
无何=không bao lâu/chẳng bao lâu/chẳng mấy chốc/không có gì/không gì/không có việc gì khác|l
无儿无女=không có con cái|l
无公害=vô hại|l
无关紧要=râu ria/không quan trọng/vô quan khẩn yếu/không quá quan trọng|l
无冬之夜=vô đông chi dạ|l
无分彼此=không còn sự phân biệt|l
无利不起早=không thấy lợi không dậy sớm/không có lợi nhuận không thể sớm|l
无利可图=vô lợi khả đồ|l
无副作用=không tác dụng phụ/không có tác dụng phụ|l
无力回天=vô lực hồi thiên/không thể cứu vãn|l
无力感=cảm giác bất lực|l
无可挑剔=không thể bắt bẻ/hoàn hảo|l
无可避免=không thể tránh né/không thể tránh|l
无可限量=vô khả hạn lượng|l
无名肿毒=nhọt độc không tên|l
无后为大=vô hậu vi đại|l
无商不活=vô thương bất hoạt|l
无回剑=vô hồi kiếm|l
无坐力炮=pháo không giật/súng không giật|l
无声片=phim câm|l
无处不在=ở khắp mọi nơi/không chỗ nào không có/không chỗ nào không có mặt|l
无处可去=không chỗ để đi/không có nơi nào để đi/không có nơi để đi|l
无大无小=bất luận lớn hay nhỏ/bất kể lớn nhỏ|l
无始经=Vô Thủy Kinh|l
无始钟=Vô Thủy Chung|l
无字天书=Vô Tự Thiên Thư|l
无字辈=bối chữ Vô|l
无应答=không trả lời|l
无异于=không khác/không khác nào|l
无异议=không dị nghị/không có dị nghị|l
无形中=trong lúc vô hình/vô hình trung|l
无形之中=trong vô hình/vô hình trung|l
无形资产=tư sản vô hình|l
无心之过=tội vô tâm|l
无性生殖=sinh sản vô tính|l
无意之中=trong lúc vô tình|l
无意识=vô ý thức/không chủ định/không có ý thức|l
无意间=trong lúc vô tình|l
无愧于心=không thẹn lương tâm/không thẹn với lòng|l
无所不卖=bán hết mọi thứ|l
无所不在=đâu đâu cũng có/có mặt khắp nơi/không chỗ nào là không tồn tại|l
无所不用=vô sở bất dụng/làm tất cả mọi thứ|l
无所用心=không chú ý/không quan tâm điều gì/không chịu động não|l
无所谓=không quan trọng/không sao cả/không đáng kể/không thể nói là/không có gì đáng kể/không hề gì/không có vấn đề/không chỗ nào|l
无把握=không nắm chắc|l
无招无式=vô chiêu vô thức|l
无损伤=không tổn thương|l
无数具=vô số cổ|l
无数道=vô số đạo|l
无时不刻=không giây phút nào|l
无时无地=luôn luôn/lúc nào cũng|l
无期徒刑=ở tù chung thân/tù chung thân/tù không thời hạn|l
无本万利=không vốn vạn lời|l
无机化学=hoá học vô cơ|l
无条件=vô điều kiện/không điều kiện|l
无止境=không có tận cùng/không bờ bến/vô chỉ cảnh|l
无止无休=không ngừng không nghỉ|l
无毒不丈夫=vô độc bất trượng phu|l
无法可施=vô pháp khả thi|l
无法形容=không cách nào hình dung|l
无法忍受=không thể chịu đựng được/không cách nào nhịn được|l
无法无天=vô pháp vô thiên|l
无法说明=không cách nào nói rõ|l
无济于事=không làm nên chuyện gì/chẳng thấm vào đâu/vô tích sự/chẳng ăn thua gì/không giải quyết được vấn đề|l
无理取闹=cố tình gây sự|l
无理数=số vô nghĩa/số vô tỷ|l
无理要求=yêu cầu vô lý|l
无生气=không sức sống|l
无生道=Vô Sinh Đạo|l
无用功=không công|l
无用武之地=không có đất dụng võ/vô dụng vũ chi địa|l
无田无地=không ruộng không đất|l
无痕剑=Vô Ngân Kiếm|l
无痕式=Incognito|l
无痕无迹=không vết không tích|l
无痕迹=không đấu vết/không dấu vết|l
无眠之夜=đêm không ngủ|l
无线电台=điện đài vô tuyến/điện đài/radio vô tuyến|l
无线电波=sóng vô tuyến điện/sóng điện vô tuyến|l
无线电话=điện thoại vô tuyến|l
无线通信=thông tin vô tuyến|l
无能为力=bất lực/không tài nào/chịu bó tay/lực lượng không đủ/sức không đủ/không có sức/không thể phát triển được lực lượng/không thể ra sức|l
无能之辈=hạng người vô năng|l
无规律=không quy luật|l
无视于=không đếm xỉa đến|l
无论如何=vô luận như thế nào/bất kể như thế nào/dù thế nào/dù sao chăng nữa/dù như thế nào|l
无话不说=không chuyện gì không nói|l
无话可说=không lời nào để nói|l
无语了=hết chỗ nói rồi/bó tay rồi/hết ý kiến|l
无路可走=không đường có thể đi|l
无轨电车=xe điện không ray/xe điện bánh hơi/ô tô điện|l
无边无际=vô biên vô hạn|l
无遮大会=vô già đại hội|l
无量山=Vô Lượng sơn|l
无门无派=không môn không phái|l
无间断=không gián đoạn|l
无间道=vô gian đạo|l
无限大=vô cùng lớn/lớn vô hạn|l
无限小=vô cùng bé/vô cùng nhỏ/nhỏ vô hạn|l
无需多说=không cần nói nhiều|l
无风不起浪=không có lửa làm sao có khói/không có gió làm sao có sóng|l
无风险=không phong hiểm|l
日夜兼程=đi cả ngày lẫn đêm|l
早上好=buổi sáng tốt lành/buổi sáng khỏe/chào buổi sáng|l
早当家=sớm biết lo liệu việc nhà|l
旭日初升=mặt trời mới mọc/mặt trời mới mọc lơ lửng chân trời|l
旱涝保收=đảm bảo thu hoạch dù hạn hay lụt/cho dù thế nào đi nữa cũng đạt được kết quả như ý/hạn lạo bảo thu|l
时不再来=thời không đến lại/thời gian không trở lại/thời cơ không đến nữa|l
时好时坏=lúc tốt lúc xấu/lúc tốt lúc kém|l
时快时慢=lúc nhanh lúc chậm|l
时断时续=lúc đứt lúc nối/lúc liền lúc đứt|l
时日无多=ngày giờ không nhiều/không còn nhiều thời gian|l
时时刻刻=thời thời khắc khắc/tại mọi thời khắc|l
时有时无=khi có khi không/lúc có lúc không|l
时机成熟=thời cơ chín muồi|l
时来运转=thời lai vận chuyển|l
时至今日=cho đến ngày nay/Cho đến ngày nay|l
时起时伏=lúc nổi lúc hạ|l
时运不济=thời vận không đủ|l
时隔多年=đã cách nhiều năm|l
昂首挺胸=ngẩng đầu ưỡn ngực/ngẩng cao đầu, ưỡn ngực/để giữ vững tinh thần của một người|l
明摆着=rõ ràng/bày công khai/rành rành/sờ sờ/tỏ rõ|l
明暗不定=sáng tối chập chờn|l
明着说=nói rõ|l
昏头搭脑=đầu óc mê mẩn|l
昏头昏脑=đầu óc mê muội/bù đầu bù cổ/đầu óc mê mẩn/đầu óc choáng váng|l
昏昏欲睡=buồn ngủ/mệt mỏi muốn ngủ|l
昏死过去=ngất đi|l
昏过去=ngất đi/đã bất tỉnh|l
昏迷不醒=hôn mê bất tỉnh|l
昏镜重磨=thấy được ánh mặt trời|l
易容之术=thuật dịch dung|l
星火燎原=Tinh Hỏa Liêu Nguyên|l
映入眼帘=đập vào mi mắt|l
春山如笑=phong cảnh núi non mùa xuân tươi đẹp|l
春暖花开=xuân về hoa nở/ngày xuân ấm áp/thời cơ đã đến|l
春梦一场=một giấc chiêm bao|l
春蚕到死丝方尽=xuân tàm đáo tử ti phương tẫn|l
春风一度=xuân phong nhất độ|l
春风化雨=xuân phong hóa vũ|l
春风满面=rạng rỡ/lộng lẫy/mặt mày tươi tỉnh/mặt mày hớn hở|l
是不是=có phải là/là không phải/có phải hay không/có đúng hay không/phải hay là không/phải hay không|l
是可忍=có thể nhẫn nại|l
是否是=có phải là hay không/có phải là ... hay không|l
是想多=là nghĩ nhiều|l
是是非非=thị thị phi phi|l
是非不分=thị phi không phân/thị phi không phân biệt/không thể phân biệt đúng sai|l
是非之地=nơi thị phi/đất thị phi|l
是非之心=thị phi chi tâm|l
是非成败=thị phi thành bại|l
是非题=Thị Phi Đề|l
昼伏夜行=ngày nghỉ đêm đi|l
昼夜兼程=ngày đêm kiêm trình|l
显现出来=hiển hiện ra|l
暮色苍茫=hoàng hôn mờ mịt|l
暴虐无道=bạo ngược vô đạo/bạo tàn độc ác|l
更为重要=trọng yếu hơn/hơi trọng yếu hơn|l
更何况=huống chi|l
更名改姓=thay tên đổi họ/đổi tên và đổi họ|l
更待何时=chờ đến khi nào|l
更想家=càng nhớ nhà hơn|l
更想说=càng muốn nói hơn|l
更想问=càng muốn hỏi hơn|l
更新换代=đổi mới/thay đổi/bỏ cũ lấy mới|l
更是如此=càng là như vậy/càng phải như vậy|l
更深人静=đêm khuya thanh vắng|l
更深夜静=canh chầy/canh vắng|l
更盛烈=càng dữ dội|l
更美上=càng đẹp hơn hơn|l
更美如=càng đẹp như hơn|l
更进一步=tiến thêm một bước/càng tiến một bước/tiến hơn một bước|l
更高吭=càng giọng cao hơn|l
最佳时机=thời cơ tốt nhất|l
最后通牒=tối hậu thư/thông điệp cuối cùng|l
最大值=cực đại nhất/cực đại/cực độ/cực điểm|l
最想学=muốn học nhất|l
最想说=muốn nói nhất|l
最终目标=mục tiêu cuối cùng nhất/mục tiêu cuối cùng|l
最起码=tối thiểu nhất/tối thiểu|l
最高值=giá trị cao nhất|l
月满则亏=trăng tròn thì khuyết|l
有不世=có bất thế|l
有两下子=thật sự có tài/có bản lĩnh/khá đấy/tài đấy|l
有事没事=cũng không có việc gì|l
有产阶级=giai cấp tư sản|l
有件事=có chuyện|l
有价无市=có tiền mà không mua được/có tiền cũng không thể mua được|l
有价证券=chứng khoán có giá trị|l
有何不可=có gì không thể|l
有何意义=có ý nghĩa gì|l
有何指教=có gì chỉ giáo|l
有何见教=có gì chỉ giáo|l
有何贵干=có gì muốn làm/để làm gì|l
有借无还=có mượn không trả/có vay không trả|l
有借有还=có vay có trả|l
有先有后=có trước có sau|l
有其父必有其子=cha nào con nấy/con nhà tông không giống lông cũng giống cánh|l
有凭有据=có bằng có chứng/có bằng cớ|l
有利可图=có thể có lợi|l
有口难分=há miệng mắc quai/khó ăn khó nói/khó lòng giãi bày|l
有口难辩=khó lòng giãi bày|l
有史以来=từ trước tới nay|l
有吃有喝=có ăn có uống|l
有名气=có danh tiếng|l
有喜有忧=vừa buồn vừa vui|l
有声有色=sinh động/bóng bẩy|l
有备而来=có chuẩn bị mà đến|l
有大有小=có lớn có nhỏ|l
有头有脸=tai to mặt lớn/có uy tín danh dự/có máu mặt|l
有奶便是娘=ngã theo chiều gió/tham phú phụ bần|l
有妇之夫=người có vợ|l
有始无终=có đầu không có đuôi/đánh trống bỏ dùi/hữu thuỷ vô chung|l
有始有终=đến nơi đến chốn/có thuỷ có chung/hữu thuỷ hữu chung|l
有容乃大=hữu dung nãi đại|l
有山有水=có núi có nước/hữu sơn hữu thủy|l
有异火=có dị hỏa|l
有异象=có dị tượng/có cảnh tượng kì dị|l
有张有弛=có co có giãn|l
有得有失=có được có mất|l
有得色=có đắc ý sắc|l
有心力=có tâm lực|l
有快有慢=có nhanh có chậm|l
有性生殖=sinh sản hữu tính|l
有恒心=có bền lòng|l
有恙=có bệnh/có việc gì|l
有情有义=có tình có nghĩa|l
有意思=có ý tứ/có ý nghĩa/thú vị/hứng thú/có tình ỵ́/thú vị|l
有意识=có ý thức/có mục đích/có kế hoạch|l
有感而发=biểu lộ cảm xúc/hữu cảm nhi phát/hữu cảm nhi phát (*có cảm xúc nên phát ra)|l
有所不为=có việc không nên làm|l
有所不知=có chỗ không biết|l
有所为=có việc nên làm/có cái nên làm|l
有所作为=làm một số chuyện/tạo ra sự khác biệt|l
有所思=có chút suy nghĩ/có suy nghĩ|l
有才干=có tài cán|l
有把握=có nắm chắc/chắc chắn|l
有教无类=hữu giáo vô loại|l
有时候=có đôi khi/có lúc|l
有期徒刑=tù có thời hạn|l
有机体=cơ thể/sinh vật/thể hữu cơ|l
有机化学=hoá học hữu cơ|l
有机可乘=có cơ hội để lợi dụng được|l
有机合成=chất tổng hợp hữu cơ|l
有机物=chất hữu cơ|l
有机玻璃=thuỷ tinh hữu cơ/kính pha lê hữu cơ|l
有机肥料=phân bón hữu cơ|l
有机质=chất hữu cơ|l
有权有势=có quyền thế|l
有条有理=có trật tự/mạch lạc/rõ ràng/có tình có lý|l
有条理=có trật tự|l
有来无回=có đến mà không có về/chỉ có tới chớ không có lui/có đi mà không có về|l
有来有往=có qua có lại|l
有板有眼=có bài bản hẳn hoi/nói làm đâu ra đấy/chừng mực/có bài có bản|l
有样学样=học theo/bắt chước theo/có gì học nấy/hữu dạng học dạng/học theo răm rắp|l
有根有据=có căn có cứ|l
有模有样=ra dáng/hữu mô hữu dạng/hữu mô hữu dạng (*ra dáng)|l
有毒气体=thể khí có độc/khí độc/Hơi độc|l
有气无力=hữu khí vô lực/uể oải/yếu ớt/ỉu xìu|l
有气没力=hữu khí vô lực|l
有求于=muốn cầu cạnh|l
有求必应=hữu cầu tất ứng/cầu được ước thấy/cầu sao được vậy/xin gì được nấy/cầu gì được đó|l
有法可依=có pháp có thể theo|l
有滋有味=tư vị/có vị|l
有理式=biểu thức hữu tỷ|l
有理数=số hữu tỷ|l
有理有据=có lý có cứ/có lý có chứng cứ|l
有生之年=sinh thời|l
有生以来=từ lúc chào đời tới nay/từ khi lọt lòng tới nay/từ lúc sinh ra/từ xưa đến nay/từ lúc ra đời đến giờ/từ lúc sinh ra tới nay/từ lúc sinh ra tới nay|l
有生力量=sinh lực/quân đội|l
有男有女=có nam có nữ/nữ có nam có|l
有的是=có rất nhiều/có là/có khi là/cả đống|l
有益无害=có ích vô hại/hữu ích vô hại|l
有目共睹=rõ như ban ngày/hữu mục cộng đổ/rõ như ban ngày/quá rõ ràng|l
有目共赏=ai thấy cũng khen|l
有眼力=có nhãn lực/có nhãn lực|l
有神论=hữu thần luận/thuyết hữu thần|l
有线广播=truyền thanh/phát thanh hữu tuyến|l
有线电视=truyền hình cáp/Truyền hình hữu tuyến|l
有线电话=điện thoại hữu tuyến|l
有缘分=có duyên phận|l
有老有少=trẻ có già có|l
有胆儿=có gan|l
有色人种=người da màu/dân da màu|l
有色眼镜=thành kiến/cái nhìn phiến diện|l
有花雨=có mưa hoa|l
有血有肉=có máu có thịt/sinh động/sâu sắc|l
有言在先=đã nói trước/đã bảo trước|l
有识之士=hữu thức chi sĩ|l
有话好说=chuyện gì cũng từ từ|l
有话要说=có lời muốn nói|l
有话要问=có lời muốn hỏi|l
有话说=có lời nói/có lời|l
有说有笑=cười cười nói nói/hữu thuyết hữu tiếu/vừa nói vừa cười|l
有起有伏=có lên có xuống|l
有趣儿=thú vị|l
有轨电车=tàu điện/xe điện/Tàu điện|l
有过之=có phần hơn|l
有进无退=chỉ có tiến không có lùi|l
有道是=có câu nói là|l
有鉴于此=vì thế|l
有门儿=có hi vọng/có cách|l
有问必答=hỏi gì đáp nấy/hữu vấn tất đáp|l
有限责任=trách nhiệm hữu hạn/Trách nhiệm hữu hạn|l
有难同当=có nạn cùng chịu|l
有难有易=có khó có dễ|l
有高有低=cao có thấp có/có cao có thấp|l
有鼻子有眼儿=nghe cứ như thật/có căn cứ hẳn hoi/có mắt có mũi hẳn hoi|l
望其项背=nhìn theo bóng lưng|l
未完结=chưa kết thúc|l
未成年=vị thành niên/chưa trưởng thành/chưa đến tuổi trưởng thành|l
未成年人=trẻ vị thành niên/chưa thành nhân/người chưa đến tuổi trưởng thành/người chưa thành niên|l
未找到=không tìm được|l
末日来临=tận thế hàng lâm/ngày tận thế tới|l
末梢神经=đầu mút dây thần kinh|l
机不可失=tận dụng thời cơ/cơ hội không thể mất/thời cơ không thể mất|l
机会难得=cơ hội khó được/cơ hội hiếm có|l
机关用尽=nghĩ nát óc/các cơ quan đã cạn kiệt|l
机关算尽=tính toán xảo diệu|l
机变如神=tính toán như thần/máy biến thành thần|l
机器翻译=phiên dịch bằng máy/dịch máy|l
机械运动=chuyển động cơ giới/chuyển động máy móc|l
杀人蜂=Sát Nhân Phong|l
杀出重围=giết ra khỏi trùng vây|l
杀回马枪=giết hồi mã thương|l
杀毒软件=phần mềm diệt virus|l
杀菌作用=sự sát trùng|l
杀过来=giết tới|l
杖刑=trượng hình/hình phạt đánh bằng gậy|l
杜鹃啼血=tiếng than đỗ quyên|l
条件刺激=kích thích phản xạ có điều kiện|l
条件反射=phản xạ có điều kiện|l
条分缕析=phân tích cặn kẽ/phân tích tỉ mỉ/phân tích từng ly từng tý|l
来复枪=súng trường/nòng súng có khương tuyến|l
来头不小=lai lịch không nhỏ|l
柔声道=ôn nhu nói|l
柔声问=ôn nhu hỏi|l
柔肠百结=ruột mềm trăm mối|l
柔软体操=thể thao dẻo dai/thể dục mềm dẻo|l
查无实据=điều tra nhưng không tìm được chứng cứ|l
柳如是=Liễu Như Thị|l
柳暗花明又一村=liễu ám hoa minh hựu nhất thôn|l
柴田胜家=Shibata Katsuie|l
树倒猢狲散=tan đàn xẻ nghé/cây đổ bầy khỉ tan/xẻ đàn tan nghé/thầy bại thì tớ cụp đuôi|l
核反应=phản ứng hạt nhân/phản ứng nguyên tử|l
核反应堆=lò phản ứng hạt nhân|l
核心人物=nhân vật trọng yếu|l
核打击=nổ hạt nhân|l
核磁共振=cộng hưởng từ hạt nhân/NMR/cộng hưởng từ|l
栽下来=ngã xuống|l
栽不活=không trồng được|l
栽跟头=thất bại/bị té nhào/lùi bước/té ngã/té nhào/thua/bị một vố đau/tài cân đầu|l
植物性神经=thần kinh thực vật|l
植物纤维=sợi thực vật|l
植物群落=quần thể thực vật|l
楔形文字=văn tự hình chêm|l
概不=tổng thể không|l
概莫能外=không có ngoại lệ|l
榜上无名=bảng thượng vô danh/rớt/không có tên trên bảng|l
模糊不清=mơ hồ không rõ/mơ hồ/mờ theo tuổi tác|l
模糊起来=bắt đầu mơ hồ/mơ hồ|l
横下心来=quyết tâm/hoành hạ tâm lai|l
横拖倒拽=dốc hết sức/kéo ngang và kéo xuống|l
横椎=quét ngang|l
横躺竖卧=nằm ngang nằm dọc|l
橡皮擦=cục tẩy|l
欠债还钱=thiếu nợ thì trả tiền|l
欢呼雀跃=nhảy cẫng hoan hô|l
欢喜冤家=hoan hỉ oan gia|l
欢迎仪式=nghi thức hoan nghênh|l
欢迎会=hoan nghênh hội|l
欢迎您=chào mừng ngài|l
欲噬=muốn nuốt|l
欲扬先抑=chê trước khen sau/muốn dương trước|l
欲言又止=muốn nói lại thôi|l
欲语还休=muốn nói lại thôi/dục ngữ còn hưu|l
欲说还休=muốn nói lại thôi/muốn nói còn hưu|l
欺上瞒下=lừa trên gạt dưới/dối trên gạt dưới|l
止回阀=van một chiều/van một chiều hoặc chõ|l
止步不前=dừng bước không tiến/dừng lại|l
正中下怀=gãi đúng chỗ ngứa/đúng với ý nguyện/trúng tim đen|l
正中要害=chính giữa yếu hại/đánh đinh vào đầu|l
正则表达式=biểu thức chính quy|l
正合我意=chính hợp ý ta|l
正对着=chính đối|l
正当理由=lý do chính đáng/lý do chính đáng|l
正当防卫=phòng vệ chính đáng/tự vệ|l
正忙着=đang bận|l
正是如此=đúng là như thế/đúng là như vậy|l
正科级=chính khoa cấp/chính khoa cấp|l
正经起来=nghiêm chỉnh lại/chính kinh|l
正面人物=nhân vật chính diện|l
此时此刻=giờ này khắc này/vào giờ phút này|l
步履维艰=đi đứng khó khăn/đi bộ khó khăn/đi lại khó khăn|l
步步为营=thận trọng từng bước/thận trọng/phòng thủ nghiêm ngặt/đánh bước nào, củng cố bước ấy/tiến bước nào, rào bước ấy/ăn cây nào, rào cây đó|l
武侠小说=tiểu thuyết võ hiệp|l
武器专家=chuyên gia vũ khí|l
武打片=phim võ thuật/võ đánh phim/phim hành động|l
武昌起义=khởi nghĩa Vũ Xương|l
武经总要=Võ Kinh Tổng Yếu|l
武装人员=nhân viên có vũ trang|l
武装到牙齿=trang bị đến tận răng|l
武装力量=lực lượng vũ trang/lực lượng võ trang|l
武装警察=cảnh sát võ trang|l
武装部长=võ trang bộ trưởng|l
武道家=võ đạo gia|l
死不了=không chết được/không thể chết/tôi không thể chết/Portulaca Sundial|l
死不改悔=chết không hối cải|l
死不认账=chết không nhận|l
死也不放=tử cũng không buông|l
死去活来=chết đi sống lại|l
死定了=chết chắc rồi/chết chắc|l
死就死=chết thì chết|l
死心眼儿=cố chấp/bảo thủ/người cố chấp/người bảo thủ|l
死有余辜=chết chưa hết tội/chết chưa đền hết tội|l
死猪不怕开水烫=lợn chết không sợ bỏng nước sôi|l
死罪可免=tội chết có thể miễn|l
死胡同=ngõ cụt|l
死记硬背=học bằng cách nhớ|l
死路一条=một con đường chết/chỉ còn đường chết|l
殊死搏斗=quyết tử đấu tranh|l
残羹冷饭=cơm thừa canh cặn|l
毋庸置疑=không thể nghi ngờ|l
每一寸=mỗi một tấc|l
每一式=mỗi một thức|l
每况愈下=ngày càng sa sút/ngày càng xuống cấp/ngày càng xấu đi|l
每周五=mỗi thứ sáu|l
每周六=mỗi thứ bảy|l
每家每户=từng nhà/nhà nhà|l
每时每刻=mỗi thời mỗi khắc|l
比下有余=so với bên dưới có thừa|l
比不上=so ra kém/thua kém/thua sút/không sánh được|l
比之不上=không sánh bằng|l
比人多=so nhiều người|l
比众不同=không giống mọi người|l
比例失调=thiếu cân đối/thiếu cân xứng/không cân đối|l
比例尺=tỉ lệ xích/bản tỉ lệ/thước tỉ lệ|l
比如说=tỉ như nói/nói thí dụ như|l
比我强=so với ta mạnh hơn/mạnh hơn ta|l
比手划脚=múa tay múa chân/bỉ thủ hoa cước|l
比方说=nói ví dụ/nói cách khác|l
比来比去=so tới so lui|l
比比划划=khoa tay múa chân|l
比比皆是=chỗ nào cũng có/khắp nơi/đâu đâu/nơi nơi|l
比的上=sánh được|l
比目鱼=cá thờn bơn/cá lờn bơn/tên thông dụng của cá bơn/cá tháp/cá bình|l
比肩而立=kề vai sát cánh/kề vai|l
比试一下=tỷ thí một chút|l
比较忙=tương đối bận rộn/khá bận|l
比较慢=tương đối chậm|l
比较满意=tương đối hài lòng|l
比较简单=tương đối đơn giản|l
比较语言学=ngôn ngữ học so sánh|l
比高下=so cao thấp|l
毫不介意=không ngần ngại chút nào|l
毫不关心=không quan tâm chút nào/không hề quan tâm|l
毫不利己=không có lợi cho bản thân chút nào|l
毫不在乎=không thèm quan tâm/không cần thiết chút nào|l
毫不在意=không thèm để ý chút nào/không để ý chút nào|l
毫不客气=không chút khách khí|l
毫不容情=không dung tình chút nào|l
毫不放松=không hề buông lỏng/không buông lỏng chút nào|l
毫不犹豫=không chút do dự|l
毫不理会=không chút nào để ý/không để ý chút nào|l
毫不留情=không lưu tình chút nào/không chút lưu tình|l
毫不相关=không quan hệ chút nào|l
毫不相干=không hề liên quan/không liên quan|l
毫不费力=không tốn sức chút nào|l
毫不迟疑=không chút do dự/không chậm trễ chút nào|l
毫不退缩=không thối lui chút nào|l
毫不退让=không hề nhượng bộ chút nào/không nhường chút nào/không lùi một phân|l
毫不逊色=không chút thua kém/không kém chút nào|l
毫发未伤=không mất một sợi lông|l
毫无二致=giống như đúc/hoàn toàn giống nhau/giống hệt|l
毫无价值=không có chút giá trị|l
毫无作用=không hề có tác dụng|l
毫无例外=không ngoài dự tính|l
毫无关系=không hề quan hệ|l
毫无办法=không có biện pháp/không có biện pháp chút nào|l
毫无动静=không hề có động tĩnh gì/không có động tĩnh gì|l
毫无意义=không có chút ý nghĩa nào|l
毫无把握=không nắm chắc chút nào|l
毫无效果=không có hiệu quả chút nào|l
毫无用处=không dùng được/không chỗ dùng chút nào|l
毫无疑义=không chút nghi ngờ/không có nghi ngờ|l
毫无疑问=không hề nghi ngờ/không nghi ngờ chút nào|l
毫无知觉=không hề hay biết/không cảm giác chút nào|l
毫无结果=không có kết quả gì|l
毫无道理=không hề có đạo lý/không đạo lý chút nào|l
毫无顾忌=không hề cố kỵ/không cố kỵ chút nào/không kiêng dè chút nào|l
民主改革=cải cách dân chủ|l
民事诉讼=tố tụng dân sự|l
民以食为天=dân dĩ thực vi thiên|l
民族形式=hình thức dân tộc|l
民族自决=dân tộc tự quyết/quyền dân tộc tự quyết|l
民用建筑=kiến trúc dân dụng/xây dựng dân dụng|l
民间传说=truyền thuyết dân gian/văn hóa dân gian|l
气不过=giận|l
水上飞机=thuỷ phi cơ/máy bay có thể hạ cánh trên mặt nước|l
水利枢纽=trung khu thuỷ lợi|l
水土不服=không quen khí hậu|l
水如心=Thủy Như Tâm|l
水平如镜=nước phẳng như gương|l
水愈术=Thủy Dũ Thuật|l
水泼不进=nước tát không lọt|l
水淹七军=nước dìm bảy đạo quân|l
水清无鱼=nước trong không có cá/một người quá nặng không có bạn|l
水满则溢=nước đầy thì tràn|l
水火不容=thủy hỏa bất dung/nước lửa bất dung/như nước với lửa|l
水火之中=trong nước lửa|l
水至清则无鱼=nước quá trong ắt không có cá/người quá xét nét hẳn chẳng có ai chơi|l
水蛇腰=thân hình như thủy xà/thân hình như rắn nước|l
水调歌头=Thủy Điều Ca Đầu|l
永无休止=vĩnh viễn không ngừng nghỉ/vĩnh không ngừng nghỉ/không bao giờ ngừng nghỉ/không ngừng không nghỉ|l
永无止境=vĩnh vô chỉ cảnh/vĩnh viễn không có điểm dừng|l
永结同心=vĩnh kết đồng tâm/vĩnh viễn kết đồng tâm|l
求之不来=cầu còn không được|l
求全责备=yêu cầu cao/yêu cầu cực cao/đòi hỏi trọn vẹn|l
沉沉入睡=chìm vào giấc ngủ|l
沉浸于=đắm chìm ở|l
沉着脸=trầm mặt|l
沉迷于=trầm mê ở|l
沉醉于=say đắm ở|l
沉默是金=im lặng là vàng|l
没上没下=không có trên không có dưới|l
没上过学=chưa từng đi học|l
没下顿=không có bữa sau|l
没了断=không kết thúc|l
没事人=người không việc gì/người không liên quan/người không có sao|l
没事儿=không có chuyện/không có chuyện gì|l
没事干=không có việc làm/không có chuyện làm/không có chuyện gì|l
没事找事=ở không đi gây sự|l
没亲没故=không thân không thích|l
没人中=không người trong|l
没人云=không người nói|l
没人会管=không ai sẽ quan tâm|l
没人住=không người ở|l
没人劝=không người khuyên|l
没人多=không nhiều người|l
没人好=không người tốt|l
没人妻=không nhân thê|l
没人少=không ít người|l
没人干=không ai làm|l
没人开=không ai mở/không ai lái|l
没人摸=không người sờ vuốt|l
没人放=không người thả|l
没人敢=không ai dám|l
没人敢问=không ai dám hỏi|l
没人时=khi không có ai|l
没人是=không người là|l
没人样=không hình người|l
没人爱=không người yêu/không nhân ái|l
没人疼=không người thương|l
没人笑=không người cười|l
没人脉=không có nhân mạch/không có người quen|l
没人要=không ai muốn|l
没人话=không tiếng người|l
没什么=không có gì/không sao/không việc gì/không hề gì|l
没什好说=không có gì để nói|l
没关到=không nhốt vào|l
没关好=không đóng kỹ|l
没关死=không đóng lại|l
没关系=không quan hệ/không sao/không có sao/không việc gì/đừng ngại/không liên quan|l
没准儿=không chừng/không chắc|l
没准头=không chính xác|l
没出息=không có tiền đồ/Không tiến lên/chẳng nên thân/vô hi vọng/không ra gì. ◇Hồng Lâu Mộng 紅樓夢: Giá khả hựu thị hồ thuyết/tựu toán nhĩ thị cá một xuất tức đích/chung lão tại giá lí/nan đạo tha tỉ muội môn đô bất xuất môn đích 這可又是胡說/就算你是個沒出息的/終老在這裡/難道他姊妹們都不出門的|l
没动不=không không động đậy|l
没动换=không hoạt động|l
没动静=không có động tĩnh|l
没变丑=không biến dạng|l
没吃上=không ăn|l
没吃到=không ăn được|l
没吃多=không ăn nhiều|l
没吃好=không ăn được|l
没吃没穿=không đủ ăn mặc|l
没吃过=chưa ăn qua/chưa từng ăn|l
没名没分=không danh không phận|l
没听说过=chưa nghe nói qua/chưa từng nghe nói|l
没吭=không có lên tiếng|l
没在响=không đang vang lên|l
没在干=không đang làm|l
没在理=không có lý|l
没多上=không nhiều hơn|l
没多久=không bao lâu|l
没多喝=không uống nhiều|l
没多好=không thật tốt|l
没多活=không sống thêm|l
没多瞧=không nhìn lâu|l
没多管=không quản thêm/không nhiều nòng|l
没多耗=không tiêu hao thêm|l
没多花=không dùng nhiều|l
没多言=không nhiều lời|l
没多话=không nói nhiều|l
没多说=không nhiều lời|l
没多费=không tốn nhiều|l
没多远=không bao xa|l
没多问=không hỏi nhiều|l
没大没小=không biết lớn nhỏ/không lớn không nhỏ/xấc láo/không biết lớn nhỏ/không biết người trên kẻ dưới|l
没头没尾=không đầu không đuôi|l
没头没脑=không đầu không đuôi|l
没奈何=không làm sao được/không còn cách nào/hết cách/đành chịu|l
没好气=không cao hứng/tức giận|l
没完没了=không ngừng không nghỉ|l
没少喝=không ít uống/không uống ít|l
没少用=không dùng một phần nhỏ|l
没工夫=không có rảnh|l
没干么=không làm chi|l
没影儿=không còn hình bóng|l
没得治=không chữa được|l
没得说=không thể chê|l
没心没肝=không tâm không phổi|l
没心没肺=không tim không phổi|l
没心肝=không tâm can|l
没想争=không muốn tranh|l
没想以=không muốn lấy|l
没想伤=không muốn thương tổn|l
没想到=không nghĩ tới|l
没想去=không muốn đi|l
没想吃=không muốn ăn|l
没想哭=không muốn khóc|l
没想头=không ý nghĩ|l
没想好=chưa nghĩ ra|l
没想娶=không muốn kết hôn|l
没想学=không muốn học|l
没想害=không muốn hại|l
没想家=không nhớ nhà|l
没想干=không muốn làm|l
没想当=không muốn làm|l
没想成=không muốn trở thành|l
没想打=không muốn đánh|l
没想抓=không muốn bắt|l
没想歪=không hiểu sai|l
没想死=không muốn chết|l
没想比=không muốn so sánh với|l
没想泡=không muốn tán tỉnh|l
没想清=không hiểu rõ|l
没想用=không muốn dùng|l
没想看=không muốn nhìn|l
没想睡=không muốn ngủ|l
没想笑=không muốn cười|l
没想说=không muốn nói|l
没想走=không còn muốn chạy|l
没想躲=không muốn tránh|l
没想过=không nghĩ tới|l
没想通=không nghĩ thông suốt|l
没想道=không thầm nghĩ|l
没想问=không muốn hỏi|l
没意思=không có ý nghĩa/vô vị|l
没成想=không có nghĩ rằng/không ao ước|l
没教养=không có giáo dục|l
没教过=không dạy qua/đã không dạy|l
没敢上=không dám lên|l
没敢以=không dám lấy|l
没敢到=không dám đến|l
没敢去=không dám đi|l
没敢寻=không dám tìm|l
没敢提=không dám nhắc tới|l
没敢来=không dám đến|l
没敢笑=không dám cười|l
没敢问=không dám hỏi|l
没数过=không có đếm|l
没日没夜=không biết ngày đêm/không ngày không đêm|l
没有止境=vô bờ bến|l
没有规矩=không có quy củ|l
没有话说=không có lời gì để nói|l
没权没势=không quyền không thế|l
没来头=không lai lịch|l
没来晚=không tới chậm|l
没来由=không khỏi/không lý do|l
没毒舌=không ác miệng|l
没毛儿=không Mao nhi|l
没法儿=không có cách nào|l
没法子=không có cách nào|l
没父没母=không cha không mẹ|l
没理由=không có lý do|l
没用到=không dùng đến|l
没用过=chưa bao giờ dùng qua/chưa dùng qua/chưa từng dùng|l
没由来=không có căn nguyên|l
没白来=không uổng công|l
没的比=không so được|l
没的说=không thể nói|l
没皮没脸=không cần mặt mũi/mất mặt mũi|l
没看懂=nhìn không hiểu|l
没石=ngập đá|l
没租到=không mướn được|l
没等上=không chờ thêm|l
没等下=không chờ sau đó|l
没等会=không đợi lát nữa|l
没等干=không tương đương|l
没等得=không chờ đến|l
没等车=không chờ xe|l
没胆上=không dám lên|l
没能忍=không có thể chịu|l
没能用=không có thể sử dụng|l
没脸没皮=không cần mặt mũi|l
没良心=không có lương tâm|l
没花上=không tiêu tốn|l
没见识=không kiến thức/không có kiến thức|l
没词儿=không có gì để nói|l
没话可说=không thể nói được gì|l
没话找话=một thoại hoa thoại|l
没话说=không lời nói/không phản đối|l
没说的=thật tốt/chưa nói/không vấn đề gì|l
没谱儿=chưa nghĩ tới/không có chủ định/không có kế hoạch|l
没轻没重=không nhẹ không nặng|l
没边儿=vô biên|l
没过多久=cũng không lâu lắm|l
没这回事=không có chuyện đó|l
没追上=không đuổi kịp|l
没门儿=không có cửa đâu/không có lối thoát/bế tắc/không được|l
没问到=không hỏi|l
没面子=thật mất mặt|l
没饱=không có no|l
没骨气=không có cốt khí/Không có khí chất|l
油光满面=đầy mặt bóng loáng/mặt bóng lưỡng/dầu đầy mặt|l
油料作物=cây hạt dầu/cây có hạt ép dầu|l
治一治=trị một chút|l
治外法权=quyền bất khả xâm phạm/trị ngoại pháp quyền/quyền đứng ngoài pháp luật|l
治愈术=Trì Dũ Thuật/trì dũ thuật/{Trì Dũ Thuật}|l
治标不治本=trị ngọn không trị gốc|l
沾染上=nhiễm phải|l
泄私愤=tiết tư phẫn|l
泛泛之交=quen biết hời hợt|l
泛泛而谈=nói sơ lược/nói qua loa/bàn qua/tạm bàn|l
泡起来=ngâm/cua|l
波光粼粼=sóng nước lấp loáng|l
波浪鼓=trống bỏi|l
波涛起伏=sóng lớn nhấp nhô|l
波澜不惊=không có chút rung động nào|l
波澜起伏=nổi sóng chập trùng/tình tiết phức tạp/bốn bề sóng dậy/lắt léo|l
泪如雨下=nước mắt rơi như mưa|l
泪流满面=lệ rơi đầy mặt|l
洋溢着=tràn đầy|l
洒下来=rơi xuống dưới|l
洒水机=máy tưới nước|l
洒水车=xe phun nước|l
洒然一笑=bật cười lớn|l
洒狗血=diễn cương quá mức|l
洒红节=lễ Holi|l
洗不清=tẩy không sạch|l
洗尽铅华=tẩy tận duyên hoa/rửa sạch chì/xóa bỏ hết những trang điểm bên ngoài/trở về với bản chất thực.|l
洗脸盆=bồn rửa mặt|l
活下去=sống sót/sống tiếp|l
活不下去=sống không nổi|l
活不了=sống không được/không sống được/không sống nổi|l
活久见=sống lâu cái gì cũng có thể thấy/sống lâu/nếu bạn sống đủ lâu, bạn sẽ thấy mọi thứ|l
活人无数=cứu người vô số|l
活到老=sống đến già|l
活动中心=trung tâm hoạt động|l
活动状态=trạng thái hoạt động|l
活受罪=khổ thân/nhục nhã/chịu tội sống/khổ thân mình/mang phải vạ|l
活多久=sống bao lâu|l
活字印刷=in chữ rời/in tô-pi|l
活学活用=hoạt học hoạt dụng|l
活期存款=tiền gửi ngân hàng lấy không phải báo trước/tiền gửi ngân hàng|l
活泼可爱=hoạt bát đáng yêu|l
活腻了=chán sống|l
活跃分子=thành viên tích cực/người hoạt bát|l
活跃度=độ sinh động/hoạt động|l
活蹦乱跳=nhảy nhót tưng bừng/vui vẻ/vui sướng|l
活过来=sống tới/sống lại|l
流下去=chảy đi xuống|l
流下来=chảy xuống|l
流下泪来=nước mắt chảy ròng/nước mắt chảy xuống|l
流传于世=truyền lưu thế gian|l
流体力学=thuỷ động học|l
流光溢彩=tỏa ra ánh sáng lung linh|l
流动资产=tài sản lưu động|l
流大汗=đổ mồ hôi|l
流干了=chảy khô|l
流年不利=thời giờ bất lợi|l
流着泪=chảy nước mắt|l
流窜犯=tội phạm/tội phạm nói chung|l
流连忘返=lưu luyến quên về|l
浃髓沦肌=ngấm vào xương tủy|l
浑然一体=liền thành một khối/một khối/trọn vẹn một khối|l
浑身上下=toàn thân trên dưới/toàn thân/cả người/khắp người/khắp toàn thân|l
浑身是汗=toàn thân đầy mồ hôi|l
浑身解数=tất cả vốn liếng|l
浓墨重彩=nổi bật|l
浪子回头=lãng tử hồi đầu|l
浪子回头金不换=con hư biết nghĩ lại quý hơn vàng/biết nhận lỗi là tốt rồi|l
浪打浪=sóng đánh sóng|l
浪漫爱情=tình yêu lãng mạn|l
浪翻云=Lãng Phiên Vân|l
浮一大白=uống cạn một chén lớn|l
浮上来=nổi lên|l
浮想联翩=miên man bất định/mơ tưởng viển vông/mơ tưởng viển vông|l
浮游生物=sinh vật phù du/sinh vật trôi nổi|l
浮皮潦草=qua loa/cẩu thả/lơ là|l
海外关系=quan hệ bà con, bạn bè ở nước ngoài|l
海洋性气候=khí hậu biển|l
海浪般=như sóng biển|l
消了毒=khử độc|l
消化不良=tiêu hóa không tốt|l
消化系统=hệ tiêu hoá|l
消声器=dụng cụ giảm thanh/ống hãm thanh|l
消完毒=khử hết độc|l
消彼长=tiêu bỉ trường|l
消极怠工=tiêu cực lãn công/tiêu cực nhàn rỗi|l
消泯=tiêu diệt|l
消耗掉=tiêu hao hết|l
消过毒=đã khử trùng|l
消遥自在=tiêu dao tự tại|l
淡不上=không có|l
深呼吸=hít sâu/thở sâu/hít thở sâu|l
深爱着=yêu tha thiết|l
混上来=hỗn đi lên|l
混下去=lẫn vào/lăn lộn tiếp/tiếp tục sống|l
混不下去=lăn lộn ngoài đời không nổi/không sống được nữa|l
混混儿=lưu manh/vô lại/côn đồ|l
混过去=hỗn qua|l
混饭吃=kiếm cơm|l
添麻烦=thêm phiền toái/gây rắc rối cho ai đó|l
清了清=dọn dẹp|l
清晰可见=có thể thấy rõ ràng|l
清者自清=thanh giả tự thanh|l
清补凉=sâm bổ lượng/thanh bổ mát mẻ/ching bo leung, một món súp tráng miệng ngọt ngào, lạnh giá|l
清规戒律=thanh quy giới luật/quy tắc/luật lệ|l
清醒过来=tỉnh táo lại/tỉnh lại|l
清风徐来=thanh phong từ lai/gió mát từ từ đến|l
游来游去=bơi qua bơi lại|l
游过去=đi qua|l
游过来=bơi tới/lội tới|l
溢于言表=lộ rõ trên mặt/ dật vu ngôn biểu/dật vu ngôn biểu/tình cảm bộc lộ trong lời nói/dật vu ngôn biểu (*tình cảm bộc lộ trong lời nói)|l
溢美之词=lời ca tụng|l
滑下去=tuột xuống|l
滑不溜手=hoạt bất lưu thủ|l
滑天下之大稽=làm trò cười cho thiên hạ|l
滚一滚=lăn lăn/cổn nhất cổn|l
滚出去=lăn ra ngoài/cút ra ngoài/cút ra ngoài|l
滚出来=cút ra đây/lăn ra đến/lăn ra đây|l
滚动轴承=ổ trục bi|l
滚回去=cút về|l
滚回来=cút trở về|l
滚瓜溜圆=béo tròn béo trục/béo tròn trùng trục/mập núc ních|l
滚起来=lăn lên|l
满地找牙=răng rơi đầy đất|l
满天下=khắp thiên hạ|l
满打满算=tính toán đâu ra đấy/tính đâu ra đấy/mãn đả mãn toán|l
满汉全席=mãn hán toàn tịch/mãn hán toàn tiệc/một bữa tiệc thịnh soạn|l
满肚子=đầy mình/đầy bụng|l
满脑子=đầy trong đầu/đầy đầu|l
满身是汗=cả người mồ hôi|l
滥好人=lạm người tốt|l
滥杀无辜=lạm sát kẻ vô tội|l
滴水之恩=tích thủy chi ân|l
漠不关心=thờ ơ/không quan tâm/không hề quan tâm|l
漫反射=tán xạ/tung toé/sự phản chiếu khuếch tán|l
潮水般=như thủy triều/như nước thủy triều|l
潮涨潮落=thủy triều lên xuống/thuỷ triều lên xuống/nước ròng nước lớn|l
潮起潮落=thủy triều lên xuống/sóng lên sóng xuống|l
激光打印机=máy in laser|l
激动不已=kích động không thôi|l
激发起=kích thích lên|l
激发起来=kích thích|l
激流勇退=thấy nước xiết liền lui|l
灌进来=thổi vào|l
火伞高张=nắng như thiêu đốt/ô lửa cao|l
火头上=đang tức giận/lúc nổi nóng/đang trong cơn tức giận|l
火灭烟消=tan thành mây khói|l
灿然一新=nhìn mới toanh|l
点到为止=điểm đến là dừng|l
点头哈腰=cúi đầu khom lưng/luôn mồm vâng dạ/cúi người gật đầu|l
点头称是=gật đầu nói phải/gật đầu tán thành|l
烧不动=đốt không nổi|l
烧成灰=đốt thành tro|l
烧杀抢掠=cướp bóc đốt giết|l
热情洋溢=đầy nhiệt tình|l
热核反应=phản ứng nhiệt hạch/phản ứng hạt nhân|l
热核武器=bom khinh khí/vũ khí nhiệt hạch/vũ khí hạt nhân|l
热泪盈眶=lệ nóng doanh tròng|l
热胀冷缩=nóng nở ra lạnh co lại|l
热血男儿=nam nhi nhiệt huyết|l
热身运动=vận động nóng người|l
热锅上的蚂蚁=kiến bò trên chảo nóng/con kiến trên chảo nóng|l
热闹非凡=phi thường náo nhiệt|l
煞是好看=trông rất đẹp mắt|l
煞有介事=làm như có thật/ăn không nói có|l
煞血=sát huyết|l
煞费苦心=nhọc lòng/hao tổn tâm huyết|l
煞风景=làm mất vui/để làm hỏng niềm vui|l
煽风点火=châm ngòi thổi gió/xúi bẩy gây chuyện/châm dầu vào lửa/lửa cháy đổ thêm dầu/quạt gió thổi lửa|l
熔于一炉=hòa vào một lò|l
燎原之火=lửa cháy lan đồng/ngọn lửa cháy|l
爬上爬下=leo lên leo xuống|l
爬下来=leo xuống|l
爬不起来=không đứng dậy được/không bò dậy nổi|l
爬来爬去=bò qua bò lại/bò tới bò lui|l
爬起来=bò lên/đứng lên/bò dậy|l
爱不爱=yêu hay không yêu/có yêu hay không|l
爱情小说=tiểu thuyết tình yêu|l
爱民如子=yêu dân như con|l
爱理不理=xa cách/khó gần/không cởi mở/ái lý bất lý|l
爱管闲事=thích xen vào chuyện của người khác/thích quản việc đâu đâu|l
爱说笑=thích nói giỡn|l
父之过=lỗi của cha|l
父债子还=phụ trái tử hoàn/nợ cha con trả|l
父慈子孝=phụ từ tử hiếu|l
父母双亡=phụ mẫu đều mất|l
牙痒痒=nghiến răng/nha dương dương|l
物以稀为贵=vật hiếm thì quý|l
物以群分=vật phân theo bầy|l
物价指数=chỉ số vật giá/chỉ số giá hàng|l
物尽其用=vật tận kỳ dụng/dùng hết tác dụng của nó/xài cho đúng tác dụng/vật tận kỳ dụng (*xài cho đúng tác dụng)|l
物是人非=cảnh còn người mất/người và vật không còn|l
物有所值=đáng giá|l
物极必反=vật cực tất phản/già néo đứt dây/tức nước vỡ bờ/sự vật phát triển đến cực điểm thì sẽ chuyển hoá theo hướng ngược lại|l
物理变化=biến đổi lý tính/thay đổi vật lý/sự thay đổi hình thái|l
物竞天择=vật cạnh thiên trạch/vật đua trời lựa/cạnh tranh sinh tồn|l
物累=vật lụy/vật phiền phức|l
物美价廉=hàng đẹp giá rẻ/vật mỹ giới liêm|l
物降一物=vỏ quýt dày có móng tay nhọn|l
牵涉到=liên lụy tới|l
牵累到=liên lụy đến|l
犯上作乱=làm phản/làm rối loạn/nổi dậy chống lại hoàng đế|l
犯不上=không đáng/chẳng bõ công/không quan trọng|l
犯不着=không đáng/tội gì|l
犯嘀咕=lẩm bẩm/thầm nói|l
犯得上=đáng/nên|l
犯罪活动=hoạt động tội phạm|l
犹犹豫豫=do do dự dự|l
犹豫不定=do dự bất định|l
犹豫起来=do dự|l
狗屁不通=rắm chó không kêu/văn bế tắc, diễn đạt không lưu loát|l
狗男女=cẩu nam nữ|l
狞狰=dữ tợn|l
独具一格=phong cách riêng/phong cách đặc sắc|l
独具慧眼=con mắt tinh đời/kiến giải cao siêu|l
独具特色=độc đáo đặc sắc|l
独到之处=chỗ độc đáo|l
独木不成林=một cây làm chẳng nên non/một con chim én không làm nên mùa xuân|l
独立国家=độc lập quốc gia|l
独门独院=nhà biệt lập/một cửa duy nhất|l
狮子般=như sư tử|l
猜测到=đoán được|l
猪狗不如=không bằng heo chó|l
猴皮筋儿=dây cao su/cọng cao su|l
玩具枪=súng đồ chơi|l
玩笑话=lời đùa giỡn/và đùa/đùa giỡn/Lời nói đùa|l
玩起来=chơi|l
环状软骨=xương sụn cuống họng/sụn nhẫn|l
环绕着=còn quấn/bao quanh|l
玻璃纤维=sợi thủy tinh/sợi thuỷ tinh|l
球墨铸铁=hợp kim thép|l
理当如此=lẽ ra nên như vậy|l
理性认识=nhận thức lý tính|l
琢磨不透=suy nghĩ không thấu|l
瓮声瓮气=ồm ồm/úng thanh úng khí/giọng ồm ồm|l
瓮着=úng|l
生下了=sanh ra/sinh ra/sinh ra|l
生不如死=sống không bằng chết|l
生不起气=không tức giận được|l
生与死=sinh cùng tử/sống và chết/sống hay chết|l
生之力=sinh chi lực/sức mạnh của sự sống|l
生之路=con đường sống|l
生了病=bị bệnh|l
生产关系=quan hệ sản xuất|l
生产工具=công cụ sản xuất|l
生产方式=phương thức sản xuất/cách thức sản xuất|l
生产资料=tư liệu sản xuất|l
生产过剩=sản xuất thừa|l
生俱=bẩm sinh/sinh câu|l
生动活泼=sinh động hoạt bát/sống động|l
生化危机=Resident Evil/sinh hóa nguy cơ|l
生化学家=sinh hóa học gia|l
生化武器=vũ khí sinh hóa/vũ khí sinh học|l
生吃了=ăn sống rồi|l
生命危险=nguy hiểm tính mạng/nguy hiểm tính mạng/nguy hiểm đến tính mạng|l
生啃=gặm sống|l
生存斗争=đấu tranh sinh tồn/đấu tranh sống còn|l
生张熟魏=có quen thân có quen sơ|l
生得多=sinh được nhiều|l
生态学=sinh thái học|l
生意经=lối buôn bán/cách buôn bán/kiểu buôn bán|l
生成器=máy chế tạo|l
生我气=giận ta|l
生或死=sống hoặc chết|l
生拉硬拽=nài ép lôi kéo/cưỡng ép/ép buộc/gò ép/gò bó/miễn cưỡng/miễn cưỡng phụ hoạ|l
生日会=tiệc sinh nhật|l
生日快乐=sinh nhật vui vẻ|l
生日礼物=quà sinh nhật|l
生杀大权=quyền sinh sát/đại quyền sinh sát/quyền sinh quyền sát|l
生死关头=sống chết trước mắt/bước ngoặt sinh tử|l
生活品质=phẩm chất cuộc sống|l
生活安定=cuộc sống yên ổn|l
生活必需品=nhu cầu thiết yếu hàng ngày/nhu yếu phẩm hàng ngày/nhu cầu thiết yếu của cuộc sống|l
生活资料=tư liệu sinh hoạt/đồ dùng trong cuộc sống|l
生物工程=công nghệ sinh học/kỹ thuật sinh học|l
生理反应=phản ứng sinh lý|l
生生不息=sinh sôi không ngừng/sinh sôi liên tục|l
生生世世=đời đời kiếp kiếp|l
生生死死=sinh sinh tử tử/sinh sinh tử tử|l
生着气=đang tức giận|l
生而=sinh nhi|l
生财之道=con đường phát tài|l
生财有道=biết cách làm giàu/biết cách hái ra tiền|l
生起气=tức lên|l
生起气来=nóng giận|l
生身之母=mẹ ruột|l
生身父亲=cha ruột|l
生身父母=cha mẹ ruột|l
生辰八字=ngày sinh tháng đẻ|l
用一用=dùng một chút|l
用不上=không dùng được/không cần/không dùng được : không cần|l
用不着=không cần đến/không cần phải/không dùng tới|l
用人不疑=dùng người thì không nghi ngờ người/dùng người thì không nên nghi ngờ người|l
用人之道=đạo dùng người|l
用力过度=dùng sức quá độ|l
用在一时=dùng trong chốc lát|l
用尽心机=dụng hết tâm cơ|l
用得上=cần dùng đến|l
用心良苦=dụng tâm lương khổ|l
用攒下=dùng tất cả|l
用来用去=dùng đến dùng đi|l
用此术=dùng thuật này|l
用武之地=đất dụng võ|l
用的上=dùng tới được|l
甩开膀子=thoải mái|l
甩袖子=phất tay áo/vung tay áo của một người|l
田不缺=Điền Bất Khuyết|l
田径运动=vận động điền kinh|l
由上而下=từ trên cao đi xuống|l
由上至下=từ trên xuống dưới|l
由下而上=từ dưới lên trên|l
由不得=không thể theo/không phải do/không thể tuỳ theo/không thể thuận theo/không thể tự chủ được/không kiềm được/buột/cũng không do/không thể kìm được|l
由他去=tùy hắn đi|l
由何而来=từ đâu mà đến|l
由内而外=từ trong ra ngoài|l
由始至终=từ đầu đến cuối|l
由实而虚=do thật mà hư|l
由小变大=từ nhỏ biến thành lớn|l
由易到难=từ dễ đến khó|l
由来已久=từ xưa đến nay|l
由此可知=từ đó có thể biết|l
由浅入深=từ cạn tới sâu|l
由虚变实=từ hư biến thực|l
由表及里=từ ngoài vào trong/bởi bảng và bên trong/tiến hành từ bên ngoài vào bên trong|l
甲壳动物=động vật giáp xác/loài giáp xác|l
甲状旁腺=tuyến giáp trạng bên|l
甲状腺=tuyến giáp trạng|l
甲状软骨=xương sụn giáp trạng|l
电之力=Điện Chi Lực|l
电力系统=hệ thống điện lực|l
电子系统=hệ thống điện tử|l
电脑前=trước máy vi tính|l
电脑前面=máy vi tính phía trước|l
电脑屏幕=màn ảnh máy vi tính/màn hình máy vi tính|l
电脑系统=hệ thống máy tính/hệ thống máy vi tính|l
电视屏幕=màn hình TV|l
电话本=danh bạ điện thoại|l
电路系统=hệ thống đường điện|l
电闪雷鸣=sấm sét vang dội/sấm chớp rền vang/sấm vang chớp giật|l
男下女上=nam hạ nữ thượng|l
男儿有泪不轻弹=nước mắt nam nhi không dễ chảy/nam nhi có nước mắt không nhẹ/Đàn ông đích thực không dễ khóc|l
男大当婚=trai lớn lấy vợ/nam đại đương hôn/trai lớn dựng vợ|l
男女之间=giữa nam nữ|l
男女关系=quan hệ nam nữ|l
男女平等=nam nữ bình đẳng/bình đẳng giữa nam và nữ/bình đẳng giới|l
男女老幼=già trẻ nam nữ/mọi người|l
男左女右=nam trái nữ phải|l
男扮女装=nam giả nữ trang/giả gái|l
男男女女=nam nam nữ nữ/cả trai lẫn gái/có nam có nữ/có trai có gái|l
留余地=để lối thoát/để đường lui/rào trước đón sau|l
留后路=để đường rút lui/để lối thoát/để lại đường lui|l
留声机=máy quay đĩa/máy hát|l
留得青山在=lưu được núi xanh|l
略见一斑=nhìn lướt/thoáng qua|l
略识之无=biết ít chữ|l
略逊一筹=hơi kém một chút|l
略高于=hơi cao hơn|l
疏于防范=đề phòng sơ suất|l
疏忽大意=lơ là sơ suất|l
疑人不用=nghi người thì không dùng người|l
疑神疑鬼=nghi thần nghi quỷ/đa nghi/đa nghi như Tào Tháo|l
疲劳度=độ mệt mỏi|l
疲劳感=cảm giác mệt nhọc|l
疲惫感=cảm giác mệt mỏi|l
痛痒相关=đau khổ liên quan với nhau|l
痛起来=đau|l
瘦下去=gầy đi|l
瘦骨嶙峋=gầy trơ cả xương|l
癞皮狗=chó ghẻ/lại bì cẩu/chó rụng lông/chó trụi lông/đồ vô liêm sỉ|l
癞蛤蟆想吃天鹅肉=cóc ghẻ mà đòi ăn thịt thiên nga/cóc mà đòi ăn thịt thiên nga/ăn mày đòi ăn xôi gấc/ăn chực đòi bánh chưng|l
登徒子=đăng đồ tử/dê xồm/kẻ xấu xa|l
登记手续=thủ tục ghi danh|l
白吃白喝=ăn uống chùa|l
百业待兴=bách nghiệp đãi hưng|l
百余人=hơn trăm người|l
百年一遇=trăm năm mới gặp|l
百年不遇=hiếm có/hiếm thấy ở đời/trăm năm cũng không dễ gặp/trăm năm hiếm có|l
百年之后=trăm năm về sau/sau trăm tuổi/sau khi chết|l
百年之好=gắn bó suốt đời|l
百年大计=kế hoạch trăm năm/tính chuyện lâu dài/tính chuyện trăm năm/biện pháp lâu dài/kế hoạch lâu dài|l
百年谐老=bách niên giai lão|l
百年难遇=trăm năm khó gặp|l
百废俱兴=hoàn tất những công việc còn dây dưa chưa làm/xây dựng, sửa sang tất cả/làm lại từ đầu/hoàn tất những công việc còn dang dở|l
百废待兴=bách phế đãi hưng|l
百忙中=trong lúc cấp bách|l
百无一用=cực kỳ vô dụng|l
百毒不侵=bách độc bất xâm|l
百毒神君=Bách Độc Thần Quân|l
百般刁难=gây khó khăn đủ đường|l
百花争艳=muôn hoa đua thắm khoe hồng|l
百花盛开=trăm hoa đua nở|l
百里挑一=trong trăm có một/hiếm có/trong trăm chọn một/cực kỳ xuất sắc/trăm người chọn một|l
的确如此=đúng là như thế|l
皮下注射=tiêm dưới da|l
盗亦有道=đạo tặc cũng có đạo/kẻ cướp cũng có đạo nghĩa/đạo cũng có đạo|l
盛极必衰=thịnh cực tất suy|l
目不斜视=nhìn không chớp mắt/mắt nhìn thẳng|l
目无余子=dưới mắt không còn ai/không coi ai ra gì|l
直到现在=cho tới bây giờ|l
直心眼儿=lòng dạ ngay thẳng/ngay thẳng/người ngay thẳng/người lòng dạ ngay thẳng|l
直系亲属=trực hệ/dòng họ trực tiếp|l
直达快车=tốc hành/chạy suốt|l
相互之间=giữa lẫn nhau/giữa nhau/giữa 2 người chúng ta|l
相互交织=đan vào lẫn nhau|l
相互作用=hỗ trợ lẫn nhau|l
相互依存=tương hỗ y tồn|l
相互信任=tín nhiệm lẫn nhau|l
相互影响=ảnh hưởng lẫn nhau|l
相互理解=hiểu nhau|l
相互竞争=cạnh tranh với nhau|l
相互配合=phối hợp lẫn nhau|l
相互间=giữa lẫn nhau|l
相亲相爱=tương thân tương ái/yêu thương lẫn nhau|l
相似之处=chỗ tương tự|l
相似形=hình đồng dạng|l
相去不远=không khác nhau lắm|l
相反相成=tính thống nhất của các sự vật tương phản|l
相同之处=chỗ tương đồng|l
相夫教子=giúp chồng dạy con|l
相对性=tính tương đối|l
相对无言=nhìn nhau không nói/tương đối im lặng|l
相对来说=tương đối mà nói/dù sao|l
相对湿度=độ ẩm tương đối|l
相对真理=chân lý tương đối|l
相对而言=so ra mà nói/tương đối mà nói/so ra|l
相对论=thuyết tương đối|l
相对高度=độ cao tương đối|l
相差不多=không sai biệt nhiều/xê xích không nhiều|l
相忍为国=vì lợi ích của quốc gia dân tộc mà nhường nhịn nhau|l
相机而动=tùy cơ mà động|l
相机行事=tuỳ cơ ứng biến/tùy cơ hành sự|l
相比之下=so sánh dưới/dưới so sánh/nếu mà so sánh/so sánh với đó|l
相比而言=so ra mà nói|l
相片儿=tấm hình/ảnh chụp/hình chụp|l
相见恨晚=hận gặp nhau trễ/gặp nhau hận muộn/Cảm giác như chúng ta đã quen biết nhau từ lâu.|l
相谈甚欢=trò chuyện vui vẻ|l
相过面=xem tướng qua|l
省吃俭用=bớt ăn bớt mặc/ăn mặc tiết kiệm/nhịn ăn nhịn xài|l
看不上眼=không để vào mắt/nhìn không thuận mắt/không lọt nổi mắt xanh|l
看不清楚=thấy không rõ lắm/không thấy rõ|l
看不过去=nhìn không được|l
看不过眼=không vừa mắt|l
看不顺眼=thấy ngứa mắt|l
看也不看=nhìn cũng không nhìn/cũng không thèm nhìn tới|l
看了又看=xem đi xem lại|l
看在眼里=nhìn ở trong mắt|l
看来看去=nhìn tới nhìn lui|l
看样子=xem ra/ra mòi/xem chừng/nhìn dáng dấp|l
看清楚=thấy rõ ràng/nhìn rõ ràng/nhìn rõ ràng|l
看笑话=chế giễu/chê cười/làm trò cười|l
看走了眼=nhìn sai rồi/nhìn lầm|l
真不容易=thật không dễ dàng|l
真不愧是=thật không hổ là/thật không hỗ là|l
真不象=thật sự không giống|l
真伪莫辨=thực giả chưa phân/thật giả không phân biệt được/Thật giả lẫn lộn|l
真假莫辨=thật giả khó nói|l
真假难辨=khó phân thật giả|l
真凭实据=chứng cứ rõ ràng/bằng chứng chính xác/bằng cớ cụ thể|l
真刀真枪=đao thật thương thật/chân ướt chân ráo/đao thật súng thật|l
真名实姓=tên họ thật|l
真实度=độ chân thật/độ chân thực|l
真实情况=tình huống thật|l
真心实意=chân tâm thật ý|l
真心话=lời thật lòng/lời nói thật lòng|l
真情实感=chân tình thực cảm/cảm giác chân thật/Chân thực tình cảm|l
真才实学=thực học/thực tài/chân tài thực học|l
真是假=thật hay giả/thật sự là giả|l
真有此事=thật có chuyện này ư|l
真材实料=chân tài thực học|l
真枪实弹=súng thật đạn thật|l
真没想到=thật không nghĩ tới|l
真相大白=chân tướng bại lộ/sự thật đã được làm sáng tỏ/toàn bộ sự thật được tiết lộ/mọi thứ trở nên rõ ràng|l
真真假假=thật thật giả giả/chân chân giả giả|l
真真实实=chân chân thật thật/chân chân thực thực|l
眨眼睛=nháy mắt|l
眼不见=mắt không thấy|l
眼中钉=cái đinh trong mắt|l
眼前一亮=hai mắt tỏa sáng/sáng mắt lên|l
眼前亏=thiệt thòi trước mắt/thua thiệt trước mắt|l
眼皮子浅=kiến thức hạn hẹp/tầm mắt hạn hẹp|l
眼皮底下=ngay dưới mắt/không coi vào đâu/dưới mắt|l
瞎了眼=mắt bị mù|l
瞎忙活=mù quáng làm việc|l
瞎胡闹=làm loạn|l
瞎说八道=nói càn nói bậy/ăn càn nói bậy/ăn bậy nói bạ/hạt thuyết bát đạo/ăn nói bậy bạ|l
瞠乎其后=trố mắt nhìn theo/nhìn theo trân trối|l
瞠然=hai mắt trợn|l
瞠目=trố mắt/trợn mắt/trơ mắt/giương mắt|l
瞠目而视=nhìn trừng trừng/trơ mắt nhìn/giương mắt nhìn|l
瞬也不瞬=nháy mắt cũng không nháy|l
瞬时速度=vận tốc tức thời|l
知之甚少=biết rất ít|l
知人善任=tri nhân thiện nhậm/biết người khéo dùng|l
知冷知热=biết nóng biết lạnh|l
知情达理=thấu tình đạt lý/biết điều|l
知法犯法=cố tình vi phạm/tri pháp phạm pháp/hiểu pháp luật mà phạm luật/cầm khoán bẻ măng/Hiểu luật mà phạm luật|l
知行合一=tri hành hợp nhất/tri hành nhất trí/sự thống nhất giữa nhận thức và hành động|l
知遇之恩=ơn tri ngộ|l
知难而退=biết khó mà lui|l
破体字=chữ phá lệ/chữ tục|l
破啼为笑=từ khóc thành cười|l
破土动工=phá thổ động công|l
破坏活动=hoạt động phá hoại/sự phá hoại|l
破百=phá trăm/phá bách|l
破罐子破摔=vò đã mẻ không sợ rơi|l
破罐破摔=vò đã mẻ không sợ sứt|l
硕果仅存=thạc quả cận tồn/sau khi chọn lọc/cây còn lại quả to/còn lại toàn người tài, sau khi trải qua sàng lọc/"thạc quả cận tồn" (quả lớn còn sót lại)|l
硝烟味=mùi khói thuốc súng|l
硬上弓=ngạnh thượng cung|l
硬不硬=có cứng hay không|l
硬了起来=cứng rắn|l
硬气功=ngạnh khí công|l
硬汉子=kẻ kiên cường|l
硬着头皮=kiên trì/bất chấp khó khăn/kiên trì đến cùng/bất chấp khó khăn, kiên trì đến cùng/nhắm mắt|l
硬着陆=rơi/rớt|l
硬要来=miễn cưỡng tới|l
硬说是=miễn cưỡng nói|l
确凿证据=chứng cớ xác thực|l
确有其事=xác thực/xác thực có việc này|l
确有其人=đúng là có người này|l
碍面子=sợ mất thể diện/sợ làm tổn thương tình cảm/ngại làm phật lòng/e làm mất mặt|l
碧空如洗=trời xanh không mây/trời xanh quang đãng|l
碰一鼻子灰=mũi dính đầy tro/bị một vố/bị chửi mắng té tát|l
碰击声=tiếng va chạm|l
碰头会=họp hội ý/cuộc hội ý|l
碰碰运气=thử thời vận/thử vận khí một chút/thử vận may|l
碰运气=tìm vận may|l
碰钉子=nếm mùi thất bại/bị một vố/vấp phải trắc trở/bị thất bại/vấp váp|l
碱基对=cặp base|l
社会关系=quan hệ xã hội/quan hệ giữa người với người|l
社会存在=tồn tại xã hội|l
社会工作=công tác xã hội|l
社会形态=hình thái xã hội|l
社会意识=ý thức xã hội|l
社会教育=giáo dục xã hội|l
社会治安=trị an xã hội|l
社会活动=hoạt động xã hội|l
社团活动=hoạt động câu lạc bộ|l
祖祖辈辈=đời đời kiếp kiếp/đời đời/đời này qua đời khác|l
神之大杀器=vũ khí giết thần|l
神之女=thần chi nữ/con gái của thần|l
神之源=Thần chi nguyên|l
神之箭=Thần Chi Tiễn|l
神之血=thần chi huyết|l
神仙下凡=thần tiên hạ phàm|l
神器谱=Thần Khí Phổ|l
神圣同盟=đồng minh Thần Thánh|l
神智不清=thần trí mơ hồ|l
神机妙算=thần cơ diệu toán/mưu kế thần tình/mưu hay chước giỏi|l
神机营=Thần Cơ doanh|l
神灾=thần tai|l
神照经=Thần Chiếu Kinh|l
神神道道=thần thần đạo đạo|l
神秘学=thần bí học/bí ẩn|l
神秘色彩=sắc thái thần bí|l
神秘莫测=thần bí khó lường/bí ẩn|l
神经中枢=trung khu thần kinh|l
神经兮兮=vui buồn thất thường|l
神经末梢=đầu dây thần kinh|l
神经系统=hệ thần kinh/hệ thống thần kinh|l
神经纤维=dây thần kinh|l
神经衰弱=thần kinh suy nhược/suy nhược thần kinh/thần kinh yếu|l
神经过敏=thần kinh quá nhạy cảm/đa nghi/ngờ vực/thần kinh quá nhạy|l
神职人员=nhân viên thần chức|l
神裂火织=Kanzaki Kaori|l
神话传说=truyền thuyết thần thoại|l
神选之人=người thần tuyển|l
神闲气定=thần nhàn khí định|l
神闲气静=thần nhàn khí tĩnh|l
神阵上=trên thần trận|l
禁而不止=cấm mà không ngừng|l
私有财产=tài sản riêng/tài sản tư hữu|l
私相授受=riêng mình trao nhận|l
秋后算账=thu hậu toán trướng/tính toán sau mùa thu/giải quyết các tài khoản sau mùa thu|l
秋收起义=khởi nghĩa Thu Thụ|l
秋色平分=ngang ngửa|l
种族歧视=kì thị chủng tộc/phân biệt chủng tộc/kỳ thị chủng tộc|l
科幻小说=tiểu thuyết khoa huyễn|l
积劳成病=tích lao thành bệnh/vất vả lâu ngày sinh bệnh|l
积小成大=tích tiểu thành đại/tích lũy nhỏ thành lớn|l
积少成多=góp gió thành bão/tích thiểu thành đa/kiến tha lâu đầy tổ/gom ít thành nhiều|l
积年累月=thời gian dài/đã bao năm tháng/năm tháng trôi qua|l
积水成渊=tích tiểu thành đại/tích nước thành uyên|l
积渐=tích lũy dần|l
积重难返=thói quen khó sửa/cắm sào sâu khó nhổ|l
积非成是=tích phi thành thị|l
稀土元素=nguyên tố đất hiếm|l
稀有元素=nguyên tố hiếm|l
稀有动物=động vật quý hiếm|l
稀缺资源=tư nguyên khan hiếm|l
稍有不慎=hơi không cẩn thận/hơi bất cẩn một chút|l
稍等一下=chờ một chút|l
稍等下=chờ một lát/chờ một chút|l
稍逊一筹=kém hơn một chút|l
稚气未脱=chưa hết ngây thơ/trẻ con vẫn chưa thoát ra/vẫn mang nét hồn nhiên của tuổi thơ|l
稳坐不动=ngồi yên bất động|l
稳坐钓鱼台=Lã Vọng buông cần|l
稳定下来=ổn định lại|l
稳定平衡=thăng bằng ổn định/thăng bằng bền|l
空不异色=không bất dị sắc/không tức thị sắc|l
空冥期=Không Minh kỳ|l
空前绝后=vô tiền khoáng hậu/trước không có, sau này cũng không có/không bao giờ có|l
空口说白话=chỉ nói mà không làm/nói suông chứ không làm|l
空想家=không tưởng gia|l
空无一物=không có vật gì/không hề có thứ gì|l
穿红着绿=ăn mặc loè loẹt|l
窃国者侯=kẻ trộm quốc gia thì làm vương làm hầu|l
窃钩者诛=kẻ trộm gà trộm chó thì đáng chém|l
窝里反=đấu tranh nội bộ|l
窝里横=gia đình bạo ngược|l
立体几何=hình học không gian|l
立锥之地=đất cắm dùi|l
站不住脚=chân đứng không vững|l
站不稳=đứng không vững|l
站不起来=đứng không dậy nổi/không đứng nổi/không đứng lên nổi|l
站得住脚=đứng vững được bước chân|l
站立起来=đứng thẳng lên|l
站街女=gái đứng đường|l
竹篮打水=lấy giỏ trúc mà múc nước|l
笑一笑=cười một cái|l
笑了笑=cười cười/cười một tiếng/cười cợt|l
笑了起来=nở nụ cười/phì cười|l
笑容满面=vẻ mặt tươi cười|l
笑掉大牙=cười đến rụng răng|l
笑而不答=cười không đáp|l
笨嘴笨舌=ngọng nghịu/vụng về|l
笨头笨脑=chậm hiểu/chậm tiêu/đầu óc chậm hiểu|l
笨家伙=người đần/tên ngốc|l
笨成=trở thành|l
笨手笨脚=tay chân vụng về/bản thủ bản cước/vụng về/chân tay vụng về/bổn thủ bổn cước|l
第一产业=nông nghiệp|l
第一关=cửa thứ nhất/ải thứ nhất/đầu tiên|l
第一击=kích thứ nhất/đòn thứ nhất|l
第一印象=ấn tượng đầu tiên|l
第一流=hạng nhất/quan trọng/loại một/cao cấp/hạng cao nhất/lỗi lạc/tài ba|l
第三关=cửa thứ ba|l
第三等级=đẳng cấp thứ ba|l
第四季度=quý bốn/Quý IV/quý 4|l
等价物=vật ngang giá/vật bằng giá|l
等差级数=cấp số cộng|l
等比级数=cấp số nhân|l
等着瞧=chờ coi|l
等级森严=đẳng cấp sâm nghiêm|l
等量齐观=đánh đồng như nhau/xem như nhau/coi ngang hàng|l
等闲之辈=hạng người bình thường/kẻ đầu đường xó chợ|l
答不上话=không trả lời được|l
答应下来=đáp ứng/đồng ý|l
答非所问=hỏi một đằng, trả lời một nẻo/đáp phi sở vấn/ông nói gà, bà nói vịt/hỏi một đằng trả lời một nẻo|l
简体字=chữ giản thể/chữ đơn giản|l
简化字=chữ giản hóa|l
简单明了=ngắn gọn dễ hiểu/đơn giản và rõ ràng/rõ ràng và đơn giản|l
简单机械=máy móc đơn sơ/máy móc đơn giản|l
简明扼要=đơn giản ngắn gọn/rõ ràng dễ hiểu/ngắn gọn và súc tích/ngắn gọn và đúng trọng tâm|l
简而言之=nói ngắn gọn/nói vắn tắt/nói đơn giản|l
简谐运动=chuyển động đơn giản|l
算一算=tính toán/tính một lần/tính toán một chút|l
算下来=tính được|l
算不上=không tính là|l
算了吧=quên đi thôi/coi như hết/được rồi đó|l
算了算=tính một cái/tính toán một chút|l
算你狠=xem như ngươi lợi hại/Xem như ngươi lợi hại|l
算得上=được cho|l
算无遗策=tính toán không bỏ sót/tính toán - không bỏ sót/không để sót/tính toán không một chỗ sai sót|l
算来算去=tính đi tính lại/tính tới tính lui|l
算清楚=tính toán rõ ràng|l
算的上=tính được là|l
管他什么=bất kể hắn là cái gì|l
管教好=quản giáo tốt|l
类似之处=chỗ tương tự|l
粗声粗气=cả tiếng/lớn tiếng/nói năng thô lỗ/thô thanh thô khí|l
粗手笨脚=tay thô chân đần|l
粮尽=lương thực hết|l
粮食作物=cây lương thực|l
精力充沛=tinh lực dồi dào|l
精力旺盛=tinh lực tràn đầy/tràn đầy năng lượng/Cường lực|l
精力过剩=dồi dào sinh lực|l
精神衰弱=suy nhược tinh thần/suy nhược thần kinh|l
精简版=bản rút gọn|l
精英教育=giáo dục ưu tú/Giáo dục tinh anh|l
精装修=trùng tu sạch sẽ/bao gồm dọn dẹp|l
糖醋排骨=sườn xào chua ngọt/đường thố bài cốt|l
紧张状态=tình trạng khẩn trương/tình trạng sốt sắng|l
紧急事件=sự kiện khẩn cấp|l
紧急任务=nhiệm vụ khẩn cấp|l
紧急会议=hội nghị khẩn cấp|l
紧急命令=mệnh lệnh khẩn cấp|l
紧急情况=tình huống khẩn cấp|l
紧急状况=tình trạng khẩn cấp|l
紧急状态=trạng thái khẩn cấp/tình trạng cấp bách/tình trạng khẩn cấp|l
紧紧张张=rất khẩn trương|l
紧紧抓住=nắm chắc/nắm chặt/tóm chặt lấy|l
紧要关头=khẩn yếu quan đầu/khẩn yếu quan đầu (*tình trạng nguy cấp)/ngàn cân treo sợi tóc|l
紧贴着=dán chặt lấy/dán chặt/dán chặt|l
紧跟着=theo sát lấy/theo sát mà/theo sát|l
紧身服=áo bó/đồ bó|l
紫气东来=Tử Khí Đông Lai|l
累死累活=mệt gần chết/luy tử luy hoạt|l
繁荣昌盛=phồn vinh thịnh vượng/thịnh vượng/vẻ vang và hưng thịnh/phát triển mạnh|l
红了眼=đỏ mắt/mù quáng|l
红了脸=đỏ mặt|l
红光满面=hồng quang đầy mặt/mặt mày hồng hào/đỏ da thắm thịt/nét mặt hồng hào|l
红着脸=đỏ mặt|l
红红火火=hồng hồng hỏa hỏa|l
纤纤玉手=thon thon tay ngọc/tay ngọc nhỏ dài|l
线性方程=phương trình bậc một/phương trình bậc nhất|l
线性规划=quy hoạch tuyến tính|l
线装本=sách khâu lại bằng chỉ|l
组合成=tổ hợp thành|l
组完队=tổ xong đội|l
组装机=máy lắp ráp|l
细嚼慢咽=nhai kỹ nuốt chậm|l
细想下=ngẫm nghĩ kỹ|l
经不住=không nhịn được/không chịu nổi|l
经不起=chịu không được/không qua nổi/không chịu nổi|l
经世致用=kinh thế trí dụng|l
经国之才=kinh quốc chi tài|l
经年累月=năm này tháng nọ/năm này tháng khác|l
经济危机=khủng hoảng kinh tế|l
经济衰退=suy thoái kinh tế/Suy thoái kinh tế|l
结核杆菌=vi trùng lao|l
结缔组织=mô liên kết|l
绚濑=Ayase|l
络腮胡子=râu quai nón|l
绝不会=tuyệt sẽ không/chắc chắn sẽ không|l
绝不食言=tuyệt không nuốt lời|l
绝口不提=không hề đề cập tới|l
绝对优势=ưu thế tuyệt đối|l
绝对值=giá trị tuyệt đối|l
绝对温度=nhiệt độ tuyệt đối|l
绝对真理=chân lí tuyệt đối/chân lý tuyệt đối|l
绝对零度=độ không tuyệt đối/không độ tuyệt đối|l
绝对高度=độ cao tuyệt đối|l
绝无仅有=tuyệt vô cận hữu/gần như không tồn tại/điên cuồng/có một không hai/hiếm có|l
绝绝子=tuyệt tuyệt tử/Bạn là nhất|l
绝色美女=tuyệt sắc mỹ nữ|l
统一体=thể thống nhất|l
统一口径=thống nhất lời khai/thống nhất cỡ nòng/đường dẫn một đoạn/áp dụng một cách tiếp cận thống nhất để thảo luận một vấn đề|l
统一天下=thống nhất thiên hạ|l
统一战线=mặt trận thống nhất/chung một chiến tuyến|l
统一指挥=thống nhất chỉ huy|l
统一行动=thống nhất hành động|l
统战部长=Thống chiến bộ trưởng|l
统治阶级=giai cấp thống trị|l
统筹学=thống trù học|l
绵绵细雨=mưa phùn rả rích|l
综合利用=lợi dụng tổng hợp|l
综合处=tổng hợp xử/phòng tổng hợp|l
综合排名=tổng xếp hạng/xếp hạng toàn diện|l
综艺节目=chương trình tạp kỹ|l
绿树成荫=cây xanh râm mát/lục thụ thành ấm - sống già thành đại ca/cây xanh tạo bóng mát/cây xanh tỏa bóng|l
绿色植物=thực vật xanh/cây xanh|l
缺心少肺=thiếu tim thiếu phổi|l
缺心眼儿=thiếu đầu óc|l
网中之鱼=cá ở trong lưới/cá trong võng|l
置身于=đưa thân vào|l
美不胜收=đẹp không sao tả xiết/đẹp vô cùng/đẹp hết chỗ nói|l
美极了=đẹp cực kỳ/cực kỳ xinh đẹp/đẹp quá|l
群众演员=diễn viên quần chúng/Diễn viên quần chúng|l
群众组织=tổ chức quần chúng|l
群众路线=đường lối quần chúng|l
群众运动=phong trào quần chúng|l
群星璀璨=dàn sao chói sáng/các ngôi sao lấp lánh|l
群芳谱=Quần Phương Phổ|l
翩翩公子=công tử văn nhã|l
翩翩少年=thiếu niên nhanh nhẹn|l
翻个儿=lật/đảo/lật ngược|l
翻开书=mở sách|l
翻旧账=lôi chuyện cũ/nhắc chuyện cũ|l
翻来复去=lật tới lật lui|l
翻样=thay đổi thiết kế|l
翻澜=nổi sóng|l
翻白眼=mắt trợn trắng/hai mắt trắng dã/thất vọng/phẫn nộ/bệnh nguy kịch|l
翻老账=lôi chuyện cũ/nhắc chuyện cũ|l
翻脸不认人=trở mặt không quen biết/trở mặt không biết người/trở mặt/quay lưng|l
翻花绳=chơi dây/lật dây hoa/Trò chơi dây|l
翻译出=phiên dịch ra|l
翻译器=máy phiên dịch|l
翻译官=quan phiên dịch|l
翻译家=nhà phiên dịch/dịch giả|l
翻译机=máy phiên dịch|l
翻身仗=khắc phục khó khăn|l
翻过去=lật qua|l
翻过来=lật qua|l
老于家=lão Vu gia|l
老冤家=lão oan gia/kẻ thù cũ|l
老大不小=trưởng thành/lớn/già đầu/lớn đầu|l
老掉牙=cũ rích/già cỗi/lỗi thời/cổ xưa/không hợp thời/lão điệu nha|l
老泪纵横=nước mắt tuôn đầy mặt/lão lệ tung hoành|l
老疙瘩=con út|l
老着脸皮=mặt dạn mày dày/mặt mo/mặt dầy|l
老花眼镜=kính lão/kính viễn thị|l
耍不动=chơi không nổi|l
耍嘴皮=nên thông minh|l
耍嘴皮子=múa mép khua môi/nói suông/chỉ nói không làm|l
耍子=chơi|l
耍心眼=tính toán, mưu trí, khôn ngoan/đấu trí|l
耍心眼儿=tính toán thiệt hơn|l
耍把戏=làm xiếc|l
耍无赖=chơi xấu/chơi xỏ lá|l
耍泼=trêu chọc|l
耍流氓=chơi lưu manh/đùa giỡn với lưu manh/Giở trò lưu manh|l
耍滑头=ngang ngạnh|l
耍花招=ra vẻ/giở trò/giở mánh khoé|l
耍花样=giở trò gian|l
耍花腔=mồm mép bịp người/tán tỉnh lừa người|l
耍贫嘴=nói lải nhải/nói nhảm|l
耍赖皮=chơi xấu|l
耍酷=hù người|l
耐不住=không chịu nổi/không nén được/không dằn lòng được/không chịu được|l
耐久力=sức bền|l
耐久度=độ bền|l
耐涝=chống ngập úng/chịu được nước lũ|l
耐火材料=vật liệu chịu lửa|l
耳朵尖=thính tai/lỗ tai thính|l
耳朵眼儿=tai/lỗ tai/lỗ xâu tai|l
职责所在=chỗ chức trách/đang chấp hành nhiệm vụ/nằm trong chức trách|l
联合声明=thông cáo chung/thông báo chung|l
联席会议=hội nghị liên tịch|l
联想起=liên tưởng tới|l
联系方式=phương thức liên lạc|l
联系方法=phương pháp liên lạc|l
联系电话=điện thoại liên lạc|l
聚伞花序=xim/cyme|l
聚合物=polyme/polymer/Polyme|l
聚少离多=chung đụng thì ít mà xa cách thì nhiều/ở cùng nhau thì ít mà xa cách thì nhiều|l
肉乎乎=thịt hồ hồ/thịt/nhiều thịt|l
肉体上=trên nhục thể/trên thân thể|l
肉眼凡胎=nhục nhãn phàm thai|l
肉食动物=động vật ăn thịt|l
股掌之上=thao túng/trên lòng bàn tay|l
肥头大耳=tai to mặt lớn/phương phi/đầu mập tai to|l
肥水不流外人田=phù sa không lưu ruộng người ngoài/phì thủy bất lưu ngoại nhân điền/chỗ béo bở không cho người ngoài|l
肩负着=gánh vác|l
肾上腺=tuyến thượng thận/tuyến trên thận|l
肾上腺素=adrenalin/a-đrê-na-lin|l
肾之神藏=thần tàng của thận|l
胃蛋白酶=an-bu-min trong dịch vị/pép-xin/enzim trong dịch vị|l
胆大心小=can đảm cẩn trọng|l
背对着=đưa lưng về phía|l
背负着=gánh vác lấy/lưng đeo|l
胜一负=thắng một thua|l
胜券在握=nắm chắc thắng lợi trong tay/nắm chắc phần thắng|l
胜多败少=thắng nhiều bại ít/thua ít thắng nhiều|l
胜少负多=thắng ít thua nhiều|l
胜少败多=thắng ít bại nhiều|l
胜者为王=kẻ thắng làm vua/người thắng làm vua|l
胡子拉碴=râu ria xồm xoàm|l
胡笳十八拍=hồ già thập bát phách|l
胡编乱造=thêu dệt vô cớ/vô căn cứ/bừa bãi/hồ biên loạn tạo|l
胳膊拧不过大腿=trứng chọi đá/châu chấu đá xe/nhỏ không địch lại lớn/yếu không thể địch lại mạnh|l
能掐会算=thần cơ diệu toán/biết trước tương lai|l
脊梁背=xương sống|l
脊椎动物=động vật có xương sống|l
脊椎骨=xương cột sống/xương sống|l
脊神经=thần kinh cột sống/dây thần kinh cột sống|l
脊索动物=động vật dây sống|l
脑中风=xuất huyết não|l
脑力劳动=lao động trí óc|l
脑海中=trong đầu|l
脑肿瘤=khối u não/u não|l
脑胀=não trướng|l
脑贫血=thiếu máu não|l
脑震荡=não chấn động/chấn động/chấn động não|l
脱贫致富=thoát bần trí phú|l
脸一红=mặt đỏ lên|l
脸不红=mặt không đỏ|l
脸无人色=mặt tái nhợt như người chết|l
脸皮厚=da mặt dày|l
脸皮薄=da mặt mỏng|l
脸红红=mặt ửng hồng|l
脸红脖子粗=mặt đỏ tía tai|l
脸色苍白=sắc mặt tái nhợt|l
脸青鼻肿=mặt xanh mũi sưng|l
腔肠动物=động vật xoang tràng/động vật ruột khoang|l
腰椎骨=xương sống eo|l
腰酸背疼=đau lưng nhức eo|l
膀大腰圆=cao lớn vạm vỡ|l
膨胀系数=hệ số giãn nở|l
膨胀起来=bành trướng/bắt đầu bành trướng|l
自上到下=từ trên xuống dưới|l
自上而下=từ trên xuống dưới/từ đầu đến đuôi|l
自下而上=từ đuôi đến đầu/từ dưới lên trên/từ dưới lên|l
自不待言=không cần phải nhiều lời|l
自不量力=không biết lượng sức/không lượng sức mình/không tự lượng sức|l
自专=chuyên quyền/độc đoán/chuyên chế|l
自产自销=tự cung tự cấp/tự sản xuất và bán|l
自以为是=tự cho là đúng/tự cho là|l
自作多情=tự mình đa tình/tưởng ai cũng mê mình/tưởng bở|l
自作死=tự tìm đường chết|l
自作聪明=tự cho là thông minh/làm ra vẻ khôn ngoan/tự cho mình là thông minh|l
自作自受=tự làm tự chịu/mình làm mình chịu/bụng làm dạ chịu/ai làm nấy chịu|l
自信心=lòng tự tin|l
自内而外=từ trong đến ngoài|l
自制力=tự chủ/kỷ luật/lực tự chế|l
自动化=tự động hoá/tự động hóa|l
自动售货机=máy bán hàng tự động|l
自动步枪=súng trường tự động/súng tự động|l
自动武器=vũ khí tự động|l
自卖自夸=mèo khen mèo dài đuôi/khoe khoang mình giỏi/tự khen/tự mại tự khoa|l
自古以来=từ xưa đến nay/từ xưa tới nay|l
自叹不如=cảm thấy không bằng/cảm thấy không bằng ...|l
自叹弗如=tự than không bằng|l
自各儿=bản thân/mình/tự mình|l
自命不凡=tự cho mình siêu phàm/hoang tưởng tự đại/thói cuồng vinh|l
自圆其说=tự bào chữa/tự viên kỳ thuyết/vo tròn cho kín kẽ|l
自外而内=từ ngoài vào trong|l
自始至终=từ đầu đến cuối/tự thủy chí chung/từ đầu chí cuối|l
自学成才=tự học thành tài|l
自寻短见=nghĩ quẩn|l
自弹自唱=tự đàn tự hát|l
自强不息=không ngừng vươn lên/không ngừng cố gắng|l
自感应=tự cảm ứng|l
自成一家=tự thành một trường phái riêng|l
自我意识=tự ý thức/tự nhận thức/nhận thức về bản thân|l
自找没趣=tự làm mất mặt/tự bôi xấu|l
自拍照=tự chụp hình|l
自有打算=tự có tính toán|l
自杀式=tự sát thức|l
自杀性=tính chất tự sát|l
自杀未遂=tự sát bất thành/cố gắng tự tử|l
自来水=nước máy/nước uống/hệ thống cung cấp nước uống/nước uống|l
自来水管=ống nước máy|l
自来火=diêm/hộp quẹt/bật lửa|l
自来红=tài năng thiên phú/tài năng bẩm sinh|l
自查自纠=tự tra tự củ|l
自此以后=từ nay về sau|l
自毁前程=tự hủy tương lai|l
自然主义=tự nhiên chủ nghĩa/chủ nghĩa tự nhiên|l
自然人=công dân|l
自然光=ánh sáng tự phát/nguồn sáng|l
自然力=lực lượng thiên nhiên/thiên nhiên lực|l
自然天成=tự nhiên thiên thành|l
自然数=số tự nhiên/dãy số tự nhiên|l
自然法=luật rừng/tự nhiên pháp|l
自然灾害=thiên tai|l
自然物=vật tự nhiên|l
自然环境=môi trường tự nhiên|l
自然科学=khoa học tự nhiên|l
自然科学家=nhà khoa học tự nhiên|l
自然经济=kinh tế tự nhiên/kinh tế thiên nhiên|l
自然规律=quy luật tự nhiên|l
自然资源=tài nguyên thiên nhiên|l
自然选择=chọn lọc tự nhiên|l
自由体操=thể dục tự do|l
自由恋爱=tình yêu tự do|l
自由泳=bơi tự do/bơi ếch|l
自由竞争=tự do cạnh tranh|l
自由职业=nghề tự do/nghề nghiệp tự do|l
自由落体=vật rơi tự do|l
自由行动=tự do hành động|l
自由诗=thơ tự do|l
自由贸易=mậu dịch tự do|l
自留地=đất tự lưu/đất phần trăm/ruộng phần trăm/ruộng đất sở hữu riêng/tự lưu|l
自相矛盾=tự mâu thuẫn/không hợp lý/không lô-gích|l
自称为=tự xưng là|l
自耕农=trung nông/nông dân tự canh tác|l
自行其是=làm theo ý mình/tự cho là đúng|l
自行决定=tự làm quyết định|l
自行火炮=pháo tự hành|l
自觉性=tính tự giác|l
自觉自愿=tự giác tự nguyện|l
自讨没趣=tự chuốc nhục nhã|l
自讨苦吃=tự mình chuốc lấy cực khổ/chuốc phiền/chuốc khổ|l
自说自话=tự quyết định/tự quyết/lẩm bẩm/bụng bảo dạ/tự thuyết tự thoại/tự mình nói với mình|l
自谋生路=tự mưu sinh lộ|l
自豪感=cảm giác tự hào|l
自负盈亏=tự chịu trách nhiệm lời lỗ|l
自选动作=động tác tự chọn|l
自问自答=tự hỏi tự trả lời|l
自食其力=tay làm hàm nhai/mình làm mình hưởng/sống bằng sức mình|l
自食其言=tự nuốt lời hứa|l
自鸣得意=dương dương tự đắc/gật gù đắc chí|l
自鸣钟=đồng hồ báo giờ/đồng hồ báo thức|l
臭气熏天=xú khí huân thiên|l
臭熏熏=thối tha/hôi hám|l
臭老九=xú lão cửu|l
至公无私=chí công vô tư|l
至关重要=cực kỳ trọng yếu/rất quan trọng/cực kì quan trọng/rất quan trọng yếu/cực kì trọng yếu|l
至情至性=chí tình chí nghĩa|l
至死不悔=chết cũng không hối|l
至灵之物=chí linh chi vật|l
至理名言=lời lẽ chí lý/lời nói chí lý/danh ngôn chí lý|l
至高无上=chí cao vô thượng/cao nhất/tối đa/tột bậc/cao cả|l
舌下神经=thần kinh dưới lưỡi|l
舒筋活血=cường gân hoạt huyết|l
良久良久=một hồi lâu sau|l
良性肿瘤=bướu lành|l
艳光四射=diễm quang tứ xạ|l
艺高人胆大=kẻ tài cao gan cũng lớn/tài cao mật lớn/người tài cao gan lớn|l
艺高胆大=tài cao gan lớn/tài cao mật lớn|l
节节败退=liên tục bại lui|l
花拳绣腿=khoa chân múa tay/phô trương/hoa quyền tú thối|l
花无百日红=thời trẻ qua mau/hoa nở thì phải tàn|l
花样年华=hoa dạng niên hoa/hoa màu/Hoa dạng niên hoa/đỉnh cao của cuộc sống|l
花样繁多=đủ loại kiểu dáng/rất nhiều loại|l
花样翻新=sáng tạo/tân trang lại/Kiểu dáng đổi mới/tân trang/đổi mới/biến cái cũ thành cái mới|l
花落谁家=hoa rơi vào nhà nào/rơi vào nhà nào|l
苍白无力=tái nhợt vô lực/nhợt nhạt và yếu đuối/nhợt nhạt và yếu ớt|l
苔藓植物=loài rêu|l
苦辣酸甜=cay đắng ngọt bùi|l
英年早逝=tráng niên mất sớm/qua đời sớm/bị cắt đứt trong giai đoạn đầu của một người|l
英雄人物=nhân vật anh hùng|l
英雄无用武之地=anh hùng không đất dụng võ/anh hùng không có chỗ múa gươm|l
英雄气短=anh hùng khí đoản|l
茫然无知=mù tịt không biết|l
茶余饭后=trà dư tửu hậu/thoải mái/sung sướng/giờ rỗi rãi/trà dư tửu hậu (*)|l
茶饭不思=cơm nước không vào/trà phạn bất tư/mất ăn mất ngủ|l
草丛里=trong bụi cỏ/trong bụi cỏ|l
草之国=Thảo chi quốc|l
草本植物=thực vật thân thảo|l
荒郊野外=dã ngoại hoang vu/hoang giao dã ngoại/vùng hoang dã|l
莞尔一笑=cười một tiếng|l
莞尔而笑=cười mỉm/mỉm cười|l
莫不是=chẳng lẽ/chớ không phải là/hẳn là/chẳng lẽ là|l
莫想=chớ có nghĩ|l
莫过于此=cùng lắm cũng chỉ như thế này thôi|l
获得性免疫=miễn dịch nhận được|l
获得胜利=đạt được thắng lợi|l
营养不良=dinh dưỡng không đầy đủ|l
营养成分=thành phần dinh dưỡng|l
落下来=rơi xuống|l
落下风=rơi xuống hạ phong|l
蒙古人种=giống người Mông Cổ/giống người Mông-gô-lô-ít/dân da vàng|l
蒙混过关=lừa dối qua ải/lừa đèo qua cửa ải/Đài Loan [meng1 hun4 guo4 guan1]|l
蒙起来=che lên|l
蓄势待发=vận sức chờ phát động/súc thế đãi phát/thủ thế chờ đợi|l
蓄意谋杀=cố ý giết người|l
蓄谋已久=mưu đồ đã lâu|l
蔓生植物=dây leo/loài dây leo|l
蔚为壮观=úy vi tráng quan|l
蔚为大观=phong phú rực rỡ/nhiều đẹp thịnh vượng|l
蔚为奇观=lóe sáng như  kỳ quan|l
蔚然成风=úy nhiên thành phong|l
蔫不出溜=ủ rũ|l
蕨类植物=loài dương xỉ|l
薄利多销=ít lãi tiêu thụ mạnh|l
藤本植物=cây mây/cây song/thực vật dây leo|l
藻类植物=tảo/thực vật rong rêu|l
虎毒不食子=hổ dữ không ăn thịt con|l
蛮不讲理=không thèm nói đạo lý/ngang ngược không biết lý lẽ|l
蛮天=Man Thiên|l
蜚短流长=thêm mắm dặm muối/thêm thắt đặt điều/nói xấu/bịa đặt|l
融为一体=hòa làm một thể|l
融而为一=hòa làm một|l
螳臂当车=châu chấu đá xe/trứng chọi với đá|l
螳臂挡车=bọ ngựa đấu xe|l
螳螂捕蝉=bọ ngựa bắt ve|l
血债血还=nợ máu trả bằng máu|l
血冥=Huyết Minh|l
血可流=máu có thể chảy|l
血本无归=mất cả chì lẫn chài/mất hết vốn liếng|l
血气胸=tràn khí màng phổi/huyết khí ngực|l
血泪史=huyết lệ sử/lịch sử máu và nước mắt|l
血流如注=máu chảy ồ ạt/máu chảy như chú|l
血流成河=máu chảy thành sông|l
血海深仇=huyết hải thâm cừu|l
血清素=serotonin|l
血盆大口=huyết bồn đại khẩu/miệng to như chậu máu/miệng lớn dính máu/cái miệng lớn như chậu máu|l
血红蛋白=huyết sắc tố/huyết hồng tố|l
血缘关系=quan hệ máu mủ|l
血肉之躯=huyết nhục chi khu/thân thể máu thịt|l
血肉模糊=máu thịt be bét|l
行不义=làm bất nghĩa|l
行不改姓=đi không thay tên|l
行不言之教=dùng việc làm thay lời nói mà giáo dục|l
行为艺术=nghệ thuật hành vi|l
行动不便=hành động bất tiện|l
行如风=đi như gió|l
行有余力=làm nhẹ nhàng|l
行踪不定=hành tung bất định|l
衣冠不整=áo mũ xộc xệch/quần áo không chỉnh tề|l
衣衫不整=quần áo không chỉnh tề/quần áo xốc xếch|l
衣衫褴褛=quần áo tả tơi/áo quần rách rưới/áo quần tả tơi/quần áo lam lũ|l
表达方式=phương thức biểu đạt|l
表里如一=trước sau như một/tư tưởng và lời nói hành động hoàn toàn thống nhất/trong ngoài như một|l
袒露出=lộ ra|l
被动免疫=miễn dịch thụ động|l
被劫走=bị cướp đi|l
被子植物=bị tử thực vật/thực vật hạt kín|l
被忽视=bị xem nhẹ|l
袴裙=hakama|l
装模作样=giả vờ giả vịt/trang mô tác dạng/giả bộ/làm bộ làm tịch/làm ra vẻ/làm bộ|l
装装样子=giả vờ giả vịt/giả vờ|l
裙带关系=quan hệ bám váy/quan hệ bám váy đàn bà|l
裸体画=tranh khoả thân|l
裸子植物=thực vật hạt trần/cây hạt trần|l
裸肩=vai trần|l
西装革履=Âu phục giày da/giày Tây|l
要价还价=trả giá/mặc cả|l
要你命=đòi mạng ngươi|l
要你管=ai cần ngươi lo|l
要言不烦=rõ ràng/khúc chiết|l
要这要那=muốn này muốn nọ|l
要风得风=muốn gió được gió/muốn gió có gió|l
见不得人=nhận không ra người/người không nhận ra|l
见了面=gặp mặt/thấy|l
见几而作=tùy cơ ứng biến|l
见分晓=thấy rõ ràng|l
见利忘义=thấy lợi quên nghĩa|l
见危授命=dũng cảm hy sinh/xả thân trong lúc nguy nan|l
见好就收=thấy tốt thì lấy/thấy đỡ thì thôi|l
见微知着=nhìn nhỏ biết lớn/kiến vi tri trứ|l
见机而作=tùy cơ mà làm/hãy làm điều đó một cách có cơ hội|l
见缝就钻=nắm bắt thời cơ, tận dụng mọi khả năng có thể|l
见识一下=mở mang kiến thức một chút/biết một chút về|l
见过世面=thấy qua việc đời|l
见过面=gặp mặt qua/từng gặp mặt|l
见钱眼红=thấy tiền mờ mắt/thấy tiền đỏ mắt|l
见风是雨=thấy đỏ tưởng chín/phiến diện/tưởng bở/thấy gió cho là có mưa|l
观一观=xem một chút|l
观者如云=người xem đông như kiến|l
观赏植物=cây cảnh/cây kiểng/bon-sai|l
解救出来=giải cứu ra|l
解析几何=hình học giải tích|l
解铃还需系铃人=cởi chuông còn cần người buộc chuông/chỉ có người thắt nút mới cởi nút được|l
言之有物=trong lời có ý sâu xa|l
言之过早=nói còn quá sớm|l
言必有中=gãi đúng chỗ ngứa|l
言情小说=tiểu thuyết tình cảm|l
言论自由=tự do ngôn luận/quyền tự do ngôn luận|l
计上心来=nảy ra ý hay/nảy ra sáng kiến|l
计中计=kế trong kế|l
计从心来=kế tòng tâm lai|l
计件工资=lương sản phẩm/trả lương theo sản phẩm|l
计价器=đồng hồ tính tiền|l
计出万全=kế hoạch chu toàn/kế hoạch chu đáo|l
计划生育=kế hoạch hoá gia đình/sinh đẻ có kế hoạch|l
计无所施=hết cách|l
计无施=Kế Vô Thi|l
讨人嫌=chọc người ghét/đáng ghét|l
讨回公道=lấy lại công đạo|l
讨论一下=thảo luận một chút|l
讨论会=thảo luận hội|l
讨论区=khu thảo luận|l
记下来=nhớ kỹ|l
记不清=nhớ không rõ|l
记不起来=không nhớ nổi/không nhớ ra được|l
记录下来=ghi chép lại/ghi chép xuống|l
记挂着=ghi nhớ lấy/tưởng nhớ|l
记过处分=ghi lại xử phạt|l
讲清楚=nói rõ|l
论资排辈=phân biệt đối xử|l
识别码=thức biệt mã|l
识文断字=hiểu biết chữ nghĩa/biết chữ/biết đọc biết viết/hay chữ|l
识时务=thức thời/thức thời vụ|l
识途老马=ngựa quen đường về|l
诉说着=nói|l
诚不=thật không|l
诚信为本=lấy tín làm gốc|l
话说回来=nói trở lại/như đã nói qua/nói đi nói lại|l
话里有话=trong lời nói có hàm ý/thoại lý hữu thoại/câu nói có hàm ý khác/có hàm ý khác/thoại lý hữu thoại (*câu nói có hàm ý khác)/lời nói mang thâm ý|l
话音未落=lời còn chưa dứt|l
误打误撞=đánh bậy đánh bạ|l
诱之以利=lấy lợi dụ|l
诱敌深入=dụ địch xâm nhập/dụ kẻ thù xâm nhập sâu|l
说一不二=nói một không hai/nói một là một/đã nói là làm/nói sao làm vậy|l
说一是一=nói một là một|l
说一说=nói một câu/nói một chút|l
说上话=nói chuyện|l
说不上=không thể nói/không thể nói rõ/không nói được/không đáng nói/không cần phải nói tới/không quan tâm tới/chẳng có giá trị/không thể nói được|l
说不上来=nói không ra/nói không được|l
说不下去=nói không được/không nói được|l
说不出口=nói không nên lời/không nói ra miệng/không nói ra được|l
说不出来=nói không nên lời/không nói ra được|l
说不定=nói không chừng/nói không chắc|l
说不得=nói không chừng/không thể nói trước/không thể/sao nói/không thể nói được/nói không ra/không sao nói hết/không biết nói thế nào|l
说不来=không hợp ý nhau/không biết nói/nói không ra|l
说不清=nói không rõ/không nói được|l
说不清楚=nói không rõ ràng|l
说不清道不明=không nói rõ được cũng không tả rõ được|l
说不的份=được phép nói không|l
说不话来=nói không ra lời|l
说不说=nói hay không/có nói hay không|l
说不过去=không thể nào nói nổi/không có cách gì có thể nói nổi/không nói được/không còn gì để nói|l
说中了=nói trúng rồi|l
说了半天=nói hồi lâu|l
说了算=định đoạt|l
说二是二=nói hai là hai|l
说人话=nói tiếng người/tiếng người nói|l
说件么=thuyết kiện yêu|l
说会话=nói chuyện|l
说到做到=nói được thì làm được/nói được là làm được|l
说到底=nói cho cùng|l
说动了=thuyết phục|l
说反话=nói dối lòng|l
说变就变=nói biến liền biến/thay đổi bất thường|l
说句实话=nói thật|l
说句话=nói một câu|l
说哈=thuyết cáp|l
说大话=nói mạnh miệng|l
说头儿=nói/chỗ nói/lí do bào chữa|l
说实话=nói thật/nói thật đi|l
说干就干=nói làm liền làm|l
说得上=nói lên được|l
说得动=thuyết phục|l
说得好=nói hay lắm/nói cho cùng/nói thật hay|l
说得有理=nói rất có lý/nói có lý|l
说得来=hợp ý/hợp ý nhau/biết ăn nói|l
说得过去=nói còn nghe được|l
说怪话=nói quái thoại|l
说文解字=thuyết văn giải tự|l
说时慢=nói thì chậm|l
说时迟=nói thì chậm|l
说时迟那时快=nói thì chậm mà xảy ra thì nhanh/nói thì chậm nhưng xảy ra rất nhanh|l
说服力=sức thuyết phục/thuyết phục lực|l
说来话长=nói rất dài dòng|l
说来说去=nói tới nói lui|l
说狠话=nói lời cay nghiệt/nói những lời cay nghiệt|l
说白了=nói trắng ra là/và nói trắng ra/nói trắng ra rồi/nói chuyện thẳng thắn|l
说真的=nói thật/nói thật chứ/Nói thật/lời thật|l
说瞎话=nói lời bịa đặt/nói mò|l
说空话=nói suông|l
说笑声=tiếng cười nói|l
说笑话=nói đùa|l
说老实话=nói thật|l
说话声=tiếng nói chuyện|l
说话算数=giữ lời nói|l
说话算话=nói lời giữ lời|l
说说看=nói một chút/nói một chút coi|l
说说笑笑=cười cười nói nói|l
说说话=trò chuyện|l
说走就走=nói đi là đi|l
说重话=nói nặng lời|l
说长论短=phê bình|l
说闲话=nói xấu/trò chuyện/tán dóc/tán gẫu/nói chuyện phiếm/nói lời dèm pha|l
诸如此类=như là loại này/mọi việc như thế/ví dụ như vậy/những điều như vậy/những ví dụ như thế này|l
谁又能=ai có thể|l
谁的车=xe của ai|l
谈不上=chưa nói tới/không thể nói là|l
谈何容易=nói nghe thì dễ/nói dễ vậy sao/có dễ gì đâu/nói thì dễ làm mới khó làm sao|l
谈古论今=chuyện trò/chuyện vãn|l
谈得上=có thể nói|l
谈论着=đàm luận/bàn luận/bàn về|l
谦逊地=khiêm tốn|l
谬以千里=đi một nghìn dặm/đi một ngàn dặm|l
谷类作物=ngũ cốc/cây ngũ cốc|l
象声词=từ tượng thanh|l
象形文字=chữ tượng hình/văn tự tượng hình|l
象牙白=trắng ngà|l
负债累累=nợ như chúa Chổm/nợ nần chồng chất|l
负担得起=gồng gánh nổi|l
财力雄厚=tài lực hùng hậu/tài chính dồi dào|l
财政危机=khủng hoảng tài chính/nguy cơ tài chính|l
败下阵来=thua trận|l
败阵下来=bại trận|l
货比三家=chọn kỹ lựa khéo/hàng hóa hơn ba nhà/so sánh mua sắm|l
货物运输=cước phí|l
货真价实=hàng thật giá thật/hàng thật đúng giá/thứ thiệt|l
货色齐全=đủ các mặt hàng|l
质优价廉=giá rẻ chất lượng tốt/chất lượng cao và giá rẻ|l
质疑问难=đưa ra chất vấn/đưa ra nghi ngờ|l
贫苦人家=nhà nghèo khổ|l
费力劳心=hao tâm tổn trí|l
费心劳力=hao tâm tổn trí|l
贾祸=chuốc hoạ/chuốc/gây hoạ|l
贾赦=Giả Xá|l
赔不是=chịu tội/chịu lỗi/nhận lỗi|l
赔小心=được lòng|l
赔本赚吆喝=bán lỗ vốn quảng cáo/mất vốn kiếm được|l
赔礼道歉=chịu nhận lỗi/nói xin lỗi|l
赞美诗=thánh ca/bài thánh ca|l
走下坡路=đi xuống dốc|l
走不动=đi không được/không nhúc nhích|l
走为上计=tẩu vi thượng kế/tẩu vi thượng sách|l
走亲访友=tẩu thân phóng hữu/thăm người thân và bạn bè/thăm bạn bè và các mối quan hệ của một người|l
走回头路=quay về lối cũ|l
走得慢=đi chậm rãi|l
走火入魔=tẩu hỏa nhập ma|l
走着瞧=chờ xem/chờ thời/hãy đợi đấy|l
走街串巷=đi khắp hang cùng ngõ hẻm|l
走访调查=thăm viếng điều tra/thăm khảo sát|l
走调儿=lạc giọng/lạc điệu|l
走起路来=đi trên đường|l
走马上任=cưỡi ngựa nhậm chức/đi nhậm chức|l
趁此机会=nhân cơ hội này|l
趁热=nhân lúc còn nóng|l
超人一等=vượt qua người ta một bậc|l
超前绝后=độc nhất vô nhị/vô tiền khoáng hậu|l
超然不群=khoáng đạt hơn người|l
超然物外=siêu nhiên vật ngoại/bàng quan/xa rời thế giới/đứng ngoài đấu tranh xã hội/đứng ngoài cuộc|l
超现实主义=chủ nghĩa siêu hiện thực|l
超群绝伦=không ai có thể so bì/siêu quần tuyệt luân/nổi bật/không thể so sánh được|l
越快越好=càng nhanh càng tốt|l
越来越少=càng ngày càng ít|l
越来越快=càng lúc càng nhanh|l
趟浑水=tranh vào vũng nước đục/giao du với kẻ xấu|l
跌宕不羁=phóng khoáng|l
跌宕起伏=trầm bổng chập trùng|l
跌打损伤=bị thương/té bị thương|l
跑上来=chạy tới|l
跑上跑下=chạy lên chạy xuống /chạy lên chạy xuống|l
跑不了=chạy không được/không chạy được|l
跑不动=không chạy nổi|l
跑出去=đi ra ngoài|l
跑前跑后=chạy trước chạy sau/chạy trước và sau|l
跑堂儿的=tiểu nhị/hầu bàn/người phục vụ bàn ăn/bồi bàn/chạy bàn/chiêu đãi viên|l
跑得快=chạy nhanh|l
跑来跑去=chạy tới chạy lui|l
跑步机=máy chạy bộ|l
跑的快=chạy nhanh|l
跑腿儿=người chạy việc/người sai vặt/người giúp việc vặt/nhân viên tạp vụ|l
跑跑步=chạy bộ|l
跑跑跳跳=ngược xuôi/thoăn thoắt/thoăn thoắt ngược xuôi|l
跑过来=chạy tới/đã chạy tới|l
跑马卖解=cưỡi ngựa diễn trò/làm trò trên lưng ngựa|l
踢出来=đá ra|l
蹲坐在=ngồi xổm ở|l
蹲马步=ngồi trên ngựa|l
身外之物=vật ngoài thân/tài sản/của cải/vật ngoại thân|l
身负重任=thân mang trọng trách/người mang trọng trách|l
躬体力行=tự mình thể nghiệm|l
躬先表率=lấy mình làm gương|l
躬行实践=tự mình thể nghiệm|l
躲来躲去=trốn đi trốn tới|l
躲猫猫=bịt mắt trốn tìm|l
躲起来=trốn đi/trốn|l
躲躲藏藏=trốn trốn tránh tránh/ẩn ẩn nấp nấp/đóa đóa tàng tàng|l
躲躲闪闪=né tránh/trốn tránh/đóa đóa thiểm thiểm/trốn trốn tránh tránh|l
躲避不了=né tránh không được/không tránh nổi|l
躲避球=bóng né/tránh bóng/ném bóng|l
躲闪不及=né tránh không kịp|l
车到山前必有路=xe đến trước núi ắt có đường/cứ đi ắt có đường/đừng ngại khó, nhất định sẽ có cách vượt qua/xe tới trước núi tất có đường|l
车匪路霸=cướp xe đường lộ|l
车轱辘话=lặp đi lặp lại/lải nhải|l
转亏为盈=chuyển lỗ thành lãi|l
转变态度=thay đổi thái độ|l
转头就走=quay đầu rời đi|l
转换器=chuyển hoán khí/bộ chuyển đổi/người chuyển đổi|l
转眼之间=trong nháy mắt/trong chớp mắt|l
转瞬之间=trong nháy mắt|l
转轮手枪=súng ngắn ổ quay|l
软下心来=cũng bị mềm lòng|l
软件业=công nghiệp Software|l
软件工程=kĩ thuật phần mềm/Software Engineering|l
软件开发=Sofware Developer|l
软体动物=động vật nhuyễn thể/động vật thân mềm|l
软着陆=hạ cánh nhẹ nhàng|l
软硬不吃=mềm không được cứng không xong|l
软硬件=cứng mềm|l
软硬兼施=vừa đấm vừa xoa/mềm rắn đủ cả|l
软磨硬泡=quấy rầy đòi hỏi/nhõng nhẽo đòi hỏi|l
软钉子=đinh mềm/móng tay mềm/một sự bắt bẻ hoặc từ chối khéo léo|l
软饮料=nước giải khát|l
输多胜少=thua nhiều thắng ít|l
辩口利舌=khéo ăn khéo nói|l
辩证逻辑=lô-gic biện chứng|l
迄今为止=cho tới nay|l
过不下去=không vượt qua nổi|l
过人之处=chỗ hơn người|l
过关斩将=quá quan trảm tướng/vào vòng trong/vượt qua khó khăn để tiến lên|l
过分劳累=quá mức cực khổ|l
过失杀人=ngộ sát/giết người không chủ định|l
过头话=nói quá mức|l
过意不去=băn khoăn/áy náy/không yên tâm|l
过敏反应=dị ứng/phản ứng dị ứng|l
过时不候=quá giờ thì không đợi/đến muộn là không thể chấp nhận được|l
过犹不及=hăng quá hoá dở/tốt quá hoá lốp/chín quá hoá nẫu/tốt quá hoá dở|l
过眼烟云=như mây như khói/qua mắt những đám mây khói/phù du|l
过而能改=biết sai mà sửa/sau đó có thể thay đổi|l
过肩摔=ném qua vai|l
过街老鼠=chuột chạy qua đường/chuột qua đường|l
过路财神=thần tài qua cửa|l
过门不入=hết lòng vì việc chung/qua cổng không vào|l
迎难而上=vượt khó tiến lên|l
迎面而来=chạm mặt tới/xông tới mặt|l
运上来=vận chuyển lên|l
运不走=không chở đi|l
运回来=chở về|l
运斤成风=tay nghề thành thạo/điêu luyện/vung búa thành gió|l
运载火箭=tên lửa vận chuyển/tên lửa chuyển tải/máy phóng/nguồn tên lửa để phóng tàu vũ trụ|l
近亲属=họ hàng gần/người thân|l
近似值=giá trị gần đúng/trị số gần đúng|l
近体诗=thơ cận thể|l
近几天=mấy ngày gần đây|l
近几年=mấy năm gần đây|l
近几年来=mấy năm gần đây|l
近几日=mấy ngày gần đây|l
近十年=mười năm gần đây/gần mười năm|l
近千人=gần ngàn người|l
近千名=gần nghìn tên|l
近在眼前=gần ngay trước mắt|l
近墨者黑=gần mực thì đen|l
近斗=cận đấu|l
近日来=ngày gần đây|l
近日里=mấy ngày gần đây|l
近百人=gần trăm người|l
近百年来=gần trăm năm nay|l
近视眼=mắt cận thị|l
近视眼镜=kiếng cận|l
近距离=khoảng cách gần/gần gũi|l
近身之战=đanh cận chiến/đánh cận chiến|l
近身战=cận chiến|l
近身来=đến gần người|l
还治其人之身=trả lại cho người|l
这一下=lần này|l
这一关=cửa này/cửa ải này|l
这一击=một kích này/đòn đánh này|l
这一式=một thức này/chiêu thức này|l
这一晚=đêm nay/một đêm này/chiều nay|l
这一来=đến lúc này|l
这一阵子=gần/mới đây|l
这下子=cái này/giá hạ tử/lần này|l
这两点=hai điểm này|l
这么一来=bởi như vậy/bởi vậy|l
这么回事=chuyện như vậy/có chuyện như vậy|l
这几天来=mấy ngày qua|l
这几年来=mấy năm qua này|l
这就是说=đây là giải thích|l
这山望着那山高=đứng núi này trông núi nọ/được voi đòi tiên|l
这年头=đầu năm nay/thời đại này|l
这杆枪=cây thương này|l
这样一来=cứ như vậy/bởi như vậy|l
这样的话=như vậy/lời như vậy/nếu như vậy/nói như vậy/lời nói như vậy|l
这步田地=tình cảnh như thế này/mức độ này|l
这段话=đoạn văn này|l
这群人=đám người này/đám người kia|l
这般光景=quang cảnh như vậy|l
这辈子=đời này|l
这边儿=bên này|l
这阵子=trận này|l
远不止=xa không chỉ/hơn xa|l
远嫁他乡=viễn giá tha hương|l
远程教育=viễn trình giáo dục|l
远道而来=từ xa mà đến/và đi từ xa/từ xa đến|l
违法乱纪=phạm pháp loạn kỷ cương/vi pháp loạn kỷ|l
违法行为=hành động trái luật|l
违章建筑=xây dựng trái phép|l
连为一体=nối liền thành một thể|l
连在一起=liền cùng một chỗ/nối liền cùng nhau|l
连成一气=liền thành một mạch|l
连成一片=nối thành một mảnh/liền thành một vùng|l
连接器=dụng cụ kết nối|l
连接处=chỗ nối tiếp|l
连接线=liên tiếp tuyến|l
连接起来=liên tiếp/liên tiếp lại|l
连日来=mấy ngày liên tiếp|l
连本带利=cả gốc lẫn lãi|l
连根拔起=nhổ tận gốc|l
连爬带滚=vừa bò vừa lăn|l
连环套=bẫy liên hoàn|l
连环画=tranh liên hoàn|l
连环计=liên hoàn kế/kế liên hoàn|l
连累到=liên lụy đến|l
连续函数=hàm số liên tục/chức năng liên tục|l
连绵不绝=liên miên bất tuyệt|l
连绵起伏=liên miên chập trùng/liên miên trùng điệp|l
连衫帽=áo trùm đầu|l
连跑带跳=vừa chạy vừa nhảy|l
连蹦带跳=nhảy tung tăng|l
连轴转=làm liên tục không nghỉ suốt ngày đêm/làm liên tục/làm không nghỉ|l
连载中=vẫn đang còn tiếp|l
连通器=bình thông nhau|l
连锁反应=phản ứng dây chuyền/phản ứng dây chuyền|l
连骨带皮=cả da lẫn xương|l
连鬓胡子=râu xồm/râu quai nón|l
迷了路=lạc đường|l
迷幻药=mê huyễn dược/thuốc gây ảo giác/chất gây ảo giác|l
迷彩服=đồ rằn ri/trang phục ngụy trang/trang phục sặc sỡ|l
迷彩色=đồ đổi màu ngụy trang|l
迷惑不解=cảm thấy lẫn lộn|l
迷神阵=Mê Thần Trận|l
迷走神经=thần kinh phế vị/thần kinh mê tẩu|l
迷迭香=Mê Điệt Hương/Rosemary|l
追到手=đuổi tới tay|l
追回来=đuổi trở về|l
追本溯源=truy bản tố nguyên/truy bản tố nguyên (tìm nguồn gốc)|l
追根溯源=truy căn tố nguyên|l
追根问底=truy hỏi căn nguyên|l
追过来=đuổi tới|l
追随着=đi theo/đuổi theo|l
追风逐电=lao nhanh/chạy như bay/nhanh như gió chớp|l
退一退=lui một chút|l
退可守=lui có thể thủ|l
退回去=lui về|l
退居二线=thối cư nhị tuyến/lùi lại tuyến hai/từ chức một vị trí lãnh đạo|l
退避三舍=nhượng bộ lui binh/nhượng bộ đối phương|l
送信儿=đưa tin/báo tin|l
送礼物=tặng quà|l
送话器=máy chuyển âm|l
送过来=đưa tới|l
送风机=quạt gió|l
适时地=đúng lúc đó|l
适者生存=kẻ phù hợp mới có thể sinh tồn|l
透不过气=thở không nổi/thở không thông|l
透心凉=xuyên tim/lạnh xuyên tim|l
透进来=xuyên thấu vào|l
递回去=trả lại|l
递条子=đưa thư tay/gửi thư tay|l
递眼色=nháy mắt/đưa mắt ra hiệu|l
递过来=đưa qua/tới/đưa tới|l
通不过=không thông qua|l
通人言=thông tiếng người|l
通俗歌曲=bài hát phổ biến/bài hát phổ thông/ca nhạc phổ thông|l
通信工程=Kỹ Thuật Truyền Thông/Communications Engineering|l
通力合作=chung sức hợp tác|l
通情达理=thông tình đạt lý/thấu tình đạt lý/hợp tình hợp lý|l
通权达变=tuỳ cơ ứng biến/linh động/linh hoạt|l
通电话=thông điện thoại/cú điện thoại|l
通话器=máy bộ đàm/micro/intercom|l
通货紧缩=thắt chặt tiền tệ|l
通货膨胀=lạm phát|l
通货膨胀率=tỷ lệ lạm phát|l
通路子=đường đi/con đường|l
通风口=miệng thông gió/lổ thông hơi/lỗ thông gió|l
通风报信=mật báo/mật báo tin tức/bắn tin/thông phong báo tin|l
通风管道=đường ống thông gió|l
通风道=đường thông gió|l
逞威风=ra vẻ ta đây/ta đây|l
逞性子=phóng túng/buông thả|l
逞英雄=cậy anh hùng|l
逢场作戏=gặp dịp thì chơi/góp vui lấy lệ/thỉnh thoảng gặp dịp mua vui|l
逢年过节=ngày lễ ngày tết/dịp lễ tết/phùng niên quá tiết|l
逢甲=phùng giáp|l
逻辑思维=tư duy logic|l
逼供信=bức cung|l
逼肖=giống như in/giống như lột/như tạc/rất giống|l
遗留下来=còn sót lại/để lại|l
遣送出境=trục xuất|l
遥相呼应=hô ứng lẫn nhau/hấp dẫn lẫn nhau|l
遮挡住=che kín/che đỡ|l
遮眼法=thuật che mắt/thủ đoạn che mắt|l
遮风挡雨=che gió che mưa/che phong chắn vũ|l
遮风避雨=che gió tránh mưa|l
遵守规则=tuân thủ quy tắc/tuân thủ các quy tắc|l
遵纪守法=tuân thủ luật pháp/tuân kỷ thủ pháp|l
避凶趋吉=tránh họa cầu phúc/tránh hung dữ xung cát|l
避而不答=tránh không đáp|l
避避风头=tránh đầu gió/tị tị phong đầu/tránh né khó khăn|l
避难就易=lánh nặng tìm nhẹ/tránh khó chọn dễ|l
那么出色=xuất sắc như vậy|l
那么回事=có chuyện như vậy/chuyện như vậy|l
那件事=sự kiện kia/sự kiện nào|l
那就好=vậy là tốt rồi/vậy thì tốt|l
那就算了=vậy thì thôi|l
那怎么行=như vậy sao được|l
那样一来=bởi như vậy|l
那样的话=như vậy/nói như vậy/nói vậy|l
那管家=Quản gia kia/quản gia kia|l
那还用说=đó còn cần phải nói|l
邪门歪道=tà môn ma đạo/con đường bất chính/tà môn ngoại đạo|l
醒过来=tỉnh lại|l
里三层外三层=trong ba tầng ngoài ba tầng|l
里出外进=khập khiễng/không đều/so le|l
里外不是人=trong ngoài không phải nhân|l
里里外外=trong trong ngoài ngoài|l
重中之重=quan trọng nhất|l
重修旧好=nối lại tình xưa/khôi phục quan hệ|l
重新认识=nhận thức lại|l
重机关枪=súng đại liên/đại liên|l
重温旧梦=ôn chuyện cũ/nhớ lại chuyện xưa/làm sống lại giấc mơ cũ|l
重点高中=trường chuyên cấp 3|l
重装系统=cài đặt lại hệ thống/gắn lại hệ thống|l
重要讲话=trọng yếu giảng thoại|l
野调无腔=ăn nói thiếu lễ độ|l
量不多=lượng không nhiều|l
量力而为=làm theo khả năng/liệu sức mà làm|l
量子力学=cơ học lượng tử|l
量身定做=đo thân mà làm/đo ni đóng giày|l
金幼孜=Kim Ấu Tư|l
钓一钓=câu một chút/câu một cái|l
钢筋铁骨=cương cân thiết cốt|l
铁肩担道义=bờ vai gánh đạo nghĩa/thiết kiên đam đạo nghĩa|l
铁骨铮铮=thẳng thắn cương nghị/xương cốt cứng rắn|l
铭记在心=ghi nhớ trong lòng|l
链式反应=phản ứng dây chuyền/phản ứng chuỗi/Phản ứng dây chuyền|l
锃光瓦亮=bóng loáng/sáng bóng|l
锄强扶弱=trừ bạo giúp kẻ yếu/đánh kẻ mạnh, giúp kẻ yếu/sừ cường phù nhược/đánh mạnh giúp yếu|l
锅碗瓢盆=nồi niêu xoong chảo/nồi và chảo/Nồi niêu xoong chảo|l
锐不可当=duệ không thể đỡ|l
长不大=không lớn được/chưa trưởng thành|l
长久之计=kế lâu dài/kế hoạch lâu dài|l
长久以来=trải qua thời gian dài|l
长嘘短叹=trường hư đoản thán|l
长夜漫漫=đêm dài đằng đẵng|l
长年累月=quanh năm suốt tháng/năm này tháng nọ|l
长时间=thời gian dài|l
长明不熄=sáng mãi không tắt|l
长期以来=từ xưa tới nay|l
长期投资=đầu tư lâu dài|l
长歌善舞=trường ca thiện vũ|l
长歌当哭=dùng thơ văn để giải toả nỗi buồn/trường ca thay nước mắt|l
长此下去=kéo dài như thế|l
长此以往=cứ thế mãi/cứ như vậy mãi|l
长江上游=thượng du sông Trường Giang|l
长江后浪推前浪=trường giang sóng sau đè sóng trước/sóng sau sông Dương Tử đẩy sóng trước/không ngừng phát triển|l
长治久安=trường trị cửu an|l
长生不死=trường sinh bất tử|l
长生不老=trường sinh bất lão/trường sinh bất lão/trẻ mãi không già|l
长生久视=trường sinh cửu thị|l
长盛不衰=trường thịnh không suy|l
长短句=trường đoản cú/từ|l
长筒枪=nòng súng dài|l
长篇大论=thao thao bất tuyệt/tràng giang đại hải|l
长篇小说=tiểu thuyết dài/truyện dài/tiểu thuyết trường thiên|l
长而利=vừa dài vừa bén|l
长而尖=dài mà nhọn|l
长胡子=râu dài/mọc râu|l
长见识=mở mang hiểu biết|l
长话短说=nói ngắn gọn/nói tóm lại/nói nội dung chính/nói tóm tắt|l
长足进步=tiến bộ nhảy vọt|l
长远打算=tính toán lâu dài|l
长途汽车=ôtô đường dài|l
长途电话=điện thoại đường dài/cuộc gọi đường dài/Điện thoại đường dài|l
长途车=xe đường dài|l
闭上嘴=im lặng|l
闭上眼=nhắm mắt lại|l
闭不拢嘴=không thể ngậm miệng|l
闭关政策=chính sách bế quan toả cảng|l
闭关锁国=bế quan toả cảng|l
闭合电路=mạch điện khép kín|l
闭路电视=truyền hình cáp/hệ thống truyền hình cáp|l
闭门思过=bế môn hối lỗi/nghiền ngẫm lỗi lầm/suy nghĩ lỗi lầm/đóng cửa suy nghĩ lỗi lầm|l
闭门造车=đóng cửa làm xe/bế môn tạo xa/nhắm mắt làm liều/xa rời thực tế/đóng cửa làm xe không quan sát đường sá/xa rời thực tế, nhắm mắt làm liều|l
问一问=hỏi một chút/hỏi một câu|l
问来问去=hỏi tới hỏi lui|l
问这问那=hỏi cái này hỏi cái kia|l
闯南走北=đi khắp nơi/đi nhiều nơi|l
闯荡江湖=xông xáo giang hồ/mới bước chân vào giang hồ|l
闯过去=vượt qua/xông qua|l
闯过来=xông tới|l
闯进来=xông tới|l
闲下来=rảnh rỗi|l
闲杂人等=người không có phận sự/những người không có nhiệm vụ/những người không có liên quan|l
闲着没事=nhàn rỗi không chuyện gì|l
闲磕牙=nói chuyện phiếm/tán gẫu|l
间不容发=cực kỳ nguy cấp/suýt xảy ra tai nạn|l
间不容息=không kịp thở/không thể dừng lại|l
间接选举=tuyển cử gián tiếp|l
闷亏=thua thiệt ngầm/im ỉm thiệt thòi|l
闷声不响=giữ yên lặng|l
闷头儿=cố gắng ngầm/phấn đấu lặng lẽ|l
闷葫芦=muộn hồ lô/bí ẩn làm người ta phát bực/hũ nút/bí ẩn/khó hiểu|l
闹乱子=gây hoạ/gây rắc rối|l
闹意见=giận nhau/bất hoà/xích mích/không bằng lòng với nhau|l
闹矛盾=xào xáo/mâu thuẫn/Cuộc xung đột|l
闹笑话=làm trò cười|l
闹翻天=nháo lật trời|l
闹肚子=tiêu chảy/tháo dạ/đi lỏng|l
闻名于世=nổi danh trên đời|l
闻过则喜=vui mừng được nghe góp ý/vui lòng tiếp thu lời phê bình của mọi người|l
闻风而动=nghe tin lập tức hành động/nghe thấy liền làm ngay|l
闻风而来=nghe thấy mà đến|l
阖不拢嘴=cười toe toét|l
防人之心=ý đề phòng người khác|l
防卫过当=phòng vệ quá đáng/phòng thủ quá mức/tự vệ quá mức|l
防抗之力=sức phản kháng|l
防护系统=hệ thống phòng vệ|l
防暴警察=cảnh sát chống bạo động|l
防毒面具=mặt nạ phòng độc|l
防民之口=phòng miệng dân|l
防身术=thuật phòng thân|l
阴冥力=Âm Minh lực|l
阴盛阳衰=âm thịnh dương suy|l
阶级斗争=đấu tranh giai cấp|l
除我之外=trừ ta ra|l
除旧布新=phá cũ, xây mới/đập cũ xây mới/xoá cũ lập mới|l
除此以外=ngoại trừ/ngoài ra/trừ này ra|l
险之又险=hiểm lại càng hiểm|l
险恶用心=dụng tâm hiểm ác|l
险象环生=hiểm tượng hoàn sinh/cực kỳ nguy hiểm/ngàn cân treo sợi tóc|l
陷般=giống như hãm vào|l
陷落地震=động đất sạt lở|l
随之而来=theo tới|l
随从人员=nhân viên tùy tùng|l
随他而动=chuyển động theo hắn|l
随你便=tùy theo ngươi|l
随便说说=tùy tiện nói một chút|l
随到随考=cứ đến là kiểm tra|l
随叫随到=gọi lên liền đến|l
随处可见=tuỳ ý có thể thấy/có thể được tìm thấy ở khắp mọi nơi/Khắp mọi nơi|l
随意肌=cơ ngang/cơ vân|l
随时奉陪=tùy thời phụng bồi/luôn sẵn sàng tiếp đón|l
随时随地=tùy thời tùy chỗ/bất cứ lúc nào bất cứ nơi đâu|l
随遇而安=gặp sao yên vậy/thích ứng trong mọi tình cảnh/thoả mãn trong mọi tình cảnh/tùy ngộ nhi an|l
隐形眼镜=kính sát tròng|l
隐形飞机=máy bay tàng hình|l
隐隐作痛=lẩm rẩm đau/đau đớn|l
隔三岔五=thường thường|l
隔三差五=thường thường/luôn luôn/thường/cách tam soa ngũ|l
隔夜饭=bữa cơm đêm qua|l
隔空取物=Cách không thủ vật|l
隔行如隔山=khác nghề như cách núi/không trong nghề không biết tình hình nghề đó/cách hành như cách sơn|l
隔音材料=tài liệu cách âm|l
难为人=gây khó cho người ta|l
难为情=thẹn thùng/xấu hổ/ngượng ngùng/khó xử/khó nghĩ|l
难于上青天=khó như lên trời|l
难以形容=khó mà hình dung nổi|l
难以忍受=khó mà chịu đựng/không thể chịu đựng được/khó chịu đựng|l
难以想象=khó có thể tưởng tượng|l
难以承受=khó có thể chịu đựng|l
难以避免=khó mà tránh khỏi|l
难兄难弟=cá mè một lứa/anh không ra anh, em không ra em/một giuộc/người cùng cảnh ngộ/người cùng hội cùng thuyền/bạn khố rách áo ôm/nan huynh nan đệ|l
难分上下=khó phân cao thấp|l
难分难解=khó hoà giải/khó giải quyết/khó chia cắt/khó phân chia/khó chia lìa|l
难解难分=khó phân thắng bại|l
难道真=thật chẳng lẽ/lẽ nào thật sự|l
难道说=chẳng lẽ nói|l
雅俗共赏=sang hèn cùng hưởng/sang hèn cùng thưởng thức|l
集体所有制=chế độ sở hữu tập thể|l
集合起来=tập hợp|l
雌伏=thư phục|l
雌性激素=kích thích tố sinh dục nữ/nội tiết tố nữ/oestrogen|l
雌激素=estrogen/oestrogen|l
雌雄同体=loài lưỡng tính/lưỡng tính đồng thể/đực cái đồng thể|l
雌雄同株=cây lưỡng tính|l
雌雄异体=loài đơn tính|l
雕栏玉砌=điêu lan ngọc thế|l
雨点般=như mưa rơi/mưa rơi|l
雷鸣电闪=sấm chớp/sấm vang chớp giật|l
霸王别姬=Bá Vương Biệt Cơ|l
青春年少=thanh xuân tuổi trẻ|l
青眼有加=có phần coi trọng|l
青睐有加=càng thêm xem trọng|l
青红皂白=xanh đỏ đen trắng/phải trái đúng sai/phải trái/thanh hồng tạo bạch/đúng sai phải trái|l
静下心来=ổn định lại tâm thần/tĩnh hạ tâm lai/tĩnh hạ tâm lai (*)/bình tĩnh lại tâm tình|l
静下来=yên tĩnh/tĩnh lặng - lại/lắng xuống|l
静中有动=trong tĩnh có động|l
静心思过=tĩnh tâm suy nghĩ|l
静摩擦力=lực ma sát tĩnh|l
静极思动=tĩnh cực tư động|l
静电屏蔽=che chắn tĩnh điện|l
静电感应=cảm ứng tĩnh điện|l
静脉曲张=giãn tĩnh mạch/chứng giãn tĩnh mạch|l
静脉注射=tiêm tĩnh mạch|l
静观其变=yên lặng theo dõi kỳ biến/yên lặng xem biến đổi|l
非他莫属=trừ hắn ra không còn có thể là ai khác|l
非你不可=không thể không có ngươi/không phải bạn không thể|l
非你莫属=trừ ngươi ra không còn có thể là ai khác|l
非同一般=không phải bình thường/không giống bình thường|l
非同凡响=không phải tầm thường|l
非常少=vô cùng ít ỏi/ít vô cùng/phi thường ít ỏi|l
非常重视=phi thường trọng thị|l
非必要=không tất yếu|l
非我族类=không phải tộc loại của ta/không phải chủng tộc ta|l
非我莫属=trừ ta ra không còn có thể là ai khác|l
非暴力=không bạo lực|l
非池中物=không phải vật trong ao|l
非法交易=giao dịch phi pháp|l
非要不可=không thể không cần|l
非跑不可=không thể không chạy|l
靠拢过来=áp sát tới|l
面不改容=mặt không đổi sắc|l
面不改色=mặt không đổi sắc/mặt không biến sắc|l
面冷如水=mặt lạnh như nước|l
面带微笑=mặt mỉm cười|l
面疙瘩=bún mọc/mì viên|l
面面俱到=chu đáo/chu toàn/chú ý đến mọi mặt|l
音信全无=bặt vô âm tín|l
须弥芥子=Tu Di giới tử|l
须臾之间=trong chốc lát|l
顾不上=không để ý tới/chẳng quan tâm|l
顾不了=không cố được/không thể quan tâm/Không thể quan tâm/không coi quản hết được|l
顾左右而言他=nói lảng nói tránh/đánh trống lảng/cố trái phải mà nói hắn|l
顾得上=lo lắng|l
预料之中=trong dự liệu/như đã đoán trước|l
预料到=dự liệu được|l
领会到=lĩnh hội tới|l
领教过=lĩnh giáo qua/lãnh giáo qua|l
颇具规模=quy mô khá lớn|l
颇有微辞=rất có phê bình kín đáo|l
颦眉=nhăn mày|l
风紧扯呼=không xong chạy mau|l
飘下来=đáp xuống|l
飘忽不定=lơ lửng không cố định|l
飘起来=phiêu lên/phiêu/bay lên|l
飞回来=bay trở về|l
飞过来=bay tới/bay đến|l
食不甘味=ăn không biết ngon/thực bất tri kỳ vị/ăn không ngon|l
食不知味=ăn không biết ngon/thức ăn không biết mùi/ăn mà không nếm thức ăn|l
食古不化=cổ hủ/thông thái rởm/ăn thức ăn mà không tiêu hoá được|l
食指大动=thèm ăn nhỏ dãi/miệng ăn liên tục|l
食欲不振=không muốn ăn|l
食物中毒=ngộ độc thức ăn/ngộ độc ăn uống|l
食用植物=thực vật ăn được|l
食肉动物=động vật ăn thịt|l
饥肠辘辘=bụng đói kêu vang/cơ tràng lộc lộc/bụng đói cồn cào|l
饱和状态=trạng thái bão hòa|l
饱学之士=học thức uyên bác/những người học tập no|l
饱汉不知饿汉饥=người no không biết đói/no hán không biết đói hán đói/Người được ăn no không thể biết người chết đói khổ như thế nào.|l
饶有兴味=rất có hứng thú|l
饶有兴致=có chút hăng hái/đầy hứng thú|l
饶有兴趣=nhiều hứng thú/rất hứng thú|l
饶有风趣=nhiều lí thú/rất hài hước/sôi sục với sự hài hước/dí dỏm và thú vị|l
饿着肚子=đói bụng|l
香气扑鼻=mùi thơm nức mũi|l
马路上=trên đường cái/lối đi bộ|l
驰骤=rong ruổi/phi/chạy nhanh|l
驴打滚=lư đả cổn/cho vay nặng lãi/thịt tẩm bột rán/lư đả cổn (lăn qua lăn lại) (cho vay nặng lãi)/lãi mẹ đẻ lãi con/món thịt tẩm bột rán|l
骂不动=chửi không nổi|l
骄者必败=kiêu giả tất bại/niềm kiêu hãnh đi trước khi sụp đổ|l
骨软筋麻=sức cùng lực kiệt/tê gân cốt|l
高不成低不就=cao không được thấp không xong/cao không với tới, thấp không bằng lòng/cao không được thấp không phải là được/Cao không với tới/thấp không bằng lòng|l
高中时代=thời trung học|l
高举着=giơ cao lên/giơ cao|l
高人一等=hơn người một bậc/tài trí hơn người/cao hơn người một bậc|l
高低不平=cao thấp nhấp nhô|l
高吭=giọng cao/giọng thánh thót|l
高姿态=khoan dung/thông cảm/cao thượng/cao quý/phong cách cao|l
高层建筑=nhà cao tầng/nhà chọc trời|l
高山仰止=ngưỡng mộ núi cao|l
高度重视=cao độ coi trọng|l
高开低走=đầu voi đuôi chuột/đi cao và thấp/bắt đầu thì cao/sau thì đi xuống/thường chỉ giá cả chứng khoán trong ngày/giá bắt đầu buổi sáng thì cao/càng về sau càng thấp cho đến chốt phiên giao dịch trong ngày.|l
高攀不上=trèo cao không được/leo cao không thể/không xứng đáng để kết giao với|l
高攀不起=không với cao nổi|l
高朋满座=khách quý chật nhà/khách đến rất đông|l
高歌猛进=hát vang tiến mạnh/cao ca mãnh tiến|l
高清晰度=độ rõ nét cao|l
高等动物=động vật bậc cao|l
高等学校=trường trung học/trường cấp 3|l
高等教育=giáo dục cao đẳng|l
高等植物=thực vật bậc cao|l
高等院校=cao đẳng viện giáo|l
高级小学=tiểu học cao đẳng|l
高级顾问=cố vấn cao cấp|l
高难度=độ khó cao|l
高高在上=cao cao tại thượng/ăn trên ngồi trước/chỉ tay năm ngón/ngồi tít trên cao/xa rời quần chúng|l
鬼鬼崇崇=lén lén lút lút/quỷ quỷ sùng sùng|l
魂牵梦萦=nhớ thương/nhớ mong/thương nhớ/nhớ nhiều|l
鸡皮疙瘩=nổi da gà/sởn gai ốc|l
鸡蛋清=lòng trắng trứng/lòng trắng trứng gà/Lòng trắng trứng|l
鸡飞蛋打=gà bay trứng vỡ/xôi hỏng bỏng không/mất cả chì lẫn chài|l
鹅蛋脸=mặt trứng ngỗng|l
黄巢起义=khởi nghĩa Hoàng Sào|l
黄巾之乱=loạn Hoàng Cân/loạn khăn vàng|l
黄昏时分=đang lúc hoàng hôn/lúc hoàng hôn|l
黄金分割=tỉ lệ vàng/trung ngoại tỉ/tỉ thức hoàng kim/tỉ lệ hoàng kim|l
黑吃黑=đen ăn đen|l
黑暗时代=thời đại hắc ám|l
黑板擦=khăn lau bảng/bảng đen lau/Khăn lau bảng|l
黑白不分=không phân trắng đen|l
黑色链条=dây xích đen|l
黑蚂蚁=kiến đen|l
默不作声=giữ im lặng/im lặng không lên tiếng|l
默墨=Mặc Mặc|l
黯淡下来=ảm đạm xuống/ảm đạm đi|l
黯然销魂=ảm nhiên tiêu hồn/vô cùng bi thương/ảm đạm tiêu hồn/nỗi buồn ngập tràn/nỗi buồn khi chia tay|l
鼓噪声=cổ táo thanh|l
鼻青眼肿=mắt mũi sưng bầm|l
鼻青脸肿=mặt mũi bầm dập/sưng mặt sưng mũi|l
齐家治国平天下=tề gia trì quốc bình thiên hạ|l
齐心合力=tề tâm hợp lực|l
齐步走=đi đều bước|l
齐民要术=Tề Dân Yếu Thuật|l
齐眉棍=Tề Mi Côn|l
齐腕而断=đứt từ cổ tay|l
齿白唇红=răng trắng môi hồng|l
