一=nhất|m
一一=từng cái/nhất nhất/từng việc|m
一丁点=một chút xíu|m
一丁点儿=tí xíu/tí tẹo|m
一万=một vạn/10 ngàn|m
一万一千=một vạn một ngàn/11,000|m
一万七千多=hơn một vạn bảy ngàn/hơn 17,000|m
一万三千=một vạn ba ngàn/13,000|m
一万两=một vạn lượng|m
一万两万=mộtt vạn hai vạn/một vạn hai vạn|m
一万两千=một vạn hai ngàn/12,000|m
一万二千=một vạn hai ngàn/12,000|m
一万二千余=hơn 12,000|m
一万五千余=hơn một vạn năm ngàn|m
一万五千多=hơn một vạn năm ngàn/hơn 15,000|m
一万亿=một ngàn tỷ/1000 tỉ|m
一万余=hơn một vạn|m
一万倍=gấp một vạn lần|m
一万六千多=hơn một vạn sáu ngàn/hơn 16,000|m
一万只=một vạn con|m
一万四千=một vạn bốn ngàn/14,000|m
一万块=một vạn khối/một vạn tệ|m
一万多=hơn một vạn|m
一万多两=hơn một vạn lượng|m
一万多只=hơn một vạn con|m
一万多年=hơn một vạn năm|m
一万年=một vạn năm/mười ngàn năm|m
一万张=một vạn tấm|m
一万次=một vạn lần|m
一万遍=một vạn lần|m
一万里=một vạn dặm|m
一丈=một trượng|m
一三=một ba/một, ba|m
一上台=vừa lên đài|m
一上场=vừa vào sân/vừa ra sân|m
一下=một chút/một cái/vừa hạ/thoáng cái/một lần/thoáng một phát/một tý/thử xem/bỗng chốc/một thoáng|m
一下下=từng cái/một cái/một chút|m
一下四周=bốn phía một cái|m
一下子=lập tức/thoáng cái|m
一丛丛=từng bụi từng bụi/một bụi cây|m
一丝=một tia/một chút/một ít|m
一丝一毫=một tơ một hào/mảy may/tơ hào/một tí|m
一两=một hai/một lượng|m
一两万=một hai vạn/10, 20 ngàn|m
一两下=một hai cái/một hai lần|m
一两件=một hai kiện|m
一两倍=một hai lần|m
一两分=một hai phần/một hai phân|m
一两分钟=một hai phút|m
一两千=một hai ngàn|m
一两口=một hai ngụm|m
一两句=một đôi lời|m
一两只=một hai con|m
一两周=1-2 tuần|m
一两场=một hai trận|m
一两块=một hai khối|m
一两声=một hai tiếng|m
一两处=một hai nơi|m
一两天=một hai ngày|m
一两家=một hai nhà|m
一两尺=một hai xích|m
一两岁=một hai tuổi|m
一两年=một hai năm|m
一两成=một hai thành/một hai thành|m
一两手=một bản lĩnh|m
一两招=một hai chiêu|m
一两日=một hai ngày|m
一两月=một hai tháng|m
一两本=một hai bản|m
一两枚=một hai cái/một hai quả|m
一两株=một hai gốc|m
一两样=một hai dạng|m
一两次=một hai lần|m
一两步=một hai bước|m
一两百=một hai trăm|m
一两百万=một hai trăm vạn/1,2 triệu|m
一两碗=một hai bát|m
一两秒=một hai giây|m
一两米=hơn hai thước/một hai mét|m
一两辆=một hai chiếc|m
一两重=một hai trọng|m
一两项=một hai hạng|m
一两颗=một hai khỏa|m
一个=một cái/một/một đứa/một chiếc/Một. ◇Tam quốc diễn nghĩa 三國演義: Hốt kiến thảo pha tả trắc chuyển xuất nhất cá thiếu niên tướng quân 忽見草坡左側轉出一個少年將軍|m
一个个=từng cái/từng cái từng cái/từng cái một/nguyên một đám/đám|m
一个亿=một trăm triệu/một cái ức|m
一个亿万=một cái ức vạn|m
一个半月=nửa tháng|m
一个团=một đoàn|m
一个圈=một vòng tròn/một vòng|m
一个多=hơn một cái/hơn một/một cái nhiều|m
一个多月=hơn một tháng|m
一个头=một cái đầu|m
一个套=một cái lồng/một cái đeo|m
一个床=một cái giường|m
一个月=một tháng|m
一个样=cùng một dạng/một cái gì đó|m
一个样儿=một dạng|m
一个班=một lớp|m
一个角=một cái sừng/một góc|m
一个身=cả người/một người|m
一个零=một số 0/một số không|m
一串=một chuỗi|m
一久=một lúc lâu|m
一九七一年=năm 1971|m
一九七七年=Năm 1977/năm 1977|m
一九七二年=năm 1972|m
一九七六=1976|m
一九九一年=năm 1991|m
一九九七年=năm 1997|m
一九九三=1993|m
一九九三年=năm 1993|m
一九九九年=năm 1999/năm một nghìn chín trăm chín mươi chín|m
一九九五年=năm 1995|m
一九九八年=năm 1998|m
一九九六年=năm 1996|m
一九九四年=năm 1994/năm một chín chín tư|m
一九五零年=năm 1905|m
一九八七年=năm 1987|m
一九八四年=1984|m
一九四二=một ngàn chín trăm bốn mươi hai|m
一九四八年=năm 1948|m
一二=một hai/một ... hai .../một vài/một ít/một, hai|m
一二一=một hai một|m
一二万=một, hai vạn|m
一二三=một hai ba|m
一二十=một hai chục/một hai mươi/mười, hai mươi|m
一二十两=một hai chục lượng|m
一二十米=một hai chục mét/mười, hai mươi mét|m
一二十里=mười, hai mươi dặm|m
一二千=một, hai ngàn|m
一二只=một hai con|m
一二品=nhất nhị phẩm|m
一二天=một hai ngày|m
一二层=một hai tầng|m
一二成=một, hai phần mười|m
一二根=một, hai cây|m
一二次=một hai lần|m
一二百=một hai trăm/một, hai trăm|m
一二百万=1,2 triệu|m
一二百米=một, hai trăm mét|m
一二百里=một hai trăm dặm/một, hai trăm dặm|m
一二里=một, hai dặm|m
一五一十=một năm một mười/nhất ngũ nhất thập/đầu đuôi gốc ngọn/rõ ràng mười mươi|m
一些=một chút/một số/một ít/chút/một phần/mấy/hơi/nhất ta|m
一人下=dưới một người|m
一亿=một trăm triệu/1 ức/10.000 vạn/một trăm triệu|m
一亿一千多万=hơn 110 triệu|m
一亿七千万=170 triệu|m
一亿三千万=130 triệu|m
一亿两千万=một ức hai ngàn vạn/120 triệu|m
一亿二千万=120 triệu|m
一亿五千万=150 triệu|m
一亿多=hơn một ức|m
一亿多年=hơn một trăm triệu năm|m
一亿零五百万=105 triệu|m
一代=một đời/nhất đại/đời thứ nhất|m
一代代=nhiều đời/từng đời một|m
一件=nhất kiện/một kiện/một món/một cái|m
一任=một nhiệm kỳ/một đời/mặc cho/để mặc|m
一份=một phần|m
一伙=một đám/một người/một nhóm|m
一会=một hồi/một hội|m
一会儿=một hồi/trong chốc lát/một chốc/một lát/lát nữa/lúc thì... lúc thì/một lúc|m
一位=một vị|m
一例=như nhau/đồng loạt/một lệ|m
一倍=gấp đôi/một lần|m
一元=một nguyên/Nhất Nguyên|m
一兜=bao trùm|m
一具=một bộ/một cỗ/một|m
一册=một quyển|m
一出=mới ra/một màn|m
一出场=vừa ra trận|m
一刀=một đao/một xấp/nhất đao|m
一分=một điểm/một phần/chia ra/1%/một phút|m
一分一毫=một phân một hào|m
一分一秒=từng giây từng phút/một giây một phút|m
一分钟=một phút đồng hồ/một phút|m
一列=một hàng|m
一则=một cái/một thì/thứ nhất|m
一刻=một khắc/nhất khắc/phút chốc/khoảnh khắc|m
一刻千金=một khắc ngàn vàng/một khoảnh khắc thiên kim/mỗi phút đều có giá trị|m
一刻起=bắt đầu từ thời khắc đó|m
一刻钟=một khắc đồng hồ/một khắc/mười lăm phút|m
一副=một bộ/nhất phó|m
一勺=một muỗng|m
一包=một bao/một bọc|m
一匹=một thớt/một|m
一十=mười|m
一十七=mười bảy|m
一十三=mười ba|m
一十九=mười chín|m
一十二=mười hai|m
一十五=mười năm/mười lăm|m
一十五里=mười lăm dặm|m
一十八=mười tám|m
一十六=mười sáu|m
一千=một ngàn/một nghìn|m
一千一万个=một ngàn một vạn|m
一千一百=một ngàn một trăm/1100/1,100|m
一千一百八十=1,180|m
一千万=một ngàn vạn/mười triệu|m
一千万两=mười triệu lượng|m
一千万年=một ngàn vạn năm|m
一千三百=một ngàn ba trăm|m
一千三百多年=hơn 1,300 năm|m
一千两=một ngàn lượng/một ngàn lạng|m
一千两百=một ngàn hai trăm/1,200|m
一千二百=một ngàn hai trăm/1200/1,200|m
一千二百两=một ngàn hai trăm lượng|m
一千二百多=hơn một ngàn hai trăm/hơn 1,200|m
一千二百多万=hơn 12 triệu|m
一千二百多年=hơn 1,200 năm|m
一千二百里=một ngàn hai trăm dặm/1,200 dặm|m
一千五=một ngàn rưỡi|m
一千五百=một ngàn năm trăm/1500/1,500|m
一千五百万=một ngàn năm trăm vạn/15 triệu|m
一千五百两=một ngàn năm trăm lượng|m
一千五百多=hơn một ngàn năm trăm/hơn 1,500|m
一千五百米=một ngàn năm trăm mét/1500m/1,500 mét|m
一千五百里=một ngàn năm trăm dặm/1500 dặm/1,500 dặm|m
一千亿=1000 ức|m
一千份=một ngàn bản|m
一千余=hơn một ngàn|m
一千余里=hơn một ngàn dặm|m
一千元=một nghìn đồng|m
一千八百=một ngàn tám trăm/1800/1,800|m
一千八百多年=hơn 1,800 năm|m
一千六百五十=1650/1,650|m
一千分=một ngàn điểm|m
一千只=một ngàn con/một ngàn cái/1,000 con|m
一千四百=một ngàn bốn trăm/1400/1,400|m
一千四百多=hơn một ngàn bốn trăm/hơn 1,400|m
一千四百多年=hơn 1,400 năm|m
一千多=hơn một ngàn|m
一千多万=hơn một nghìn vạn/hơn mười triệu/hơn 10 triệu|m
一千多匹=hơn một ngàn con|m
一千多只=hơn 1,000 con|m
一千多年=hơn một ngàn năm|m
一千多米=hơn một ngàn mét|m
一千多里=hơn một ngàn dặm|m
一千左右=chừng một ngàn|m
一千年=một ngàn năm|m
一千次=một ngàn lần/một nghìn lần|m
一千遍=một ngàn lần|m
一千里=một nghìn dặm/một ngàn dặm|m
一千零一夜=Nghìn lẻ một đêm|m
一千零七=1,007|m
一千零二十=1,020|m
一千零五=1,005|m
一千零六=1,006|m
一升=một lít/lên cao|m
一半=một nửa/phân nửa/một phần hai|m
一半儿=một nửa|m
一半多=hơn một nửa|m
一半左右=chừng phân nửa/khoảng một nửa|m
一卷=một quyển/quyển một|m
一双=một đôi|m
一双双=từng đôi/một đôi|m
一双眼=một đôi mắt|m
一发=một phát/vừa phát/càng/một thể/cùng/một viên|m
一叠=một chồng/một xấp/một tờ|m
一叠叠=nhất điệp điệp|m
一口=một thanh/một ngụm/một cái|m
一句=một câu/nhất cú|m
一句句=từng câu|m
一只=một con/một cái/một đầu|m
一台=một đài/một máy|m
一右=một phải|m
一号=số một/một cỡ/số 1/nhất hào/một hào/một vòng|m
一名=một/một tên/một gã|m
一吨=một tấn/1 tấn|m
一员=một viên/một thành viên|m
一周=một tuần/một vòng/một tuần : vòng/một tuần|m
一周年=một năm tròn|m
一味=một mực/một vị/một mặt/nhất vị|m
一品=nhất phẩm|m
一响=một vang/vừa vang lên/vừa vang|m
一回=một lần/một hồi|m
一团=một đoàn|m
一圈=một vòng|m
一场=một trận/một tràng/một hồi|m
一堆=một đống|m
一堵=lấp kín/một bức|m
一声=một tiếng|m
一声声=từng tiếng|m
一处=một chỗ|m
一处处=khắp nơi/mọi chỗ|m
一多=càng nhiều|m
一多半=hơn phân nửa/quá nửa/hơn một nửa/hơn một nữa|m
一夜=một đêm|m
一大半=hơn phân nửa/hơn một nửa|m
一大口=một miệng lớn|m
一大堆=một đống lớn|m
一大帮=một đại bang|m
一大截=một mảng lớn/một đoạn dài|m
一大批=một nhóm lớn|m
一大排=một dãy lớn|m
一大步=một bước dài|m
一大笔=một số lớn|m
一大群=một đoàn|m
一大部分=một bộ phận lớn|m
一天=một ngày/một thiên|m
一天两天=một ngày hai ngày|m
一天天=từng ngày/ngày từng ngày/mỗi ngày càng/từng ngày từng ngày|m
一头=một đầu/vừa... vừa/ngay/tức khắc/đột nhiên/bỗng/ngã đột ngột/cắm đầu xuống/một cái đầu/một bọn/một phe/cùng/một khối/một con|m
一套=một bộ|m
一套套=từng bộ từng bộ|m
一季=một mùa|m
一宗=một tông/nhất tông|m
一家=một nhà|m
一寸=một thốn/một tấc|m
一对=một đôi/một đối|m
一对一=một đối một/nhất đối nhất/một đấu một/một chọi một/1 vs 1|m
一对二=một đối hai/một chọi hai|m
一对对=từng đôi|m
一封=một phong|m
一尊=một tôn/một/một pho/một người/một vị|m
一小半=gần một nửa/nhất thời nửa khắc/nhất thời nữa khắc|m
一小块=một khối nhỏ|m
一小撮=một nắm/một nhúm nhỏ|m
一小片=một mảnh nhỏ/một mảng nhỏ|m
一小部分=một phần nhỏ|m
一尺=một thước/một xích(0,33m)/một thước|m
一尾=một đuôi|m
一局=một ván|m
一层=một tầng/tầng một|m
一层层=từng tầng từng tầng/từng tầng một|m
一届=một giới/một lần|m
一岁=một tuổi|m
一左一右=một trái một phải/một tả một hữu/hai bên trái phải|m
一帮=một bang/một đám/nhất bang/|m
一幕=một màn|m
一干=một đám/liên can/liên quan|m
一年=một năm/năm một|m
一年半载=một năm nửa năm/một năm nửa năm|m
一座=một tòa|m
一开=vừa mở|m
一张=một trương/xòe ra/một tấm/hé ra/một tờ|m
一忽儿=một chốc/một lát|m
一成=một thành/một phần mười/vừa thành|m
一截=một đoạn|m
一截截=từng đoạn từng đoạn|m
一所=một chỗ/một khu nhà|m
一扇=một cái/vỗ một cái/một cánh|m
一手=một tay/khéo tay/tài giỏi/thủ đoạn/một mình/đơn độc|m
一打=đánh/một tá/một chục|m
一批=một nhóm/một đám|m
一批批=từng đám/từng nhóm một|m
一把=một thanh/một nắm/một cái/một bả/chẹn/chặn/chặn ngang/nắm/vốc/lớn tuổi/nhiều tuổi|m
一把手=người đứng đầu/một tay/tham gia một phần/giỏi giang/tay cừ/nhân vật số một/người đứng đầu|m
一折=một chiết/giảm 10%/gập lại|m
一抹=một vòng/một vệt/lau một cái|m
一担=một gánh|m
一拖二=một kéo hai|m
一招=một chiêu/nhất chiêu|m
一拳=một quyền|m
一捆=một bó|m
一排=một loạt/một hàng|m
一摊=một đám/mở ra|m
一摞=một chồng|m
一撇=cong lên/nhếch lên/một nét|m
一撮=một túm/một đống|m
一支=một chi/nhất chi/một nhánh|m
一数=khẽ đếm|m
一整夜=suốt cả đêm/suốt đêm/cả một đêm|m
一整天=cả ngày|m
一整套=trọn vẹn/một bộ đầy đủ|m
一文=một văn/nhất văn|m
一方=một phương/nhất phương|m
一日=một ngày|m
一日三餐=một ngày ba bữa|m
一日千里=một ngày ngàn dặm/tiến triển cực nhanh|m
一日日=ngày ngày|m
一时三刻=một thời ba khắc/trong thời gian ngắn|m
一星半点=một chút điểm/nhỏ tí tẹo|m
一晌=một buổi|m
一曲=một khúc|m
一月=một tháng/tháng một|m
一服=liều thuốc|m
一本=một bản/một quyển|m
一朵=một đóa|m
一朵朵=từng đoá từng đoá/nhiều đóa|m
一杆=một cây|m
一束=một chùm/một nhúm/một bó|m
一条=một đầu/một cái|m
一杯=một chén/một ly|m
一枚=một viên/một cái/một mai/một quả|m
一枝=một nhánh/một cành/một chi|m
一枪=một thương/một phát súng/một súng/một phát|m
一架=một khung/một trận/một chiếc|m
一栋=một tòa/một cái nhà|m
一株=một gốc/một cây/một gốc cây/một bụi|m
一根=một cây/một cái|m
一桌=một bàn|m
一档=một chương trình/một cấp độ|m
一桩=một cọc/một việc|m
一桶=một thùng|m
一棵=một gốc/một gốc cây|m
一次=một lần|m
一次次=lần lượt|m
一款=một cái|m
一步=một bước/một/từng bước|m
一步步=từng bước một/đi bước một/từng bước|m
一段=một đoạn/nhất đoạn|m
一比二=môt so hai/1 so với 2|m
一比五=1 so với 5/một chọi năm|m
一比十=1: 10/một so mười|m
一汪=một vũng|m
一沓=một xấp/một xấp|m
一派=một phái/nhất phái|m
一溜=một dải/một dãy/nhất lưu|m
一滴=một giọt|m
一点=một điểm/một chút/điểm một cái/một giờ/gật đầu|m
一点一滴=từng giờ từng phút/từng giọt từng giọt/từ từ/một điểm một giọt/từng giọt nhỏ|m
一点一点=từng chút từng chút/từng điểm từng điểm|m
一点两点=một điểm hai điểm/một chút hai chút|m
一点儿=một chút/một ít/chút xíu/chút ít|m
一点半=một giờ rưỡi|m
一点半点=một điểm nửa điểm|m
一点多=hơn một điểm/hơn một giờ|m
一点点=một chút xíu/từng chút một/một chút|m
一点钟=một giờ đồng hồ/một giờ|m
一片=một mảnh/phiến|m
一片片=từng mảnh từng mảnh/thành từng mảnh/từng mảnh một/từng mảng từng mảng|m
一班=ban một/một tốp/nhất ban/lớp một|m
一瓶=một bình/một lọ/chai/một chai|m
一生=cả đời/nhất sinh/suốt đời/trọn đời/một đời|m
一番=một phen|m
一百=một trăm/100|m
一百一十=một trăm mười/110|m
一百一十二=một trăm mười hai/112|m
一百一十二万=112 vạn|m
一百一十里=110 dặm|m
一百七=170|m
一百七十=một trăm bảy mươi/170|m
一百七十三=một trăm bảy mươi ba/173|m
一百七十亿=mười bảy tỷ|m
一百七十四=một trăm bảy mươi bốn/174|m
一百七十多=hơn một trăm bảy mươi/hơn 170|m
一百万=một trăm vạn/một triệu|m
一百万两=một trăm vạn lượng/một triệu lượng/100 vạn lượng|m
一百三十=một trăm ba mươi/130|m
一百三十万两=một triệu ba trăm ngàn lượng|m
一百三十八=một trăm ba mươi tám/138|m
一百三十里=130 dặm|m
一百下=một trăm cái/trăm lần|m
一百两=một trăm lượng/một trăm lạng|m
一百个=một trăm|m
一百九十=một trăm chín mươi/190|m
一百九十三=một trăm chín mươi ba/193|m
一百九十八=một trăm chín mươi tám/198|m
一百九十六=một trăm chín mươi sáu/196|m
一百二十=một trăm hai mươi/120|m
一百二十七=một trăm hai mươi bảy/127|m
一百二十万=một trăm hai mươi vạn|m
一百二十万两=một trăm hai mươi vạn lượng/một triệu hai trăm ngàn lượng|m
一百二十五=một trăm hai mươi lăm/125|m
一百二十余=hơn một trăm hai mươi|m
一百二十八=một trăm hai mươi tám/128|m
一百二十八万=128 vạn|m
一百二十六=một trăm hai mươi sáu/126|m
一百二十分=một trăm hai mươi điểm/một trăm hai mươi phần trăm/120%|m
一百二十多=hơn một trăm hai mươi/hơn 120|m
一百二十多个=hơn một trăm hai mươi|m
一百二十年=một trăm hai mươi năm/120 năm|m
一百二十里=một trăm hai mươi dặm/120 dặm|m
一百五十=một trăm năm mươi/150|m
一百五十三=một trăm năm mươi ba/153|m
一百五十两=một trăm năm mươi lượng|m
一百五十二=một trăm năm mươi hai/152|m
一百五十五=một trăm năm mươi lăm/155|m
一百五十余=hơn một trăm năm mươi|m
一百五十多年=hơn 150 năm|m
一百五十里=một trăm năm mươi dặm/150 dặm|m
一百亿=một trăm ức/mười tỷ|m
一百余=hơn một trăm|m
一百余里=hơn một trăm dặm|m
一百倍=gấp trăm lần|m
一百元=một trăm nguyên|m
一百八=180|m
一百八十=một trăm tám mươi/180|m
一百八十七=một trăm tám mươi bảy/187|m
一百八十九=một trăm tám mươi chín/189|m
一百八十度=một trăm tám mươi độ/180°|m
一百八十里=180 dặm|m
一百六十=một trăm sáu mươi|m
一百六十两=một trăm sáu mươi lượng|m
一百六十五=165|m
一百六十六=166|m
一百六十四=một trăm sáu mươi bốn/164|m
一百六十多=hơn một trăm sáu mươi|m
一百六十多年=hơn 160 năm|m
一百分=một trăm điểm/100 điểm/100%/một trăm phân|m
一百只=một trăm con/một trăm cái/100 con|m
一百号=số một trăm/một trăm hào|m
一百四五十=140~150|m
一百四十=một trăm bốn mươi/140|m
一百四十两=một trăm bốn mươi lượng|m
一百四十九=149|m
一百四十四=144|m
一百多=hơn một trăm/hơn 100|m
一百多万=hơn một trăm vạn/hơn một triệu|m
一百多两=hơn một trăm lượng|m
一百多只=hơn một trăm con|m
一百多名=hơn một trăm tên|m
一百多天=hơn một trăm ngày|m
一百多岁=hơn một trăm tuổi|m
一百多年=hơn một trăm năm|m
一百多张=hơn một trăm tấm/hơn 100 tấm|m
一百多米=hơn một trăm mét/hơn 100m|m
一百多道=hơn một trăm đạo|m
一百多里=hơn một trăm dặm|m
一百天=một trăm ngày|m
一百家=một trăm nhà|m
一百年=một trăm năm|m
一百张=một trăm tấm/100 tấm|m
一百条=một trăm đầu/100 điều|m
一百根=một trăm cây|m
一百次=một trăm lần/100 lần|m
一百米=một trăm mét/100m/100 mét|m
一百遍=một trăm lần|m
一百里=một trăm dặm/100 dặm|m
一百零七=một trăm linh bảy/107|m
一百零三=một trăm lẻ ba/103|m
一百零二=102|m
一百零五=một trăm lẻ năm/105|m
一百零八=một trăm linh tám/108|m
一百零六=một trăm linh sáu/106|m
一百首=một trăm bài|m
一盆=một chậu|m
一盏=một ngọn/một chén/một chiếc|m
一盒=một hộp|m
一盘=một bàn/co lại|m
一目=một mắt/một mực|m
一眼=một chút/liếc mắt/một cái/liếc|m
一瞬千里=nhất thuấn thiên lý|m
一瞬间=một nháy mắt/trong nháy mắt|m
一碗=một bát/một chén|m
一票=một phiếu/một chuyến|m
一种=một loại|m
一秒=một giây/trong một giây|m
一站=một trạm/vừa đứng|m
一章=một chương/chương một|m
一端=một mặt/một điểm|m
一笔=một bút/một khoản/một số|m
一等=nhất đẳng/một đẳng/vừa chờ/một chút|m
一箱=một rương|m
一篇=một thiên/một phần|m
一篇篇=từng trang từng trang sách/từng chương từng chương|m
一簇簇=nhiều đám/nhiều bó/từng đám/từng bó từng bó|m
一米=một mét/một thước/1 mét|m
一类=một loại|m
一粒=một hạt/một/từng mảnh/một viên|m
一系列=một hệ liệt/một loạt/hàng loạt|m
一级=một cấp/cấp một/một bậc/nhất cấp|m
一纸=một tờ|m
一线=một tuyến/tuyến một/một đường/tiền tuyến/hàng một/người trực tiếp/một tia/một chút/Team 1|m
一组=một tổ/tổ 1|m
一组组=từng tổ từng tổ|m
一维=một chiều|m
一缕=một sợi/một luồng/một đám/một tia|m
一罐=một bình/một lon|m
一群=một đám/một bầy|m
一肚=đầy bụng|m
一肚子=một bụng|m
一股=một cỗ/một luồng/một/một cổ|m
一脸=một mặt/vẻ mặt/mặt|m
一腔=một lời|m
一艘=một chiếc|m
一节=một tiết|m
一行=một nhóm/một chuyến/nhóm/một bọn|m
一袋=một túi|m
一角=một góc/một sừng/một hào|m
一记=một cái|m
一贯=nhất quán/một quan/trước sau như một|m
一起=cùng một chỗ/vừa lên/đồng thời/cùng nhau/cùng nơi/cùng/tổng cộng/cả thảy/một vụ|m
一趟=một chuyến/một lượt|m
一路=một đường/trên đường/dọc đường/lên đường/cùng loại/cùng/cùng nhau/liên tiếp/một mạch|m
一路路=từng đạo từng đạo|m
一身=một thân/toàn thân/cả người/bộ/một mình|m
一车=một xe|m
一轮=một vòng/một vành/một lượt|m
一载=một năm/một năm|m
一辆=một cỗ/một chiếc|m
一辆辆=từng chiếc/từng chiếc một/từng chiếc từng chiếc|m
一辈=một đời/bối phận/đồng lứa/nhất bối/một bối phận|m
一辈子=cả một đời/cả đời/một đời/suốt đời|m
一辰=Nhất Thần|m
一通=một trận/vừa thông suốt/một lần|m
一遍=một lần|m
一道=một đạo/một đường/nhất đạo/cùng/cùng nhau|m
一遭=một lần|m
一部=một bộ/nhất bộ|m
一部分=một bộ phận/một phần|m
一重=nhất trọng/một trọng/một tầng/hơi nặng|m
一锤=một chùy/một búa|m
一锭=một thỏi|m
一门=một môn/một cửa/một khẩu|m
一间=một gian|m
一队=một đội/đội 1|m
一阵=một trận/một hồi|m
一阵一阵=từng trận|m
一阵子=một hồi/một trận|m
一阵阵=từng đợt/từng cơn/từng trận|m
一面=một mặt/một phía/một bên/vừa... vừa/gặp mặt một lần|m
一页=một tờ/một trang|m
一顶=một đỉnh/đỉnh đầu|m
一项=một hạng/hạng nhất|m
一顿=dừng lại/một trận/một bữa/một chầu/một lần/một hồi/cùng/cùng nhau|m
一颗=một viên/một khỏa|m
一餐=một bữa|m
一首=một bài|m
一首歌=một ca khúc|m
一驾=một giá|m
丁亥=Đinh Hợi|m
丁卯=Đinh Mão|m
七一=thất nhất/ngày thành lập Đảng cộng sản Trung Quốc|m
七七=bảy bảy/cúng thất tuần/cúng 49 ngày|m
七七八八=bảy tám phần/thất thất bát bát|m
七七四十九天=bảy bảy bốn mươi chín ngày|m
七七四十九日=bảy bảy bốn mươi chín ngày|m
七万=bảy vạn/70 ngàn|m
七万余=hơn bảy vạn|m
七万多=hơn bảy vạn|m
七丈=bảy trượng/bảy trượng|m
七上八下=bất ổn/thất thượng bát hạ/loạn tung tùng phèo|m
七下=bảy lần|m
七两=bảy lượng/bảy lạng|m
七九=bảy chín/bảy, chín|m
七五=bảy mươi lăm|m
七五折=75%|m
七亿=bảy ức/bảy trăm triệu/7 ức/bẩy trăm triệu|m
七件=bảy kiện/bảy cái|m
七位=bảy vị/thất vị|m
七倍=gấp bảy/gấp bảy lần|m
七儿=Thất nhi|m
七八=bảy tám/thất bát|m
七八万=bảy, tám vạn|m
七八丈=bảy tám trượng|m
七八下=bảy tám lần/bảy, tám lần|m
七八个=bảy tám cái|m
七八倍=bảy tám lần|m
七八分=bảy tám phần|m
七八分钟=bảy tám phút/7,8 phút|m
七八十=bảy tám chục/bảy mươi, tám mươi|m
七八十名=bảy tám mươi tên|m
七八十天=bảy tám mươi ngày|m
七八十米=bảy tám mươi mét|m
七八十里=bảy tám chục dặm/bảy mươi, tám mươi dặm|m
七八千=bảy, tám ngàn|m
七八千里=bảy, tám ngàn dặm|m
七八口=bảy, tám thanh|m
七八只=bảy, tám cái/bảy, tám con|m
七八天=bảy tám ngày|m
七八家=bảy tám nhà|m
七八年=bảy tám năm|m
七八成=bảy tám phần/bảy, tám phần mười|m
七八根=bảy, tám cây|m
七八次=bảy tám lần/bảy, tám lần|m
七八点=bảy tám giờ|m
七八百里=bảy, tám trăm dặm|m
七八米=bảy tám mét/bảy, tám mét|m
七八级=cấp bảy cấp tám|m
七八遍=bảy, tám lần|m
七八道=bảy tám đạo|m
七八里=bảy tám dặm/bảy, tám dặm|m
七八间=bảy tám gian|m
七具=bảy bộ|m
七出=bảy ra/thất xuất|m
七分=bảy phần/bảy điểm/bảy phút/bảy phần|m
七分钟=bảy phút|m
七十=bảy mươi/70/bảy mươi|m
七十一=bảy mươi mốt|m
七十七=bảy mươi bảy|m
七十万=bảy mươi vạn|m
七十三=bảy mươi ba|m
七十九=bảy mươi chín/79|m
七十二=bảy mươi hai/thất thập nhị|m
七十二万=72 vạn|m
七十二座=bảy mươi hai toà|m
七十二行=tất cả ngành nghề/bảy mươi hai nghề/hết thảy mọi nghề|m
七十五=bảy mươi lăm|m
七十余=hơn bảy mươi|m
七十余岁=bảy mươi mấy tuổi|m
七十余年=hơn bảy mươi năm|m
七十余里=hơn bảy mươi dặm|m
七十八=bảy mươi tám|m
七十六=bảy mươi sáu|m
七十只=bảy mươi con|m
七十四=bảy mươi bốn|m
七十多=hơn bảy mươi|m
七十多万=hơn bảy mươi vạn/hơn 70 vạn|m
七十多年=hơn bảy mươi năm|m
七十多里=hơn bảy mươi dặm|m
七十年=bảy mươi năm|m
七十年代=thập niên bảy mươi/|m
七十米=bảy mươi mét/70m|m
七十里=bảy mươi dặm|m
七千=bảy ngàn/bảy ngàn|m
七千万=bảy ngàn vạn/bảy chục triệu/bảy trăm ngàn/70 triệu|m
七千两=bảy ngàn lượng|m
七千五百=bảy ngàn năm trăm/7,500|m
七千余里=hơn bảy ngàn dặm|m
七千里=bảy ngàn dặm/bảy nghìn dặm|m
七卷=bảy quyển/quyển bảy|m
七口=bảy thanh|m
七只=bảy con/bảy cái/bảy con|m
七号=số bảy/số 7/số bảy|m
七名=bảy tên/bảy tên|m
七吨=7 tấn|m
七品=thất phẩm|m
七团=bảy đám|m
七块=bảy khối|m
七声=bảy tiếng/thất âm/bảy nốt nhạc|m
七处=bảy chỗ|m
七多=hơn bảy|m
七大派=Thất Đại Phái|m
七头=bảy con|m
七宗=bảy tông|m
七寸=bảy tấc/7 tấc|m
七少=thất thiếu|m
七尺=bảy thước|m
七尾=thất vĩ|m
七层=bảy tầng/tầng bảy/bảy tầng|m
七岁=bảy tuổi/bảy tuổi|m
七席=thất tịch|m
七幅=bảy bức|m
七年=bảy năm/bảy năm|m
七座=bảy tòa/bảy ngọn/bảy toà|m
七张=bảy cái/bảy tấm|m
七成=bảy thành/bảy phần mười|m
七批=bảy tốp|m
七把=bảy chuôi/bảy thanh|m
七折=70%/giảm còn 70%|m
七招=bảy chiêu/thất chiêu|m
七杆=bảy cây|m
七条=bảy đầu/bảy cái|m
七枚=bảy viên/bảy miếng|m
七架=bảy chiếc|m
七株=bảy cây|m
七根=bảy cái|m
七次=bảy lần/bảy lần|m
七滴=bảy giọt|m
七点=bảy điểm/bảy giờ/7 h|m
七点钟=bảy giờ đồng hồ|m
七片=bảy mảnh|m
七班=ban 7|m
七瓶=bảy bình|m
七百=bảy trăm/bảy trăm|m
七百万=bảy trăm vạn/bảy triệu|m
七百两=bảy trăm lượng|m
七百五十四=bảy trăm năm mươi bốn/754|m
七百余=hơn bảy trăm|m
七百余里=hơn bảy trăm dặm|m
七百多=hơn bảy trăm/hơn 700|m
七百多万=hơn bảy triệu|m
七百多年=hơn bảy trăm năm|m
七百年=bảy trăm năm|m
七百里=bảy trăm dặm/700 dặm|m
七眼=thất nhãn|m
七种=bảy loại/thất chủng/bảy loại|m
七秒=bảy giây|m
七章=bảy chương|m
七等=thất đẳng/cấp bảy|m
七米=bảy mét/7m|m
七粒=bảy hạt|m
七级=bảy cấp/cấp bảy/bảy bậc/thất cấp|m
七组=bảy tổ/tổ 7/tiểu đội 7/bảy nhóm|m
七群=bảy bầy|m
七股=bảy cỗ|m
七艘=bảy chiếc|m
七角=thất giác|m
七载=bảy năm|m
七辆=bảy chiếc|m
七遍=bảy lần|m
七道=bảy đạo|m
七郎=Thất Lang|m
七里=bảy dặm/bảy dặm|m
七重=thất trọng/bảy tầng|m
七门=bảy môn/thất môn|m
七颗=bảy viên/bảy khỏa|m
万=vạn|m
万一=vạn nhất/một phần vạn/ngộ nhỡ/nhỡ ra|m
万一把=vạn nhất đem|m
万万=vạn vạn/tuyệt đối/trăm triệu/bất kể như thế nào cũng không/dù sao cũng không/quyết|m
万万岁=vạn vạn tuế|m
万万年=vạn vạn năm|m
万丈=vạn trượng/muôn trượng/cao ngất/rất sâu/vạn trượng|m
万下=vạn lần|m
万两=vạn lượng/vạn lạng|m
万两左右=chừng vạn lượng|m
万亿=vạn ức/ngàn tỷ/ngàn tỉ|m
万件=vạn cái|m
万份=vạn phần|m
万伏=vạn Vôn|m
万余=hơn vạn/hơn vạn|m
万余里=hơn vạn dặm|m
万倍=vạn lần|m
万儿八千=ngót nghét một vạn/xấp xỉ một vạn|m
万公里=vạn cây số|m
万分=vạn phần/muôn phần/hết sức/vô cùng|m
万分之一=một phần vạn|m
万千=ngàn vạn/hàng vạn hàng nghìn/muôn vàn/vạn thiên/vạn ngàn|m
万千米=vạn km|m
万口=vạn thanh|m
万只=vạn con|m
万号=số vạn|m
万团=vạn đám|m
万处=vạn nơi|m
万多=hơn vạn/hơn vạn|m
万天=vạn ngày|m
万头=vạn con|m
万家=Vạn gia|m
万层=vạn tầng|m
万岁=vạn tuế/muôn năm/muôn tuổi/đấng vạn tuế|m
万幅=vạn bức|m
万年=vạn năm/muôn đời/muôn năm/vạn niên/vạn năm|m
万座=vạn tòa|m
万张=vạn tấm|m
万户=vạn hộ|m
万把=vạn thanh|m
万斤=vạn cân|m
万方=muôn phương/khắp nơi/muôn vẻ|m
万日=vạn ngày|m
万日元=vạn yên|m
万杆=vạn cái|m
万条=vạn cái/vạn điều|m
万枚=vạn mai/vạn viên|m
万架=vạn chiếc|m
万株=vạn cây|m
万根=vạn cái|m
万次=vạn lần|m
万段=vạn đoạn|m
万滴=vạn giọt/vạn giọt|m
万点=vạn điểm|m
万片=vạn mảnh|m
万种=vạn loại/vạn chủng|m
万端=vạn đoan/muôn mối/phong phú|m
万米=vạn mét/vạn đô/vạn mét|m
万粒=vạn hạt|m
万组=vạn tổ|m
万股=vạn cỗ|m
万艘=vạn chiếc|m
万许=gần vạn|m
万载=vạn năm/vạn năm|m
万辆=vạn chiếc|m
万遍=vạn lần|m
万道=vạn đạo|m
万部=vạn bộ|m
万里=vạn dặm/vạn lý/nghìn dặm/rất xa/cực xa/vạn dặm|m
万重=vạn trọng/vạn tầng|m
万顷=mênh mang|m
三七=ba bảy/tam thất/củ tam thất|m
三七二十一=mọi việc/sự/ba bảy hai mươi mốt|m
三七分=chia ba bảy/chia 3:7|m
三七开=chia ba bảy/chia 3-7|m
三万=ba vạn/30 ngàn/3 vạn|m
三万两=ba vạn lượng|m
三万九千=39,000|m
三万五千=ba vạn năm ngàn/35,000|m
三万余=hơn ba vạn|m
三万八千=38,000|m
三万四千=ba vạn bốn ngàn/34,000|m
三万多=hơn ba vạn|m
三万年=ba vạn năm|m
三万里=ba vạn dặm/ba vạn dặm|m
三丈=ba trượng|m
三三=tam tam|m
三三两两=tốp năm tốp ba/tụm năm tụm ba/tam tam lưỡng lưỡng/túm năm tụm ba|m
三三五五=tụm năm tụm ba|m
三下=ba lần/ba cái|m
三下两下=tam hạ lưỡng hạ|m
三两=ba lượng/ba lạng/ba hai|m
三两下=hai ba lần/ba đến hai lần xuống|m
三两个=hai ba cái/hai ba tên|m
三两句=hai ba câu|m
三两只=hai ba con|m
三两天=hai ba ngày|m
三两年=hai ba năm|m
三两日=hai ba ngày|m
三两步=hai ba bước|m
三个=ba cái/ba|m
三五=ba năm/ba, năm|m
三五下=ba năm lần|m
三五个=ba năm cái/3~5 cái|m
三五十=ba mươi năm mươi|m
三五十米=ba mươi năm mươi mét|m
三五千=năm ba ngàn/ba, năm ngàn|m
三五天=ba năm ngày/3-5 ngày/ba, năm ngày|m
三五年=ba năm năm/ba năm rưỡi/3 5 năm|m
三五成群=tốp năm tốp ba/quần tam tụ ngũ/thành nhóm thành tốp/túm năm tụm ba|m
三五日=ba năm ngày|m
三五次=ba, năm lần|m
三五步=ba năm bước|m
三五米=3~5m|m
三五遍=ba năm lần|m
三五里=ba năm dặm/3~5 dặm/ba, năm dặm|m
三人组=tổ ba người|m
三亿=ba trăm triệu|m
三亿七千万=370 triệu|m
三任=ba nhiệm|m
三位=ba vị/ba người/Ba Vì|m
三余=hơn ba|m
三倍=ba lần/gấp ba|m
三元=tam nguyên/tức là ba cái có trước vậy|m
三克=ba gram|m
三八线=vĩ tuyến 38/38 dòng/Vĩ tuyến 38, tạo thành biên giới DMZ giữa Bắc và Nam Triều Tiên|m
三六九=tam lục cửu|m
三六九等=đủ loại khác biệt/ba bảy loại/nhiều loại/đủ loại|m
三具=ba bộ|m
三刀=ba đao/tam đao|m
三分=ba phần/ba điểm|m
三分之二=hai phần ba|m
三列=ba hàng/đoàn ba|m
三刻=ba khắc/canh ba|m
三副=ba bộ/tài công bậc ba/nhân viên lái tàu bậc ba|m
三十=ba mươi/30|m
三十一=ba mươi mốt|m
三十一日=ba mươi mốt ngày|m
三十七=ba mươi bảy/37|m
三十七八=ba mươi bảy ba mươi tám|m
三十万=ba mươi vạn|m
三十万两=ba mươi vạn lượng|m
三十万余=hơn ba mươi vạn|m
三十三=ba mươi ba|m
三十三天=tam thập tam thiên/ba mươi ba ngày|m
三十三日=ba mươi ba ngày|m
三十三章=chương 33:|m
三十下=ba mươi lần|m
三十两=ba mươi lượng|m
三十个=ba mươi|m
三十九=ba mươi chín|m
三十九天=ba mươi chín ngày|m
三十二=ba mươi hai/32|m
三十二卷=quyển ba mươi hai/ba mươi hai quyển|m
三十二天=ba mươi hai ngày|m
三十二章=chương 32:|m
三十五=ba mươi lăm/35|m
三十五万=ba mươi lăm vạn|m
三十五个=ba mươi lăm|m
三十五六=ba mươi lăm ba mươi sáu|m
三十五分=ba mươi lăm phút|m
三十五米=ba mươi lăm mét|m
三十五里=35 dặm/ba mươi lăm dặm|m
三十余=hơn ba mươi|m
三十余名=hơn ba mươi tên/hơn ba mươi người|m
三十余岁=ba mươi mấy tuổi|m
三十余年=hơn ba mươi năm|m
三十余米=hơn ba mươi mét|m
三十余载=hơn ba mươi năm|m
三十余里=hơn ba mươi dặm|m
三十八=ba mươi tám/38|m
三十公里=30 km|m
三十六=ba mươi sáu|m
三十六七=ba mươi sáu ba mươi bảy|m
三十六代=ba mươi sáu đời|m
三十六只=ba mươi sáu con|m
三十六名=ba mươi sáu tên|m
三十六天=ba mươi sáu ngày|m
三十六把=ba mươi sáu thanh|m
三十六日=ba mươi sáu ngày|m
三十六根=ba mươi sáu cái|m
三十六里=ba mươi sáu dặm|m
三十几=ba mươi mấy|m
三十几年=ba mươi mấy năm|m
三十几米=ba mươi mấy mét|m
三十出头=ngoài ba mươi/ba mươi tuổi đầu|m
三十分=ba mươi điểm/ba mươi phút/ba mươi phần|m
三十分钟=ba mươi phút/30 phút|m
三十只=ba mươi con|m
三十四=ba mươi bốn|m
三十四五=34-35|m
三十多=hơn ba mươi/hơn - ba mươi/ba chục|m
三十多万=hơn ba mươi vạn/hơn 30 vạn|m
三十多万两=hơn ba mươi vạn lượng|m
三十多个=hơn ba mươi|m
三十多天=hơn ba mươi ngày|m
三十多年=hơn ba mươi năm|m
三十多米=hơn ba mươi mét/hơn 30m|m
三十多里=hơn ba mươi dặm|m
三十夜=đêm ba mươi|m
三十天=ba mươi ngày|m
三十岁=ba mươi tuổi|m
三十左右=chừng ba mươi|m
三十年=ba mươi năm|m
三十张=ba mươi tấm|m
三十招=ba mươi chiêu|m
三十日=ba mươi ngày|m
三十次=ba mươi lần|m
三十秒=ba mươi giây/30 giây|m
三十米=ba mươi mét/30m|m
三十级=30 cấp|m
三十里=ba mươi dặm|m
三千=ba ngàn/ba nghìn/3000/ba ngàn|m
三千七百=ba ngàn bảy trăm/3700/3,700|m
三千万=ba ngàn vạn/ba mươi triệu|m
三千万两=ba ngàn vạn lượng|m
三千两=ba ngàn lượng|m
三千五百=ba ngàn năm trăm/3500/3,500|m
三千五百九十=3,590|m
三千余=hơn ba ngàn/hơn ba ngàn|m
三千余年=hơn ba ngàn năm|m
三千余里=hơn ba ngàn dặm|m
三千八百米=3,800 mét|m
三千六百九十=3,690|m
三千多=hơn ba ngàn/hơn ba nghìn|m
三千多万=hơn ba nghìn vạn/hơn 30 triệu|m
三千多年=hơn ba nghìn năm/hơn ba ngàn năm|m
三千多里=hơn ba ngàn dặm|m
三千年=ba ngàn năm|m
三千米=ba ngàn mét/3000 m|m
三千里=ba ngàn dặm/ba nghìn dặm|m
三升=ba lít|m
三卷=ba quyển/quyển ba|m
三双=ba đôi/tam đôi|m
三叠=ba chồng/Tam Điệp|m
三口=ba miệng/ba thanh/ba ngụm|m
三句=ba câu|m
三只=ba con/ba cái/ba đầu|m
三台=ba đài/ba máy|m
三号=số ba/số 3/Số 3|m
三名=ba tên/ba gã|m
三吨=3 tấn|m
三周=ba tuần/ba vòng|m
三周年=ba năm tròn|m
三品=tam phẩm/ba phẩm/Tam phẩm|m
三四=ba bốn/ba, bốn|m
三四丈=ba bốn trượng|m
三四代=ba bốn đời|m
三四倍=gấp ba bốn lần|m
三四十=ba bốn mươi/ba mươi, bốn mươi|m
三四十丈=ba mươi bốn mươi trượng|m
三四十只=ba mươi, bốn mươi con|m
三四十米=ba bốn mươi mét/30-40m/30~40m/ba mươi, bốn mươi mét|m
三四十里=ba mươi, bốn mươi dặm|m
三四千=ba bốn ngàn|m
三四千里=ba, bốn ngàn dặm|m
三四只=ba, bốn con|m
三四天=ba bốn ngày|m
三四家=ba bốn nhà|m
三四成=ba bốn thành/ba, bốn phần mười|m
三四根=ba, bốn cây|m
三四次=ba bốn lần/ba, bốn lần|m
三四百米=ba bốn trăm mét/300~400m/ba, bốn trăm mét|m
三四百里=ba, bốn trăm dặm|m
三四米=ba bốn mét/3-4m/ba, bốn mét|m
三四里=trong vòng ba bốn dặm/ba, bốn dặm|m
三团=ba đám|m
三圈=ba vòng|m
三块=ba khối|m
三堂=tam đường|m
三声=ba tiếng/tam thanh|m
三处=ba khu/ba chỗ/Khu vực 3|m
三多=ba nhiều/ba thứ nhất/Tam Đa/hơn ba|m
三夜=ba đêm|m
三大少=Tam đại thiếu|m
三天=ba ngày|m
三天三夜=ba ngày ba đêm|m
三天两头=ba ngày hai bữa/ba ngày hai đầu/Dăm ba bữa|m
三头=ba đầu/tam đầu/ba con|m
三套=ba bộ|m
三子=tam tử/con thứ ba/con trai thứ ba/ba đứa con/ba con trai|m
三宗=ba tông/tam tông|m
三家=ba nhà/Tam gia|m
三寸=ba tấc|m
三对=ba đôi/ba đối|m
三封=tam phong|m
三尊=ba tôn/tam tôn/ba vị|m
三少=Tam thiếu/Tam Thiếu|m
三尺=ba thước|m
三尾=tam vĩ/ba đuôi|m
三层=ba tầng/tầng ba|m
三岁=ba tuổi|m
三席=tam tịch|m
三幅=ba bức|m
三平方米=ba mét vuông|m
三年=ba năm|m
三年五载=ba năm năm năm|m
三座=ba tòa/ba toà|m
三张=ba tấm/ba tờ|m
三成=ba thành/ba phần mười|m
三截=ba đoạn|m
三批=ba nhóm/ba đợt|m
三把=ba thanh/ba cái|m
三折=30%/giảm còn 30%|m
三招=ba chiêu|m
三拳=ba quyền/tam quyền|m
三排=ba hàng|m
三方=tam phương/ba bên|m
三月=ba tháng/tháng ba|m
三杆=ba sào/ba cây|m
三束=ba bó|m
三杯=ba chén|m
三枚=ba cái/ba viên/ba mai/ba quả/ba miếng|m
三枪=ba phát/ba súng|m
三架=ba cái/ba chiếc|m
三柱=tam trụ|m
三株=ba cây|m
三样=ba loại|m
三根=ba cây/ba cái|m
三次=ba lần/lần ba/ba lượt|m
三步=ba bước|m
三段=ba đoạn/tam đoạn|m
三派=ba phái|m
三溜=ba dãy|m
三滴=ba giọt|m
三点=ba điểm/ba giờ|m
三点一线=ba điểm trên một đường thẳng/ba điểm thẳng hàng|m
三点钟=ba giờ|m
三片=ba mảnh|m
三班=ban ba/tam ban/lớp ba/ba ban|m
三瓶=ba bình|m
三番=ba phen|m
三番两次=lại nhiều lần|m
三番五次=năm lần bảy lượt|m
三番四次=ba lần bốn lượt|m
三百=ba trăm/300|m
三百七十七万=377 vạn|m
三百七十六=ba trăm bảy mươi sáu/376|m
三百万=ba trăm vạn/300 vạn/ba triệu|m
三百万两=ba trăm vạn lượng/ba triệu lượng|m
三百三十一=ba trăm ba mươi mốt/331|m
三百两=ba trăm lượng|m
三百二十三=ba trăm hai mươi ba/323|m
三百二十四=ba trăm hai mươi bốn/324|m
三百五十=ba trăm năm mươi/350|m
三百五十六=ba trăm năm mươi sáu/356|m
三百五十里=350 dặm|m
三百余=hơn ba trăm|m
三百余里=hơn ba trăm dặm|m
三百八十万两=ba triệu tám trăm ngàn lượng|m
三百八十四=ba trăm tám mươi bốn/384|m
三百六十=ba trăm sáu mươi/360|m
三百六十五=ba trăm sáu mươi lăm/365|m
三百六十五天=ba trăm sáu mươi lăm ngày/365 ngày|m
三百六十里=360 dặm|m
三百只=ba trăm con/300 con|m
三百多=hơn ba trăm/hơn 300|m
三百多万=hơn ba trăm vạn/hơn 3 triệu|m
三百多年=hơn ba trăm năm/hơn 300 năm|m
三百多米=hơn ba trăm mét|m
三百多里=hơn ba trăm dặm|m
三百左右=khoảng ba trăm|m
三百次=ba trăm lần/300 lần|m
三百米=ba trăm mét/300m/300 mét|m
三百里=ba trăm dặm/300 dặm|m
三眼=tam nhãn/Tam Nhãn|m
三种=ba loại|m
三秒=ba giây|m
三章=ba chương/chương ba|m
三等=tam đẳng/cấp ba|m
三篇=tam thiên|m
三米=ba mét/ba thước/ba mét|m
三粒=ba hạt|m
三线=tam tuyến/tuyến ba|m
三组=ba tổ/tổ 3|m
三维=ba chiều/ba chiều( 3D)|m
三群=ba bầy|m
三股=ba cỗ/ba luồng/ba cổ|m
三艘=ba chiếc|m
三节=tam tiết|m
三英门=Tam Anh môn|m
三角=tam giác/ba góc/hình tam giác|m
三记=ba cái/ba đòn|m
三趟=ba chuyến|m
三路=ba đường|m
三轮=ba lượt/ba vành/xích lô|m
三载=ba năm/tam năm|m
三辆=ba chiếc|m
三辈子=ba đời|m
三遍=ba lần|m
三道=ba đạo|m
三遭=ba lần|m
三里=ba dặm/ba dặm|m
三重=tam trọng/ba tầng|m
三门=ba môn/tam môn|m
三间=ba gian|m
三队=ba đội/đội 3|m
三页=ba trang|m
三项=ba loại|m
三顿=ba trận/ba bữa|m
三颗=ba viên/ba khỏa|m
三餐=ba bữa cơm|m
上万=hơn vạn|m
上万只=hàng vạn con|m
上下左右=trên dưới trái phải/trên dưới phải trái|m
上千=hơn ngàn|m
上千亿=hơn trăm tỷ|m
上千年=hơn ngàn năm|m
上百万=hơn trăm vạn/hơn triệu|m
上百年=trên trăm năm|m
不一会儿=chỉ chốc lát sau|m
不二=không hai/như một/nhất quán/một lòng/chuyên nhất/dốc lòng|m
不多会儿=không bao lâu/một chút xíu/không lâu lắm|m
不少次=không ít lần|m
不招=không chiêu/không khai/không làm cho/không nhận tội|m
不支=chống đỡ hết nổi/không thể chèo chống tiếp được nữa/không ngừng/không chống đỡ nổi|m
丙午=Bính Ngọ|m
丙戌年=năm Bính Tuất|m
丙等=Bính đẳng|m
丝丝=từng tia từng tia/tí ti/nhè nhẹ/từng tí/ti ti|m
丝毫=mảy may/chút nào/tí ti|m
丝米=Đề-xi-mi-li-mét/Đềximilimét|m
丝缕=ti lũ/sợi tơ|m
两=lưỡng|m
两万=hai vạn/20 ngàn|m
两万三千=hai vạn ba ngàn/23,000|m
两万两=hai vạn lượng|m
两万五千=hai vạn năm ngàn/25,000|m
两万五千里=hai mươi lăm ngàn dặm|m
两万余=hơn hai vạn|m
两万余里=hơn hai vạn dặm|m
两万八千=hai vạn tám ngàn/28,000|m
两万六千=hai vạn sáu ngàn/26,000|m
两万多=hơn hai vạn|m
两万左右=chừng hai vạn|m
两万里=hai vạn dặm|m
两丈=hai trượng|m
两三=hai ba/hai, ba|m
两三万=hai ba vạn|m
两三下=hai ba cái/hai, ba lần|m
两三倍=gấp hai ba lần|m
两三分=hai ba phần|m
两三分钟=hai ba phút/2,3 phút|m
两三千=hai ba ngàn|m
两三千年=hai ba ngàn năm/2000-3000 năm|m
两三千里=hai ba ngàn dặm|m
两三口=hai ba ngụm|m
两三只=hai ba con/hai, ba con|m
两三天=hai ba ngày|m
两三岁=hai ba tuổi|m
两三年=hai ba năm|m
两三张=hai, ba tấm|m
两三成=hai ba thành/hai, ba phần mười|m
两三日=hai ba ngày|m
两三根=hai, ba cây|m
两三次=hai ba lần/hai, ba lần|m
两三步=hai, ba bước|m
两三点=hai ba điểm/hai ba giờ|m
两三片=hai, ba mảnh|m
两三百=hai ba trăm|m
两三百里=hai ba trăm dặm/hai, ba trăm dặm|m
两三米=hai ba mét|m
两三股=hai ba cỗ|m
两三里=hai ba dặm/hai, ba dặm|m
两下=hai lần/hai cái|m
两下子=hai lần/bản lĩnh/mấy lần/vài lần/kỹ năng|m
两两=hai hai|m
两个=hai cái/hai|m
两串=hai chuỗi|m
两亩=hai mẫu ruộng|m
两亿=hai ức/200 triệu/hai trăm triệu|m
两亿七千万=270 triệu|m
两亿多年=hơn hai trăm triệu năm|m
两代=hai đời|m
两件=hai kiện/hai cái|m
两任=hai vị|m
两份=hai phần|m
两伙=hai nhóm|m
两位=hai vị|m
两倍=hai lần/gấp hai/gấp ba|m
两克=2 gram|m
两公里=hai cây số|m
两具=hai cỗ|m
两刀=hai đao|m
两分=hai phần/hai điểm|m
两分钟=hai phút đồng hồ/hai phút|m
两列=hai nhóm/hai hàng|m
两副=hai bộ|m
两包=hai bao|m
两匹=hai thớt/hai con|m
两十=hai mươi|m
两千=hai ngàn/2000/hai nghìn|m
两千一百万=21 triệu|m
两千万=hai ngàn vạn/20 triệu|m
两千三百多年=hơn 2,300 năm|m
两千两=hai ngàn lượng|m
两千五百=hai ngàn năm trăm|m
两千五百多年=hơn 2,500 năm|m
两千余=hơn hai ngàn|m
两千余里=hơn hai ngàn dặm|m
两千只=hai ngàn cái/2,000 con|m
两千四百=hai ngàn bốn trăm/2400/2,400|m
两千多=hơn hai ngàn|m
两千多万=hơn hai ngàn vạn/hơn 20 triệu|m
两千多只=hơn 2,000 con|m
两千多年=hơn hai nghìn năm/hơn hai ngàn năm|m
两千多米=hơn hai ngàn mét|m
两千左右=chừng hai ngàn|m
两千年=hai ngàn năm|m
两千米=hai ngàn mét/2000m|m
两千里=hai ngàn dặm/hai nghìn dặm|m
两升=hai lít|m
两半=hai nửa|m
两厘=hai li|m
两叁=hai ba|m
两双=hai cặp/hai đôi|m
两发=hai phát|m
两叠=giường hai tầng/gấp đôi|m
两口=hai ngụm/hai cái/hai phần|m
两句=hai câu/đôi câu|m
两只=hai con/hai cái/hai|m
两台=hai đài/hai bệ|m
两号=số hai|m
两名=hai tên/hai|m
两周=hai tuần/hai vòng|m
两响=hai tiếng|m
两团=hai đoàn/hai luồng/hai đám|m
两圈=hai vòng|m
两场=hai trận/hai tràng|m
两块=hai khối|m
两堆=hai đống|m
两声=hai tiếng|m
两处=hai nơi|m
两夜=hai đêm|m
两大块=hai khối lớn|m
两天=hai ngày|m
两头=hai đầu/hai phía/đầu nọ đầu kia/hai bên/hai nơi/hai con|m
两套=hai bộ|m
两季=hai mùa|m
两宗=hai tông|m
两家=hai nhà|m
两寸=hai thốn/hai tấc|m
两对=hai đôi|m
两封=hai lá|m
两尊=hai tôn/hai cái/hai vị|m
两尺=hai thước|m
两局=hai ván/hai cục|m
两层=hai tầng|m
两岁=hai tuổi|m
两峰=hai đỉnh núi|m
两帮=hai đám/hai bang|m
两幅=hai bức|m
两干年=hai ngàn năm|m
两年=hai năm|m
两座=hai tòa/hai chỗ ngồi|m
两张=hai tấm/hai cái/hai tờ|m
两成=hai thành/hai phần mười|m
两截=hai đoạn/hai khúc|m
两户=hai hộ|m
两所=hai chỗ|m
两扇=hai phiến/hai miếng|m
两手=hai tay/bản lĩnh/kỹ năng/phương pháp/biện pháp|m
两打=hai tá|m
两批=hai nhóm|m
两把=hai thanh/hai cái/hai cây|m
两折=20%/lưỡng chiết/giảm còn 20%|m
两招=hai chiêu|m
两拳=hai quyền|m
两捆=hai bó|m
两排=hai hàng|m
两支=hai chi|m
两文=hai văn/lưỡng văn|m
两方=hai phe|m
两日=hai ngày|m
两月=hai tháng|m
两本=hai bản/hai quyển|m
两朵=hai đóa|m
两杆=hai cây|m
两束=hai bó|m
两条=hai đầu/hai chiếc/hai cái|m
两杯=hai chén|m
两枚=hai viên/hai cái/hai mai/hai quả|m
两枝=hai cành|m
两枪=hai thương/hai phát|m
两架=hai khung/hai chiếc|m
两株=hai gốc/hai cây|m
两根=hai cây/hai cái|m
两桌=hai bàn|m
两桩=hai cọc|m
两桶=hai thùng|m
两次=hai lần|m
两次三番=hai lần ba bận/hai lần ba lần|m
两步=hai bước|m
两段=hai đoạn|m
两派=hai phái|m
两溜=hai dải|m
两滴=hai giọt|m
两点=hai điểm/hai giờ|m
两点钟=hai giờ đồng hồ/hai giờ|m
两片=hai mảnh|m
两瓶=hai bình|m
两百=hai trăm/200|m
两百万=hai trăm vạn/200 vạn/hai triệu|m
两百万两=hai trăm vạn lượng/hai triệu lượng|m
两百两=hai trăm lượng|m
两百五十=hai trăm năm mươi/250|m
两百亿=200 ức/20 tỷ|m
两百余=hơn hai trăm|m
两百八十里=280 dặm|m
两百多=hơn hai trăm/hơn 200|m
两百多万=hơn hai trăm vạn/hơn 2 triệu|m
两百多个=hơn hai trăm|m
两百多年=hơn hai trăm năm/hơn 200 năm|m
两百多里=hơn hai trăm dặm|m
两百年=hai trăm năm|m
两百架=hai trăm khung|m
两百次=hai trăm lần/200 lần|m
两百米=hai trăm mét/200m/200 mét|m
两百里=hai trăm dặm/200 dặm|m
两盏=hai ngọn|m
两眼=hai mắt|m
两碗=hai bát/hai chén|m
两种=hai loại|m
两秒=hai giây|m
两站=hai trạm|m
两章=hai chương|m
两端=hai đầu/lưỡng đoan|m
两簇=hai đóa|m
两米=hai mét/2m/hai thước|m
两类=hai loại|m
两粒=hai hạt|m
两组=hai tổ|m
两群=hai bầy|m
两股=hai cỗ/hai cổ|m
两艘=hai chiếc|m
两节=hai mảnh|m
两袋=hai túi|m
两角=hai sừng|m
两记=hai cái/hai phát/hai đòn|m
两趟=hai chuyến/hai lần|m
两轮=hai vòng/hai lượt/hai đợt/hai vành/|m
两载=hai năm|m
两辆=hai chiếc|m
两辈子=hai đời|m
两遍=hai lần|m
两道=hai đạo/lưỡng đạo|m
两遭=hai cái|m
两部=hai bộ|m
两里=hai dặm/hai dặm|m
两重=hai trọng/lượng nặng/hai tầng|m
两门=hai môn/hai khẩu|m
两队=hai đội|m
两面=hai mặt/mặt trái, mặt phải/hai nơi/hai phía/hai bên/tính hai mặt|m
两面三刀=hai mặt/hai lòng/đâm bị thóc thọc bị gạo|m
两顿=hai bữa|m
两颗=hai viên/hai khỏa|m
两首=hai bài|m
九万=chín vạn/90 ngàn|m
九万五千=chín vạn năm ngàn/95,000|m
九万余=hơn chín vạn|m
九万里=chín vạn dặm|m
九丈=chín trượng|m
九三=cửu tam|m
九三年=năm chín mươi ba|m
九下=chín lần|m
九两=chín lượng/chín lạng|m
九两多=hơn chín lượng|m
九个=chín|m
九九=cửu cửu|m
九九九=999|m
九九八十一=chín chín tám mươi mốt|m
九九年=99 năm|m
九九歌=cửu chương/bảng cửu chương|m
九二=cửu nhị|m
九五之尊=Cửu Ngũ Chí Tôn/ngôi cửu ngũ/ngôi vua|m
九亿=chín trăm triệu/chín trăm triệu|m
九件=chín kiện/chín cái|m
九伙=chín nhóm|m
九位=chín vị|m
九余=hơn chín|m
九倍=chín lần|m
九六年=năm 96|m
九具=chín bộ|m
九分=chín phần/chín điểm|m
九十=chín mươi/cửu thập|m
九十一=chín mươi mốt/91|m
九十七=chín mươi bảy|m
九十三=chín mươi ba|m
九十个=chín mươi|m
九十九=chín mươi chín/99|m
九十九米=99m/chín mươi chín mét|m
九十余=hơn chín mươi|m
九十八=chín mươi tám|m
九十六=chín mươi sáu|m
九十分钟=chín mươi phút/90 phút|m
九十多=hơn chín mươi|m
九十多万=hơn 90 vạn|m
九十多年=hơn chín mươi năm|m
九十天=chín mươi ngày|m
九十年代=thập niên 90/thập niên chín mươi/thập kỷ chín mươi|m
九十日=chín mươi ngày|m
九十里=chín mươi dặm|m
九千=chín ngàn/chín ngàn|m
九千万=chín ngàn vạn/chín trăm ngàn/90 triệu|m
九千两=chín ngàn lượng|m
九千余=hơn chín ngàn|m
九千多=hơn chín ngàn|m
九千岁=cửu thiên tuế|m
九卷=9 quyển|m
九叠=chín tầng|m
九口=chín khẩu|m
九只=chín cái/chín con/chín con|m
九号=số chín/Số 9/số chín|m
九名=chín tên/chín tên|m
九吨=9 tấn|m
九响=vang chín lần|m
九四=cửu tứ|m
九四年=năm chín mươi tư|m
九回=chín lần|m
九团=chín đám|m
九圈=chín vòng|m
九块=chín khối|m
九声=chín tiếng|m
九处=chín nơi|m
九多=hơn chín|m
九头=chín đầu/cửu đầu/chín con|m
九家=chín nhà/Cửu gia/cửu gia|m
九寸=chín tấc|m
九对=chín đối/9 đôi/chín đôi|m
九尊=chín vị|m
九少=Cửu thiếu|m
九尺=chín thước|m
九层=chín tầng/tầng chín/chín tầng|m
九岁=chín tuổi|m
九幅=chín bức|m
九座=chín tòa/ cửu tòa/cửu tòa/chín toà|m
九张=chín cái/chín tấm|m
九成=chín thành/chín phần mười|m
九批=chín tốp|m
九把=chín chuôi/chín thanh|m
九折=90%/giảm còn 90%|m
九排=hàng chín|m
九方=Cửu Phương|m
九曲=cửu khúc|m
九杆=chín cây|m
九条=chín đầu/chín cái|m
九枚=chín cái/chín miếng/chín viên|m
九架=chín chiếc|m
九株=chín cây|m
九次=chín lần/chín lần|m
九歌=Cửu Ca|m
九段=chín đoạn/cửu đoạn|m
九派=chín phái|m
九滴=chín giọt/chín giọt|m
九点=chín giờ/9 giờ|m
九点半=chín giờ rưỡi/9:30|m
九点钟=chín giờ|m
九片=chín mảnh|m
九班=ban 9/lớp 9|m
九瓶=chín bình|m
九百=chín trăm/chín trăm|m
九百万两=chín trăm vạn lượng/chín triệu lượng|m
九百两=chín trăm lượng|m
九百九十七=chín trăm chín mươi bảy/997|m
九百九十九=chín trăm chín mươi chín/999|m
九百九十八=chín trăm chín mươi tám/998|m
九百二十二=chín trăm hai mươi hai/922|m
九百余里=hơn chín trăm dặm|m
九百多=hơn chín trăm/hơn 900|m
九百多年=hơn 900 năm|m
九百里=chín trăm dặm/900 dặm|m
九眼=cửu nhãn|m
九种=chín loại|m
九秒=chín giây|m
九章=chín chương/chương 9|m
九等=cửu đẳng/cấp chín|m
九米=chín mét/9m|m
九粒=chín hạt|m
九级=cấp chín/chín cấp/cửu cấp|m
九组=chín tổ|m
九股=chín cỗ|m
九艘=chín chiếc|m
九角=cửu giác|m
九轮=cửu luân|m
九载=chín năm|m
九辆=chín chiếc|m
九遍=chín lần|m
九道=chín đạo|m
九部=chín bộ|m
九里=chín dặm/9 dặm/chín dặm|m
九重=cửu trọng/chín tầng|m
九零年=năm 90|m
九面=chín mặt|m
九顿=chín bữa ăn|m
九颗=chín khỏa/chín viên|m
二一=nhị nhất|m
二万=hai vạn/20 ngàn|m
二万两=hai vạn lượng|m
二万五千=hai vạn năm ngàn/25,000|m
二万五千里=hai mươi lăm ngàn dặm|m
二万余=hơn hai vạn|m
二万多=hơn hai vạn|m
二丈=hai trượng|m
二三=hai ba|m
二三万=hai, ba vạn|m
二三丈=hai ba trượng|m
二三十=hai ba mươi/hai mươi, ba mươi|m
二三十只=hai mươi, ba mươi con|m
二三十年=hai mươi ba mươi năm|m
二三十米=hai ba mươi mét|m
二三十道=hai ba mươi đạo|m
二三十里=hai ba mươi dặm/hai mươi, ba mươi dặm|m
二三千=hai, ba ngàn|m
二三天=hai ba ngày|m
二三层=hai ba tầng/tầng hai ba|m
二三成=hai ba thành/hai, ba phần mười|m
二三次=hai, ba lần|m
二三百=hai ba trăm|m
二三百米=200~300m/hai, ba trăm mét|m
二三百里=hai ba trăm dặm/hai, ba trăm dặm|m
二三米=hai, ba mét|m
二三里=hai, ba dặm|m
二下=hai lần|m
二两=hai lượng/hai lạng|m
二个=hai|m
二个月=hai tháng|m
二九=đôi chín/mười tám|m
二二=nhị nhị|m
二五眼=kém năng lực/kém chất lượng/người kém năng lực/người kém cỏi|m
二人组=tổ hai người|m
二亿=hai triệu/hai ức/hai trăm triệu|m
二件=hai cái|m
二伙=hai nhóm|m
二位=nhị vị|m
二余=hơn hai|m
二倍=gấp đôi|m
二儿=Nhị nhi|m
二元=hai nguyên tố/nhị nguyên|m
二八=đôi tám/hai tám/mười sáu|m
二六=hai sáu|m
二分=hai phần|m
二分之一=một phần hai|m
二副=phó nhì|m
二十=hai mươi|m
二十一=hai mươi mốt|m
二十一个=hai mươi mốt|m
二十一二岁=hai mươi hai mốt tuổi|m
二十一天=hai mươi mốt ngày|m
二十一日=ngày hai mươi mốt/hai mươi mốt ngày|m
二十七=hai mươi bảy/27|m
二十七个=hai mươi bảy|m
二十七八=hai mươi bảy hai mươi tám/27-28|m
二十七八岁=hai mươi bảy hai mươi tám tuổi|m
二十七天=hai mươi bảy ngày|m
二十七日=hai mươi bảy ngày/ngày hai mươi bảy|m
二十七秒=hai mươi bảy giây|m
二十七章=chương 27:|m
二十万=hai mươi vạn|m
二十万两=hai mươi vạn lượng|m
二十万左右=chừng hai mươi vạn|m
二十万斤=hai mươi vạn cân|m
二十三=hai mươi ba/23|m
二十三个=hai mươi ba|m
二十三年=23 năm|m
二十三日=hai mươi ba ngày|m
二十三道=hai mươi ba đạo|m
二十两=hai mươi lượng|m
二十个=hai mươi cái/hai mươi|m
二十九=hai mươi chín/29|m
二十九日=hai mươi chín ngày|m
二十二=hai mươi hai|m
二十二个=hai mươi hai|m
二十二代=hai mươi hai đời|m
二十二只=hai mươi hai con|m
二十二日=ngày 22/hai mươi hai ngày|m
二十二里=hai mươi hai dặm|m
二十五=hai mươi lăm|m
二十五两=hai mươi lăm lượng|m
二十五分=hai mươi lăm phút/25'|m
二十五日=ngày hai mươi lăm/hai mươi lăm ngày|m
二十五米=hai mươi lăm mét|m
二十五里=hai mươi lăm dặm|m
二十亿=hai tỷ/hai mươi tỷ/2 tỉ|m
二十余=hơn hai mươi|m
二十余万=hơn hai mươi vạn/hơn 200 ngàn|m
二十余只=hơn hai mươi con|m
二十余名=hơn hai mươi người|m
二十余天=hơn hai mươi ngày/hơn 20 ngày|m
二十余岁=hai mươi mấy tuổi|m
二十余日=hơn hai mươi ngày|m
二十余载=hơn hai mươi năm|m
二十余里=hơn hai mươi dặm|m
二十倍=gấp hai mươi lần/gấp 20 lần/gấp hai mươi|m
二十八=hai mươi tám|m
二十八九岁=hai mươi tám hai mươi chín tuổi|m
二十八年=hai mươi tám năm/năm 28|m
二十八日=hai mươi tám ngày|m
二十公里=hai mươi km|m
二十六=hai mươi sáu|m
二十六七=hai mươi sáu hai mươi bảy|m
二十六七岁=hai mươi sáu hai mươi bảy tuổi|m
二十六年=hai mươi sáu năm/26 năm|m
二十六日=hai mươi sáu ngày|m
二十几=hai mươi mấy|m
二十几个=hai mươi mấy cái/hai mươi mấy người/hai mươi mấy|m
二十几只=hai mươi mấy con/hai mươi mấy cái|m
二十几天=hai mươi mấy ngày|m
二十几年=hai mươi mấy năm|m
二十几米=hai mươi mấy mét|m
二十几里=hai mươi mấy dặm|m
二十出头=chừng hai mươi|m
二十分=hai mươi điểm/hai mươi phần/hai mươi phút|m
二十分钟=hai mươi phút/20 phút|m
二十只=hai mươi con|m
二十周年=hai mươi năm tròn|m
二十四=hai mươi bốn/24|m
二十四两=hai mươi bốn lượng|m
二十四个=hai mươi bốn|m
二十四五=hai bốn hai lăm/hai mươi bốn hai mươi lăm/24-25/24~25|m
二十四代=hai mươi bốn đời|m
二十四只=hai mươi bốn con|m
二十四把=hai mươi bốn thanh|m
二十四日=hai mươi bốn ngày|m
二十多=hơn hai mươi|m
二十多万=hơn hai mươi vạn|m
二十多丈=hơn hai mươi trượng|m
二十多分钟=hơn 20 phút|m
二十多只=hơn hai mươi cái/hơn hai mươi con|m
二十多天=hơn hai mươi ngày|m
二十多年=hơn hai mươi năm|m
二十多次=hai mươi lần|m
二十多米=hơn hai mươi mét/hơn 20m|m
二十多里=hơn hai mươi dặm|m
二十天=hai mươi ngày|m
二十头=hai mươi đầu/hai mươi con|m
二十岁=hai mươi tuổi|m
二十年=hai mươi năm|m
二十年代=thập kỷ 20|m
二十张=hai mươi tấm|m
二十日=hai mươi ngày|m
二十根=hai mươi cây|m
二十次=hai mươi lần|m
二十米=hai mươi mét/20m|m
二十许=hơn hai mươi|m
二十载=hai mươi năm|m
二十里=hai mươi dặm/hai mươi dặm|m
二千=hai ngàn/hai nghìn/hai ngàn|m
二千七百万=27 triệu|m
二千万=hai trăm ngàn|m
二千两=hai ngàn lượng|m
二千五百=hai ngàn năm trăm/2500/2,500|m
二千余=hơn hai ngàn|m
二千多=hơn hai nghìn/hơn hai ngàn|m
二千多年=hơn hai nghìn năm/hơn hai ngàn năm|m
二千多里=hơn hai ngàn dặm|m
二千里=hai nghìn dặm/hai ngàn dặm|m
二卷=hai quyển/quyển hai|m
二口=hai thanh|m
二只=hai cái/hai con|m
二号=số hai/số 2|m
二名=hai tên|m
二吨=2 tấn|m
二周=hai tuần|m
二四=hai bốn/hai, bốn|m
二团=hai đám/nhị đoàn|m
二圈=hai vòng|m
二块=hai khối|m
二声=hai tiếng|m
二多=hơn hai|m
二天=hai ngày/hôm khác/ngày khác/vài hôm nữa|m
二头=hai đầu/hai con|m
二家=hai nhà/Nhị gia|m
二寸=hai tấc|m
二少=nhị thiếu|m
二尺=hai thước|m
二层=tầng hai/hai tầng|m
二岁=hai tuổi|m
二幅=hai bức|m
二年=hai năm|m
二座=hai tòa/hai toà|m
二张=hai tấm/hai cái|m
二手=hai tay/second-hand|m
二批=hai tốp|m
二把=hai chuôi/hai thanh|m
二把刀=nửa vời/chưa thấu đáo/lõm bõm/lơ mơ/võ vẽ/người hiểu biết nửa vời/người biết không đến nơi đến chốn|m
二把手=người đứng thứ hai/nhị bả thủ|m
二排=hai hàng|m
二月=tháng hai/hai tháng|m
二杆=hai cây|m
二条=hai cái|m
二枚=hai miếng/hai viên|m
二架=hai chiếc|m
二株=hai cây|m
二根=hai cái|m
二次=hai lần/lần thứ hai|m
二次元=nhị thứ nguyên|m
二步=hai bước|m
二段=nhị đoạn|m
二滴=hai giọt|m
二点=hai điểm/hai giờ|m
二点钟=hai giờ|m
二片=hai miếng/hai mảnh|m
二班=ban hai/nhị ban/lớp hai|m
二瓶=hai bình|m
二百=hai trăm|m
二百一十=hai trăm mười/210|m
二百一十三=hai trăm mười ba/213|m
二百七十=270|m
二百七十多年=hơn 270 năm|m
二百万=hai trăm vạn/hai triệu|m
二百万两=hai trăm vạn lượng/hai triệu lượng|m
二百三十=hai trăm ba mươi/230|m
二百三十一=hai trăm ba mươi mốt/231|m
二百三十五=hai trăm ba mươi lăm/235|m
二百三十八=hai trăm ba mươi tám/238|m
二百三十多=hơn 230|m
二百两=hai trăm lượng/hai trăm lạng|m
二百九十三=hai trăm chín mươi ba/293|m
二百九十九=hai trăm chín mươi chín/299|m
二百二=220/thuốc đỏ|m
二百二十万=220 vạn|m
二百二十五=hai trăm hai mươi lăm/225|m
二百五=đồ ngốc/đồ gà mờ/hai trăm rưỡi/khờ dại/khờ khạo/người kiến thức nông cạn/người thiển cận/người biết hời hợt|m
二百五十=hai trăm năm mươi/250|m
二百五十万两=hai triệu năm trăm ngàn lượng|m
二百五十米=250 mét|m
二百五十里=hai trăm năm mươi dặm/250 dặm|m
二百余=hơn hai trăm|m
二百余里=hơn hai trăm dặm/hơn hai trăm dặm|m
二百八十=hai trăm tám mươi/280|m
二百八十万两=hai triệu tám trăm ngàn lượng|m
二百六十=260|m
二百六十四=hai trăm sáu mươi bốn/264|m
二百只=200 con|m
二百四十五=hai trăm bốn mươi lăm/245|m
二百四十里=240 dặm|m
二百多=hơn hai trăm/hơn 200|m
二百多两=hơn hai trăm lượng|m
二百多只=hơn 200 con|m
二百多年=hơn hai trăm năm/hơn 200 năm|m
二百多米=hơn hai trăm mét|m
二百多里=hơn hai trăm dặm|m
二百天=hai trăm ngày|m
二百年=hai trăm năm|m
二百次=200 lần|m
二百米=hai trăm mét/200m/200 mét|m
二百里=hai trăm dặm/200 dặm|m
二百零三=hai trăm linh ba/203|m
二百零六=hai trăm linh sáu/206|m
二百零四万=204 vạn|m
二种=hai loại|m
二秒=hai giây|m
二章=hai chương/chương hai|m
二米=hai mét/2m|m
二粒=hai hạt|m
二线=tuyến hai/hàng hai/hạng hai|m
二组=tổ 2/hai tổ|m
二维=hai chiều/2D|m
二群=hai bầy|m
二股=hai cỗ|m
二艘=hai chiếc|m
二载=hai năm|m
二辆=hai cỗ xe/hai chiếc|m
二遍=hai lần|m
二道=hai đạo|m
二部=hai bộ|m
二重=nhị trọng/hai tầng|m
二门=nhị môn/hai môn/cổng trong|m
二队=hai đội/đội 2/nhị đội|m
二零一零年=năm 2010|m
二零零二年=năm 2002|m
二零零五年=năm 2005|m
二颗=hai viên|m
五一=ngày mồng một tháng năm|m
五一节=ngày lễ quốc tế lao động|m
五七=năm bảy/năm, bảy|m
五万=năm vạn/50 ngàn|m
五万七千多=hơn 57,000|m
五万两=năm vạn lượng|m
五万二千=52,000|m
五万五千=năm vạn năm ngàn/55,000|m
五万余=hơn năm vạn|m
五万多=hơn năm vạn|m
五万里=năm vạn dặm|m
五丈=năm trượng|m
五下=năm lần|m
五两=năm lượng/năm lạng|m
五个=năm|m
五五=năm năm/5-5|m
五五分=chia năm năm/phân chia 5:5/năm mươi : năm mươi|m
五五开=chia năm năm|m
五亿=năm trăm triệu/năm trăm triệu (5 ức)|m
五亿八千万=580 triệu|m
五件=năm kiện/năm cái|m
五任=năm nhiệm|m
五份=năm phần|m
五伙=năm nhóm|m
五位=năm vị/Goi/năm người|m
五余=hơn năm|m
五倍=gấp năm lần/năm lần|m
五儿=Ngũ nhi|m
五六=năm sáu/năm, sáu|m
五六丈=năm sáu trượng|m
五六两=năm sáu lượng|m
五六倍=gấp năm sáu lần|m
五六分=năm sáu phần|m
五六十=năm sáu mươi/50-60/năm sáu chục/năm mươi, sáu mươi|m
五六十丈=năm mươi sáu mươi trượng|m
五六十只=năm mươi, sáu mươi con|m
五六十年=năm sáu mươi năm|m
五六十米=năm sáu mươi mét|m
五六十里=năm mươi, sáu mươi dặm|m
五六千=năm sáu ngàn|m
五六千米=năm, sáu ngàn mét|m
五六只=năm, sáu con|m
五六天=năm sáu ngày|m
五六层=năm sáu tầng/tầng năm sáu|m
五六年=năm sáu năm/5-6 năm|m
五六成=năm, sáu phần mười|m
五六次=năm sáu lần/năm, sáu lần|m
五六步=năm, sáu bước|m
五六百=năm sáu trăm/năm, sáu trăm|m
五六百米=năm sáu trăm mét|m
五六百里=năm, sáu trăm dặm|m
五六米=năm sáu mét/5-6 mét/5~6 mét/năm, sáu mét|m
五六级=ngũ lục cấp/cấp năm cấp sáu|m
五六里=năm sáu dặm/năm, sáu dặm|m
五分=năm phần/năm điểm/năm phút|m
五分之一=một phần năm|m
五分之二=hai phần năm|m
五分钟=năm phút đồng hồ|m
五列=năm hàng|m
五匹=năm thớt/năm con|m
五十=năm mươi/50|m
五十一=năm mươi mốt/51|m
五十七=năm mươi bảy|m
五十万=năm mươi vạn|m
五十万两=năm mươi vạn lượng/50 vạn lượng|m
五十万左右=khoảng 500 ngàn|m
五十三=năm mươi ba/53|m
五十下=năm mươi cái|m
五十两=năm mươi lượng|m
五十个=năm mươi cái/năm mươi|m
五十九=năm mươi chín|m
五十二=năm mươi hai/52|m
五十二天=52 ngày/năm mươi hai ngày|m
五十五=năm mươi lăm/55|m
五十余=hơn năm mươi|m
五十余岁=ngoài năm mươi tuổi|m
五十余米=hơn năm mươi mét|m
五十余里=hơn năm mươi dặm|m
五十八=năm mươi tám/58|m
五十六=năm mươi sáu/56|m
五十几=năm mươi mấy|m
五十几个=năm mươi mấy người|m
五十分钟=năm mươi phút đồng hồ|m
五十只=năm mươi cái/năm mươi con|m
五十四=năm mươi bốn|m
五十四个=năm mươi bốn|m
五十多=hơn năm mươi|m
五十多万=hơn 50 vạn|m
五十多只=hơn năm mươi con|m
五十多年=hơn năm mươi năm|m
五十多米=hơn năm mươi mét/hơn 50m|m
五十多里=hơn năm mươi dặm|m
五十天=năm mươi ngày|m
五十年=năm mươi năm/50 năm|m
五十年代=thập niên năm mươi|m
五十张=năm mươi tấm|m
五十把=50 thanh|m
五十根=năm mươi cái|m
五十毫升=50ml|m
五十秒=năm mươi giây|m
五十米=năm mươi mét/50m|m
五十道=năm mươi đạo|m
五十里=năm mươi dặm|m
五十首=năm mươi bài|m
五千=năm ngàn/5000/năm nghìn|m
五千万=năm ngàn vạn/năm mươi triệu|m
五千万两=năm ngàn vạn lượng|m
五千两=năm ngàn lượng/5000 lạng|m
五千余=hơn năm ngàn|m
五千余里=hơn năm ngàn dặm|m
五千八=5800|m
五千多=hơn năm ngàn|m
五千多万=hơn 50 triệu|m
五千多年=hơn năm nghìn năm/hơn năm ngàn năm|m
五千年=năm ngàn năm|m
五千米=năm ngàn mét/5000m|m
五千里=năm ngàn dặm/năm nghìn dặm|m
五卷=năm quyển|m
五双=năm đôi|m
五口=năm thanh/năm miệng|m
五只=năm con/năm cái|m
五号=số 5/số năm|m
五名=năm tên|m
五吨=5 tấn|m
五味=ngũ vị/năm vị|m
五四=năm bốn/54|m
五回=năm hồi|m
五圈=năm vòng|m
五块=năm khối|m
五堂=Ngũ đường|m
五声=ngũ thanh|m
五处=năm nơi|m
五多=hơn năm|m
五家=năm nhà/Ngũ gia|m
五寸=năm tấc/5 tấc|m
五对=năm đôi|m
五少=Ngũ Thiếu|m
五尺=năm thước|m
五层=năm tầng/tầng năm|m
五岁=năm tuổi|m
五峰=ngũ phong|m
五席=ngũ tịch|m
五幅=năm bức|m
五座=năm tòa/năm toà|m
五张=năm tấm/năm cái|m
五成=năm thành/năm phần mười|m
五截=năm khúc|m
五批=năm đám/năm tốp|m
五把=năm thanh|m
五折=50%/giảm còn 50%|m
五招=năm chiêu|m
五方=ngũ phương/năm phương|m
五朵=năm đóa|m
五杆=năm cây|m
五条=năm đầu/năm cái|m
五枚=năm mai/năm cái/năm viên/năm miếng|m
五枪=năm phát súng|m
五架=năm chiếc|m
五株=năm cây|m
五根=năm cái|m
五次=năm lần|m
五步=năm bước|m
五段=ngũ đoạn|m
五滴=năm giọt|m
五点=năm điểm/năm giờ|m
五点钟=năm giờ/năm giờ đồng hồ|m
五片=năm mảnh|m
五瓶=năm bình|m
五百=năm trăm/500|m
五百万=năm trăm vạn/năm triệu|m
五百万两=năm trăm vạn lượng/năm triệu lượng|m
五百三十=năm trăm ba mươi/530|m
五百两=năm trăm lượng/năm trăm lạng|m
五百余=hơn năm trăm|m
五百余里=hơn năm trăm dặm|m
五百八十五=năm trăm tám mươi lăm/585|m
五百六十万=560 vạn|m
五百四十=năm trăm bốn mươi/540|m
五百四十万=năm trăm bốn mươi vạn/540 vạn|m
五百多=hơn năm trăm/hơn 500|m
五百多年=hơn năm trăm năm/hơn 500 năm|m
五百多里=hơn năm trăm dặm|m
五百年=năm trăm năm|m
五百步=năm trăm bước|m
五百米=năm trăm mét/500m/500 mét|m
五百载=năm trăm năm|m
五百里=năm trăm dặm/500 dặm|m
五眼=ngũ nhãn|m
五种=năm loại|m
五秒=năm giây|m
五章=năm chương/chương 5|m
五等=ngũ đẳng/cấp năm|m
五米=năm mét/năm thước/năm mét|m
五粒=năm hạt|m
五组=năm tổ|m
五维=năm chiều|m
五缕=năm sợi|m
五群=năm bầy|m
五股=năm cỗ|m
五艘=năm chiếc|m
五角=ngũ giác|m
五轮=năm vòng/năm lượt|m
五载=năm năm/năm thứ năm|m
五辆=năm chiếc|m
五遍=năm lần|m
五道=năm đạo|m
五郎=Ngũ Lang|m
五部=năm bộ|m
五里=năm dặm/năm dặm|m
五重=ngũ trọng/năm tầng|m
五门=năm môn/Ngũ Môn|m
五队=đội năm/năm đội|m
五页=năm khối|m
五颗=năm khỏa/năm viên|m
五首=năm đầu|m
些个=một ít/một vài/cái ít|m
些天=vài ngày/ít ngày|m
亿=ức|m
亿万=ức vạn/hàng tỉ/tỉ tỉ/số vô cùng lớn/số cực lớn/tỉ tỉ/ngàn tỉ|m
亿万年=ức vạn năm/trăm triệu năm/ngàn tỉ năm|m
亿两=trăm triệu lạng|m
亿亿=ức ức/tỉ tỉ|m
亿兆=trăm tỉ tỉ|m
亿多年=hơn trăm triệu năm|m
亿年=ức năm|m
亿载=trăm triệu năm|m
亿道=trăm triệu đạo|m
亿里=ức dặm/trăm triệu dặm|m
仟=thiên|m
仨=ba|m
仨月=3 tháng|m
众个=đám|m
众多=đông đảo/phần đông/rất nhiều/đông đúc|m
众多人口=nhân khẩu đông đúc|m
余丈=trượng hơn|m
余下=còn lại/thừa lại/còn sót lại|m
余元=Dư Nguyên|m
余公里=dặm hơn|m
余响=dư vang|m
余家=Dư gia|m
余尺=hơn…thước/hơn thước|m
余岁=tuổi hơn|m
余年=năm hơn/những năm cuối(Dư Niên)/tuổi già/những năm cuối đời/quãng đời còn lại|m
余招=chiêu hơn|m
余数=số dư/số thừa|m
余款=dư khoản|m
余瓶=hơn…bình/hơn bình/hơn...bình|m
余米=mét hơn|m
余角=góc phụ|m
余里=dặm hơn|m
佰=bách|m
便条=ghi chép/giấy nhắn tin/note-stick|m
便桶=thùng phân/bô|m
便盆=bình nước tiểu/cái bô|m
俩=lưỡng|m
俩个=hai|m
俩句=hai câu|m
俩手=hai bàn tay|m
光趟=nhẵn bóng/nhẵn/nhẵn nhụi/trơn/mượt|m
全个=toàn bộ|m
全副=toàn bộ/hạng nặng/cả/đầy đủ/toàn phó/cả bộ/toàn bộ|m
全名=tên đầy đủ|m
全天=toàn bộ ngày|m
全套=nguyên bộ/toàn sáo/toàn bộ|m
全宗=toàn tông|m
全年=cả năm|m
全方位=toàn phương vị/tất cả các hướng/xung quanh|m
全根=toàn bộ|m
全米=toàn nước mỹ|m
全系列=toàn bộ series/toàn bộ sê-ri|m
八一=tám mốt|m
八万=tám vạn/80 ngàn|m
八万三千=83,000|m
八万五千=tám vạn năm ngàn/85,000|m
八万余=hơn tám vạn|m
八万四千=84,000|m
八万四千里=tám mươi bốn ngàn dặm|m
八万多=hơn tám vạn|m
八万里=tám vạn dặm/tám vạn dặm|m
八丈=tám trượng|m
八三=tám ba|m
八下=tám lần|m
八两=tám lượng/tám lạng|m
八个=tám|m
八九=tám chín/89/tám, chín|m
八九万=tám, chín vạn|m
八九分=tám chín phần|m
八九十=tám chín mươi/80~90/tám mươi, chín mươi|m
八九十里=tám mươi, chín mươi dặm|m
八九千=tám, chín ngàn|m
八九名=tám, chín tên|m
八九天=tám chín ngày|m
八九成=tám chín thành/tám, chín phần mười|m
八九百=tám chín trăm/tám, chín trăm|m
八九米=tám chín mét/tám, chín mét|m
八九里=tám, chín dặm|m
八五折=85%|m
八亿=tám trăm triệu/8 ức|m
八件=tám cái|m
八份=tám phần|m
八伙=tám nhóm|m
八位=tám vị/tám người|m
八余=hơn tám|m
八倍=tám lần/gấp tám/gấp tám lần|m
八克=tám gram|m
八八=bát bát|m
八八六十四=tám tám sáu tư|m
八分=tám phần/tám điểm/chữ bát phân|m
八分钟=tám phút|m
八十=tám mươi/tám mươi|m
八十一=tám mươi mốt|m
八十一只=tám mươi mốt con|m
八十一招=tám mươi mốt chiêu|m
八十一日=tám mươi mốt ngày|m
八十七=tám mươi bảy|m
八十万=tám mươi vạn/tám trăm ngàn|m
八十万两=tám mươi vạn lượng|m
八十三=tám mươi ba|m
八十两=tám mươi lượng|m
八十个=tám mươi cái|m
八十九=tám mươi chín|m
八十二=tám mươi hai|m
八十五=tám mươi lăm|m
八十亩=tám mươi mẫu|m
八十余=hơn tám mươi|m
八十余里=hơn 80 dặm/hơn tám mươi dặm|m
八十八=tám mươi tám|m
八十六=tám mươi sáu|m
八十四=tám mươi bốn|m
八十多=hơn tám mươi|m
八十多年=hơn tám mươi năm|m
八十多里=hơn tám mươi dặm|m
八十年代=những năm tám mươi/thập niên tám mươi/niên đại 80|m
八十次=tám mươi lần|m
八十米=tám mươi mét/80m|m
八十道=tám mươi đạo|m
八十里=tám mươi dặm|m
八千=tám ngàn/tám ngàn|m
八千万=tám ngàn vạn/tám mươi triệu/80 triệu|m
八千两=tám ngàn lượng|m
八千八百万=88 triệu|m
八千多=hơn tám nghìn/hơn tám ngàn|m
八千根=tám ngàn cây|m
八千里=tám ngàn dặm/tám nghìn dặm|m
八卷=8 quyển|m
八双=tám đôi|m
八口=tám thanh|m
八句=tám câu|m
八只=tám con/tám cái|m
八名=tám tên/tám gã|m
八吨=8 tấn|m
八块=tám khối|m
八处=tám chỗ/tám nơi|m
八多=hơn tám|m
八大处=tám nơi lớn|m
八家=tám nhà/Bát gia|m
八寸=tám tấc/8 tấc|m
八少=bát thiếu|m
八尺=tám thước/tám thước|m
八层=tám tầng/tầng tám|m
八岁=tám tuổi/tám tuổi|m
八座=tám tòa/tám toà|m
八张=tám tấm/tám cái|m
八成=tám thành/tám phần/tám phần mười/tám mươi phần trăm/80%/sắp xong/có lẽ/cầm chắc/hầu như/gần như/chắc chắn|m
八截=tám đoạn|m
八手=tám tay/bát thủ/Yatsude|m
八批=tám tốp|m
八把=tám thanh/tám thanh|m
八折=80%/giảm còn 80%/bát chiết|m
八束=tám bó|m
八条=tám đầu/tám cái|m
八枚=tám cái/tám miếng/tám viên|m
八架=tám chiếc|m
八株=tám cây|m
八根=tám cái|m
八次=tám lần/tám lần|m
八滴=tám giọt|m
八点=tám giờ|m
八点半=tám giờ rưỡi/8:30|m
八点档=phim dài tập/(phim bộ khung giờ 20:00)|m
八点钟=tám giờ|m
八片=tám mảnh|m
八班=lớp tám|m
八瓶=tám bình|m
八番=Bát phiên|m
八百=tám trăm/800|m
八百万=tám trăm vạn/tám triệu|m
八百万两=tám triệu lượng|m
八百两=tám trăm lượng|m
八百余=hơn tám trăm|m
八百余里=hơn tám trăm dặm|m
八百多=hơn tám trăm/hơn 800|m
八百多年=hơn tám trăm năm/hơn 800 năm|m
八百年=tám trăm năm|m
八百米=tám trăm mét/800m/800 mét|m
八百里=tám trăm dặm/800 dặm|m
八百零七万=807 vạn|m
八种=tám loại|m
八秒=tám giây|m
八章=tám chương/chương 8|m
八等=bát đẳng/cấp tám|m
八米=tám mét/tám mét|m
八粒=tám hạt|m
八维=tám chiều|m
八股=bát cổ/rỗng tuếch/cứng nhắc/sáo mòn/rập khuôn/lặp lại y như đúc|m
八艘=tám chiếc|m
八角=bát giác/cây hồi/hồi/hồi hương/đại hồi/hình bát giác|m
八轮=tám bánh|m
八载=tám năm/tám năm|m
八辆=tám chiếc|m
八辈=tám đời|m
八辈子=tám đời/tám kiếp/mãn kiếp/cực lâu|m
八遍=tám lần|m
八道=tám đạo/bát đạo|m
八部=tám bộ/bát bộ|m
八里=tám dặm/8 dặm/tám dặm|m
八重=bát trọng/tám tầng|m
八颗=tám khỏa/tám viên|m
八首=tám đầu|m
六=lục|m
六七=sáu bảy|m
六七个=sáu bảy|m
六七十=sáu bảy mươi/sáu mươi bảy mươi/sáu mươi, bảy mươi|m
六七十年代=những năm 60-70/thập niên sáu mươi bảy mươi|m
六七十米=sáu bảy mươi mét/sáu mươi, bảy mươi mét|m
六七十里=sáu bảy mươi dặm|m
六七千两=sáu bảy ngàn lượng|m
六七只=sáu, bảy con|m
六七品=sáu phẩm bảy phẩm/sáu bảy phẩm|m
六七天=sáu bảy ngày|m
六七成=sáu bảy thành/sáu, bảy phần mười|m
六七次=sáu, bảy lần|m
六七点=sáu, bảy giờ|m
六七百=sáu bảy trăm/sáu, bảy trăm|m
六七百米=sáu, bảy trăm mét|m
六七米=sáu bảy mét|m
六七里=sáu, bảy dặm|m
六万=sáu vạn/60 ngàn|m
六万两=sáu vạn lượng|m
六万九千=sáu vạn chín ngàn/69,000|m
六万五千=sáu vạn năm ngàn|m
六万余=hơn sáu vạn|m
六万多=hơn sáu vạn|m
六丈=sáu trượng|m
六下=sáu lần|m
六两=sáu lượng/sáu lạng|m
六个=sáu cái/sáu|m
六个月=sáu tháng|m
六九五十四=lục cửu ngũ thập tứ|m
六二=sáu hai/62|m
六二五=lục nhị ngũ|m
六亿=sáu trăm triệu/sáu trăm triệu|m
六亿五千万=650 triệu|m
六亿人=sáu trăm triệu người|m
六件=sáu cái|m
六伙=sáu nhóm|m
六位=sáu vị/sáu người/Sáu vị quan trọng/gồm: quân/thần/phụ/tử/phu/phụ 君/臣/父/子/夫/婦 vua/tôi/cha/con/chồng/vợ.Sáu hào 爻 trong kinh Dịch 易 dùng để tượng: âm/dương/cương/nhu/nhân nghĩa.|m
六余=hơn sáu|m
六倍=gấp sáu lần/sáu lần|m
六儿=Lục nhi|m
六八=sáu tám/sáu, tám|m
六具=sáu cỗ|m
六分=sáu phần/sáu điểm|m
六分之一=một phần sáu|m
六分钟=sáu phút|m
六副=sáu bức|m
六十=sáu mươi/60/sáu mươi|m
六十一=sáu mươi mốt|m
六十七=sáu mươi bảy/67|m
六十三=sáu mươi ba|m
六十两=sáu mươi lượng|m
六十个=sáu mươi|m
六十九=sáu mươi chín|m
六十二=sáu mươi hai|m
六十五=sáu mươi lăm/65|m
六十余=hơn sáu mươi|m
六十余岁=ngoài sáu mươi tuổi|m
六十余里=hơn sáu mươi dặm|m
六十八=sáu mươi tám|m
六十六=sáu mươi sáu|m
六十四=sáu mươi bốn|m
六十四代=sáu mươi bốn đời|m
六十四天=sáu mươi tư ngày|m
六十多=hơn sáu mươi|m
六十多万=hơn 60 vạn|m
六十多岁=hơn sáu mươi tuổi|m
六十多年=hơn sáu mươi năm|m
六十多里=hơn sáu mươi dặm|m
六十天=sáu mươi ngày|m
六十年=sáu mươi năm/60 năm|m
六十年代=thập niên sáu mươi|m
六十日=sáu mươi ngày|m
六十米=sáu mươi mét/60m|m
六十里=sáu mươi dặm|m
六千=sáu ngàn/sáu ngàn|m
六千万=sáu ngàn vạn/6000 vạn/60 triệu|m
六千两=sáu ngàn lượng|m
六千五百=6,500|m
六千余=hơn sáu ngàn|m
六千只=6,000 con|m
六千多=hơn sáu ngàn/hơn sáu nghìn|m
六千多万=hơn 60 triệu|m
六千米=sáu ngàn mét|m
六千里=sáu ngàn dặm/sáu nghìn dặm|m
六卷=quyển sáu/sáu quyển|m
六只=sáu con/sáu cái/sáu con|m
六台=sáu đài|m
六号=số sáu/số 6/số sáu|m
六名=sáu tên/sáu gã|m
六吨=6 tấn|m
六品=lục phẩm|m
六四=64|m
六团=sáu đám|m
六块=sáu khối|m
六处=sáu nơi|m
六多=hơn sáu|m
六天=sáu ngày/sáu ngày|m
六头=sáu đầu/lục đầu/sáu con|m
六宗=sáu tông/lục tông|m
六家=sáu nhà/Lục gia|m
六寸=sáu tấc/6 tấc|m
六对=sáu đôi|m
六尺=sáu thước|m
六尾=sáu đuôi/lục vĩ|m
六层=sáu tầng/tầng sáu|m
六岁=sáu tuổi/sáu tuổi|m
六席=lục tịch|m
六幅=sáu bức|m
六年=sáu năm/năm sáu|m
六座=sáu tòa/sáu toà|m
六张=sáu tấm/sáu cái/sáu tờ|m
六成=sáu thành/sáu phần mười|m
六批=sáu tốp|m
六把=sáu thanh/sáu chuôi/sáu thanh|m
六折=60%/giảm còn 60%|m
六排=sáu hàng|m
六文=lục văn|m
六杆=sáu cây|m
六条=sáu đầu/sáu cái|m
六枚=sáu cái/sáu miếng/sáu viên|m
六架=sáu chiếc|m
六株=sáu cây|m
六根=sáu cái/lục căn|m
六次=sáu lần/sáu lần|m
六步=sáu bước/lục bộ|m
六段=lục đoạn|m
六派=lục phái|m
六滴=sáu giọt|m
六点=sáu điểm/sáu giờ/6h|m
六点半=sáu giờ rưỡi/6:30|m
六点钟=sáu giờ/sáu giờ đồng hồ|m
六片=sáu mảnh|m
六班=ban 6/lớp sáu|m
六瓶=sáu bình|m
六百=sáu trăm/600|m
六百万两=sáu trăm vạn lượng/sáu triệu lượng|m
六百三十三=633|m
六百三十四=sáu trăm ba mươi bốn/634|m
六百两=sáu trăm lượng|m
六百五十=sáu trăm năm mươi/650|m
六百五十二=sáu trăm năm mươi hai/652|m
六百五十米=650 mét|m
六百余=hơn sáu trăm|m
六百六十=sáu trăm sáu mươi/660|m
六百多=hơn sáu trăm/hơn 600|m
六百多年=hơn sáu trăm năm|m
六百多里=hơn sáu trăm dặm|m
六百年=sáu trăm năm|m
六百米=sáu trăm mét/600m/600 mét|m
六百里=sáu trăm dặm/600 dặm|m
六种=sáu loại/sáu loại|m
六秒=sáu giây|m
六等=lục đẳng/cấp 6/cấp sáu|m
六米=sáu mét/sáu mét|m
六粒=sáu hạt|m
六级=cấp sáu/sáu cấp/lục cấp|m
六组=sáu tổ/tổ 6|m
六维=sáu chiều|m
六群=sáu bầy|m
六股=sáu cỗ|m
六艘=sáu chiếc|m
六角=lục giác|m
六路=lục lộ/xung quanh|m
六载=sáu năm|m
六辆=sáu chiếc|m
六遍=sáu lần|m
六道=sáu đạo/lục đạo|m
六部=lục bộ/sáu bộ|m
六里=sáu dặm/sáu dặm|m
六重=lục trọng/sáu tầng|m
六顿=sáu bữa|m
六颗=sáu khỏa/sáu viên|m
六首=lục thủ|m
几=kỷ|m
几万=mấy vạn/mấy vạn|m
几万两=mấy vạn lượng|m
几万倍=mấy vạn lần|m
几万只=mấy vạn con|m
几万头=mấy vạn con|m
几万年=mấy vạn năm|m
几万米=mấy vạn mét|m
几万里=mấy vạn dặm/mấy vạn dặm|m
几丈=mấy trượng|m
几下=mấy lần/vài cái/mấy cái|m
几下子=mấy cái/mấy lần|m
几世=mấy đời/mấy thế hệ|m
几丝=vài tia|m
几两=mấy lượng/mấy lạng|m
几串=mấy xâu|m
几亩=vài mẫu|m
几人回=mấy người trở về|m
几人里=trong mấy người|m
几亿=vài ức/vài tỷ/mấy trăm triệu|m
几亿元=mấy ức nguyên|m
几代=mấy đời|m
几件=mấy món/vài món|m
几任=mấy đời/vài vị|m
几份=mấy phần/vài phần|m
几伙=mấy nhóm|m
几位=vài vị|m
几例=mấy ví dụ|m
几倍=mấy lần/vài lần/gấp mấy lần|m
几儿=hôm nào/ngày nào/ngày mấy|m
几元=kỷ nguyên|m
几公里=mấy cây số|m
几具=mấy cỗ/mấy cổ|m
几分=mấy phần/vài phần/một chút/hơi|m
几分钟=vài phút/mấy phút|m
几列=vài hàng|m
几副=mấy bộ|m
几匹=vài thớt|m
几十=mấy chục|m
几十万=mấy chục vạn/mấy trăm ngàn|m
几十万两=mấy chục vạn lượng|m
几十万年=vài chục vạn năm|m
几十万米=mấy trăm ngàn mét|m
几十丈=hơn mười trượng|m
几十下=mấy chục cái/mấy chục lần|m
几十两=mấy chục lượng|m
几十亿=vài tỷ|m
几十代=mấy chục đời|m
几十位=hơn mười vị|m
几十倍=gấp mấy chục lần/gấp mấy chục|m
几十元=mấy chục đồng|m
几十公里=mấy chục cây số/vài chục km|m
几十分之一=một phần mấy chục|m
几十分钟=mấy mươi phút|m
几十双=hơn mười đôi|m
几十只=mấy chục con/mấy chục cái/vài chục con/vài chục chích|m
几十天=hơn mười ngày/hơn 10 ngày|m
几十头=mấy chục con|m
几十年=mấy chục năm/mấy thập niên|m
几十座=mấy chục tòa|m
几十张=mấy chục tấm|m
几十把=mấy chục thanh|m
几十条=hơn mười đầu|m
几十根=mấy chục cây|m
几十次=mấy chục lần|m
几十种=mấy chục loại|m
几十箱=hơn mười rương|m
几十米=mấy chục mét/hơn 10m|m
几十载=mấy chục năm|m
几十遍=mấy chục lần|m
几十道=mấy chục đạo|m
几十里=mấy chục dặm|m
几千=mấy ngàn/mấy nghìn/mấy ngàn|m
几千万=mấy ngàn vạn/mấy chục triệu|m
几千两=mấy ngàn lượng|m
几千倍=mấy ngàn lần|m
几千公里=mấy ngàn cây số/mấy ngàn km|m
几千只=mấy ngàn con|m
几千头=mấy ngàn con|m
几千年=mấy ngàn năm/mấy nghìn năm|m
几千次=mấy ngàn lần|m
几千百次=mấy trăm ngàn lần|m
几千百遍=mấy trăm ngàn lần|m
几千米=mấy ngàn mét|m
几千遍=mấy ngàn lần|m
几千里=mấy ngàn dặm/vài nghìn dặm/vài ngàn dặm|m
几双=vài đôi/mấy đôi|m
几口=mấy ngụm/vài hớp/mấy cái/mấy thanh|m
几句=vài câu/mấy câu|m
几只=mấy cái/mấy con/vài con|m
几号=số mấy/mấy ngày/một chút|m
几名=mấy tên/vài tên|m
几周=mấy tuần/vài tuần|m
几味=mấy vị|m
几回=mấy lần/vài lần|m
几团=một đoàn/mấy đám|m
几圈=vài vòng/mấy vòng|m
几场=mấy trận|m
几块=mấy khối|m
几堵=mấy bức|m
几声=vài tiếng/mấy tiếng|m
几处=mấy chỗ|m
几多=bao nhiêu/mấy|m
几夜=vài đêm|m
几大口=mấy ngụm lớn|m
几天=mấy ngày/vài ngày|m
几天几夜=mấy ngày mấy đêm|m
几套=mấy bộ|m
几家=mấy nhà|m
几寸=mấy tấc|m
几小时=mấy tiếng|m
几尺=vài thước/mấy thước|m
几层=mấy tầng|m
几届=mấy lần/vài lần|m
几岁=mấy tuổi/vài tuổi|m
几年=mấy năm/vài/vài năm|m
几座=vài toà/mấy toà|m
几张=mấy trương/mấy tờ/tấm vé/vài tờ|m
几成=mấy thành/mấy phần mười|m
几截=vài đoạn/mấy đoạn|m
几户=mấy hộ/vài hộ|m
几批=mấy đám/mấy tốp|m
几把=mấy cái/vài thanh|m
几招=mấy chiêu|m
几排=mấy hàng|m
几撮=mấy túm|m
几斤=mấy cân/mấy/vài cân|m
几日=mấy ngày|m
几星期=mấy tuần|m
几月=mấy tháng|m
几本=mấy quyển/một vài|m
几杆=mấy cái|m
几条=mấy đầu/mấy cái|m
几杯=mấy chén|m
几枚=mấy cái/mấy viên|m
几枪=mấy thương/mấy phát/mấy phát đạn|m
几架=vài khung/mấy chiếc|m
几株=vài cọng/mấy bụi/vài cây|m
几样=mấy thứ|m
几根=mấy cây|m
几案=kỷ án|m
几棵=mấy cây|m
几次=mấy lần/vài lần|m
几次三番=ba phen mấy bận/hết lần này tới lần khác|m
几步=mấy bước/vài bước|m
几段=vài đoạn/mấy đoạn|m
几毫克=chỉ vài gam|m
几滴=mấy giọt/vài giọt|m
几点=mấy điểm/mấy giờ/vài điểm/khi nào|m
几点钟=mấy giờ/mấy phút|m
几片=vài miếng/mấy miếng|m
几瓶=mấy bình|m
几番=trải qua/Trải qua/mấy phen/vài lần|m
几百=mấy trăm/mấy trăm|m
几百万=mấy trăm vạn/mấy triệu/mấy triệu|m
几百万两=mấy trăm vạn lượng/mấy triệu lượng|m
几百两=mấy trăm lượng|m
几百个=mấy trăm|m
几百倍=mấy trăm lần|m
几百只=mấy trăm con|m
几百回=mấy trăm lần|m
几百头=mấy trăm con|m
几百年=mấy trăm năm|m
几百张=mấy trăm tấm|m
几百次=mấy trăm lần|m
几百点=mấy trăm điểm|m
几百种=mấy trăm loại|m
几百米=mấy trăm mét|m
几百遍=mất trăm lần/mấy trăm lần|m
几百道=mấy trăm đạo|m
几百里=vài trăm dặm/mấy trăm dặm|m
几盘=mấy bàn/mấy mâm/thêm vài bản/kỷ bàn/mâm/chậu|m
几眼=vài lần/mấy lần/mấy mắt|m
几种=mấy loại/vài loại/nhiều/vài|m
几秒=vài giây/mấy giây/một vài giây|m
几站=mấy trạm|m
几笔=mấy bút/vài nét bút/ít nét bút|m
几米=mấy mét/vài mét|m
几粒=mấy hạt|m
几组=mấy tổ|m
几缕=mấy sợi|m
几群=mấy nhóm/mấy bầy|m
几股=mấy cỗ/vài cỗ/vài cổ|m
几腔=đầy ấp|m
几艘=mấy chiếc|m
几行=mấy hàng/vài hàng|m
几角=mấy góc|m
几记=vài cái/mấy đòn|m
几趟=mấy chuyến/vài chuyến|m
几轮=mấy vòng|m
几载=mấy năm|m
几辆=mấy chiếc|m
几遍=mấy lần|m
几道=mấy đạo/vài đạo|m
几部=mấy bộ|m
几里=vài dặm/mấy dặm/mấy dặm|m
几重=mấy tầng|m
几钟=mấy phút|m
几门=mấy khẩu/mấy môn|m
几间=mấy gian|m
几面=mấy mặt/mấy lần/vài lần|m
几页=vài trang/vài tờ/trang/mấy tờ|m
几顿=mấy trận|m
几颗=mấy khỏa/mấy viên|m
分两=phân hai|m
分两路=chia làm hai đường|m
分句=phân câu|m
分多钟=phút hơn|m
分批=từng nhóm/từng tốp/lần lượt/luân phiên|m
分毫=mảy may/một chút/tí tẹo/tí/ít/chút nào|m
加倍=gấp bội/gấp đôi/hơn/tăng gấp bội|m
加多少=tăng bao nhiêu|m
十一=mười một/ngày 1 tháng 10|m
十一个月=mười một tháng|m
十一二=mười một mười hai|m
十一二岁=mười một mười hai tuổi|m
十一分=mười một phần/11%|m
十一只=mười một con|m
十一号=số mười một|m
十一名=mười một tên/mười một gã|m
十一天=mười một ngày|m
十一层=mười một tầng/tầng mười một|m
十一年=mười một năm|m
十一张=mười một tấm|m
十一日=mười một ngày|m
十一月=tháng mười một/tháng 11|m
十一次=mười một lần|m
十一点=mười một giờ|m
十一点半=11:30/mười một giờ rưỡi|m
十一点多=hơn mười một giờ|m
十一点左右=khoảng mười một giờ|m
十一载=năm thứ mười một/mười một năm|m
十一郎=Thập Nhất Lang|m
十七=mười bảy/17/thập thất|m
十七个=mười bảy cái|m
十七八=mười bảy mười tám|m
十七八岁=mười bảy mười tám tuổi|m
十七号=số mười bảy/số 17|m
十七天=mười bảy ngày|m
十七层=mười bảy tầng/tầng mười bảy|m
十七日=mười bảy ngày|m
十七次=mười bảy lần|m
十七级=cấp 17|m
十七载=mười bảy năm|m
十七里=mười bảy dặm|m
十万=mười vạn/mười vạn|m
十万两=mười vạn lượng/mươi vạn lượng|m
十万余=hơn mười vạn|m
十万八千=mười vạn tám ngàn|m
十万八千里=cách xa vạn dặm/xa tít tắp/mười vạn tám ngàn dặm|m
十万分之一=một phần một trăm ngàn|m
十万块=mười vạn khối/mười vạn đồng|m
十万多=hơn mười vạn|m
十万天=một trăm ngàn ngày/mười vạn thiên|m
十万左右=chừng mười vạn|m
十万里=mười vạn dặm/mười vạn dặm|m
十丈=mười trượng|m
十三=mười ba/thập tam|m
十三亿=mười ba ức/1.3 tỷ|m
十三位=mười ba vị|m
十三卷=mười ba quyển|m
十三只=mười ba con|m
十三号=số mười ba/mười ba hào/số 13|m
十三四=mười ba mười bốn|m
十三四岁=mười ba mười bốn tuổi|m
十三处=mười ba nơi|m
十三天=mười ba ngày|m
十三家=mười ba nhà|m
十三层=tầng mười ba|m
十三岁=mười ba tuổi/mười ba tuổi|m
十三年=mười ba năm|m
十三排=hàng mười ba|m
十三日=mười ba ngày|m
十三次=mười ba lần|m
十三步=mười ba bước|m
十三种=mười ba chủng|m
十三米=mười ba mét|m
十三载=mười ba năm|m
十三道=mười ba đạo|m
十三里=mười ba dặm|m
十两=mười lượng/mười hai/mười lạng|m
十个月=mười tháng|m
十之八=tám phần mười|m
十之八九=tám chín phần mười|m
十九=mười chín/19|m
十九代=mười chín đời|m
十九分=mười chín điểm|m
十九号=số 19/số mười chín|m
十九天=mười chín ngày/19 ngày|m
十九层=mười chín tầng|m
十九岁=mười chín tuổi|m
十九峰=Thập Cửu phong|m
十九日=ngày mười chín/mười chín ngày|m
十二=mười hai|m
十二万=mười hai vạn|m
十二万两=mười hai vạn lượng|m
十二万分=mười hai vạn phần|m
十二万四千=124,000|m
十二三=mười hai mười ba|m
十二三岁=mười hai mười ba tuổi|m
十二三里=mười hai mười ba dặm|m
十二两=mười hai lượng|m
十二个=mười hai cái/mười hai|m
十二亿=12 ức|m
十二代=đời thứ mười hai/mười hai đời|m
十二位=mười hai vị|m
十二倍=gấp mười hai lần|m
十二分=mười hai phần/mười hai điểm/hoàn toàn/trăm phần trăm/mười phần/rất là|m
十二只=mười hai con|m
十二号=số mười hai/số 12|m
十二名=mười hai tên|m
十二多=hơn 12|m
十二天=mười hai ngày/12 ngày|m
十二头=mười hai đầu/mười hai con|m
十二幅=mười hai bức/thập nhị phúc|m
十二年=mười hai năm|m
十二张=mười hai tấm|m
十二把=mười hai thanh|m
十二支=thập nhị chi/địa chi/mười hai chi|m
十二日=ngày 12/mười hai ngày|m
十二月=tháng mười hai/mười hai tháng|m
十二条=mười hai đầu/mười hai cái|m
十二次=mười hai lần|m
十二点=mười hai giờ/mười hai điểm/12h/12 giờ|m
十二米=mười hai mét|m
十二级=12 cấp|m
十二载=mười hai năm|m
十二道=mười hai đạo|m
十二里=mười hai dặm|m
十二重=thập nhị trọng/tầng mười hai|m
十五=mười lăm|m
十五万=mười lăm vạn|m
十五万两=mười lăm vạn lượng|m
十五两=mười lăm lượng/15 lượng|m
十五个=mười lăm cái/mười lăm người/mười lăm|m
十五位=mười lăm vị|m
十五六=mười lăm mười sáu/15~16/mười lăm, mười sáu|m
十五六岁=mười lăm mười sáu tuổi|m
十五六米=mười lăm mười sáu mét|m
十五六里=15-16 dặm|m
十五分钟=mười lăm phút/15 phút|m
十五只=mười lăm con|m
十五号=số mười lăm/ngày 15/số 15|m
十五名=mười lăm tên|m
十五天=mười lăm ngày|m
十五头=mười lăm con|m
十五层=mười lăm tầng/tầng mười lăm|m
十五岁=mười lăm tuổi|m
十五年=mười lăm năm|m
十五张=mười lăm tấm|m
十五日=mười lăm ngày|m
十五次=mười lăm lần|m
十五秒=mười lăm giây|m
十五米=mười lăm mét|m
十五级=cấp mười lăm/mười lăm cấp|m
十五载=mười lăm năm|m
十五里=mười lăm dặm|m
十人里=trong mười người|m
十亿=một tỷ/mười ức/10 ức/1 tỷ|m
十件=mười cái|m
十份=mười phần/thập phần|m
十伙=mười nhóm|m
十位=mười vị/hàng chục/mười người/Hàng chục|m
十余=hơn mười|m
十余万=hơn mười vạn/hơn trăm ngàn|m
十余丈=hơn mười trượng|m
十余下=hơn mười cái/hơn mười lần|m
十余只=hơn mười con|m
十余名=hơn mười tên|m
十余处=hơn mười chỗ|m
十余天=hơn mười ngày|m
十余年=hơn mười năm|m
十余招=hơn mười chiêu|m
十余日=hơn mười ngày|m
十余根=hơn mười cây|m
十余次=hơn mười lần|m
十余步=hơn mười bước|m
十余米=hơn mười mét|m
十余载=hơn mười năm|m
十余道=hơn mười đạo|m
十余里=trong vòng hơn mười dặm/hơn mười dặm|m
十倍=gấp mười/thập bội/gấp 10 lần/gấp mười lần|m
十克=mười gram|m
十八=mười tám|m
十八九=mười tám mười chín|m
十八九岁=mười tám mười chín tuổi|m
十八代=mười tám đời|m
十八位=mười tám vị|m
十八分=mười tám điểm|m
十八号=số 18/số mười tám|m
十八天=mười tám ngày|m
十八头=mười tám con|m
十八层=mười tám tầng/tầng mười tám|m
十八岁=mười tám tuổi|m
十八年=mười tám năm|m
十八日=mười tám ngày|m
十八次=mười tám lần|m
十八种=mười tám loại|m
十八级=mười tám cấp/cấp 18|m
十八道=mười tám đạo|m
十八里=mười tám dặm|m
十公里=mười cây số/10 km/mười km|m
十六=mười sáu/thập lục/16|m
十六七=mười sáu mười bảy/mười sáu, mười bảy|m
十六七岁=mười sáu mười bảy tuổi|m
十六代=mười sáu đời|m
十六分=mười sáu điểm|m
十六分钟=mười sáu phút|m
十六只=mười sáu con/mười sáu cái|m
十六号=số mười sáu|m
十六周岁=tròn 16 tuổi|m
十六天=mười sáu ngày/16 ngày|m
十六头=mười sáu con|m
十六岁=mười sáu tuổi|m
十六张=mười sáu tấm|m
十六日=mười sáu ngày|m
十六次=mười sáu lần|m
十六点=mười sáu giờ|m
十六级=16 cấp|m
十六里=mười sáu dặm|m
十具=mười bộ|m
十几=mười mấy/hơn mười|m
十几万两=mười mấy vạn lạng|m
十几丈=vài chục trượng|m
十几下=vài chục cái/mười mấy lần|m
十几两=mười mấy lượng|m
十几个=mười cái/mười mấy|m
十几亿=mười mấy ức|m
十几代=mười mấy đời|m
十几件=mười mấy món|m
十几位=hơn mười vị/mười mấy vị|m
十几倍=mười mấy lần|m
十几分=mười mấy phần/hơn mười phần/mười mấy phút/mười mấy điểm|m
十几分钟=mười mấy phút/hơn mười phút|m
十几只=mười mấy con/mười mấy cái|m
十几号=mười mấy/số mười mấy|m
十几名=hơn mười người|m
十几处=mười mấy nơi|m
十几天=hơn mười ngày/mười mấy ngày|m
十几头=mười mấy đầu/mười mấy con|m
十几岁=mười mấy tuổi|m
十几年=mười mấy năm|m
十几座=vài chục tòa|m
十几张=mười mấy tấm|m
十几批=mười mấy tốp|m
十几把=mười mấy thanh/vài chục thanh|m
十几日=mười mấy ngày|m
十几根=mười mấy cây|m
十几次=vài chục lần/mười mấy lần|m
十几步=vài chục bước/mười mấy bước|m
十几滴=hơn mười giọt/mười mấy giọt|m
十几种=mười mấy loại|m
十几米=mười mấy mét/hơn mười thước/mười mấy thước|m
十几载=mười mấy năm|m
十几遍=mười mấy lần|m
十几道=mười mấy đạo/hơn mười đạo|m
十几里=hơn mười dặm/mười mấy dặm|m
十几间=mười mấy gian|m
十分=mười phần/mười điểm/mười phút|m
十分之一=một phần mười|m
十分钟=mười phút đồng hồ/mười phút/10 phút|m
十列=mười hàng|m
十则=mười quy tắc|m
十副=mười bộ|m
十千=mười ngàn|m
十卷=mười quyển/10 quyển|m
十叁=mười ba|m
十双=mười đôi|m
十口=mười ngụm/mười thanh|m
十句=mười câu|m
十只=mười con/mười cái|m
十号=số mười/ngày 10|m
十名=mười tên/mười|m
十周年=mười năm tròn|m
十品=Thập phẩm|m
十四=mười bốn/14/mười bốn/thập tứ|m
十四五=mười bốn mười lăm/mười bốn, mười lăm|m
十四五岁=mười bốn mười lăm tuổi|m
十四分=mười bốn điểm|m
十四只=mười bốn con|m
十四号=số mười bốn/số 14|m
十四名=mười bốn người|m
十四块=mười bốn khối|m
十四天=mười bốn ngày|m
十四张=mười bốn tấm|m
十四把=mười bốn thanh|m
十四日=mười bốn ngày|m
十四次=mười bốn lần|m
十四载=mười bốn năm|m
十团=mười đám|m
十块=mười khối|m
十声=mười tiếng|m
十处=mười nơi|m
十多=hơn mười/hơn chục|m
十多万=hơn mười vạn|m
十多丈=hơn mười trượng|m
十多个=hơn mười|m
十多亿=hơn một tỷ|m
十多分钟=hơn mười phút|m
十多只=hơn mười cái|m
十多天=hơn mười ngày|m
十多年=hơn mười năm|m
十多日=hơn mười ngày|m
十多根=hơn mười cây|m
十多次=hơn mười lần|m
十多米=hơn mười mét/hơn 10m|m
十多遍=hơn mười lần|m
十多里=hơn mười dặm|m
十天=mười ngày|m
十头=mười đầu/mười con|m
十套=mười bộ|m
十寸=mười tấc|m
十尺=mười thước|m
十尾=mười đuôi|m
十层=mười tầng|m
十岁=mười tuổi|m
十干=thập can/thiên can|m
十年=mười năm|m
十座=mười toà/mười ngọn|m
十张=mười cái/mười tấm|m
十成=mười thành/mười phần|m
十批=mười tốp|m
十把=mười chuôi/mười thanh|m
十招=mười chiêu|m
十拳=mười quyền|m
十数=mười mấy/hơn mười|m
十数丈=hơn mười trượng|m
十数个=mười mấy|m
十数倍=mười mấy lần|m
十数只=mười mấy con|m
十数日=mười mấy ngày|m
十数米=mười mấy mét|m
十数里=hơn mười dặm|m
十方=thập phương/mười phương|m
十有八九=tám chín phần mười|m
十本=mười bản|m
十杆=mười cây|m
十束=Totsuka|m
十条=mười đầu/mười cái|m
十枚=mười cái/mười viên/mười mai/mười miếng|m
十架=mười chiếc|m
十株=mười cây|m
十根=mười cái|m
十次=mười lần|m
十滴=mười giọt|m
十点=mười điểm/mười giờ|m
十点钟=mười giờ|m
十片=mười mảnh|m
十瓶=mười bình|m
十百=hàng chục hàng trăm|m
十种=mười loại|m
十秒=mười giây/10 giây|m
十等=cấp 10/cấp mười|m
十箱=mười thùng|m
十米=mười mét/10m/mười thước|m
十粒=mười hạt|m
十级=mười cấp/cấp mười/thập cấp|m
十组=mười tổ|m
十绝阵=Thập Tuyệt Trận|m
十维=mười chiều|m
十股=mười cỗ|m
十艘=mười chiếc|m
十角=thập giác|m
十记=mười cái|m
十趟=mười chuyến|m
十载=mười năm|m
十辆=mười chiếc|m
十遍=mười lần|m
十道=mười đạo|m
十部=mười bộ|m
十里=mười dặm/mười dặm|m
十重=thập trọng/mười tầng|m
十门=mười môn|m
十集=10 tập|m
十顿=mười bữa|m
十颗=mười khỏa/mười viên|m
千万=ngàn vạn/nhất thiết/dù sao cũng/chục triệu|m
千万分之一=một phần ngàn vạn|m
千万千万=hàng vạn hàng nghìn|m
千万只=ngàn vạn cái/ngàn vạn con|m
千万年=ngàn vạn năm/thiên vạn năm|m
千万把=ngàn vạn thanh|m
千万次=ngàn vạn lần|m
千万种=ngàn vạn loại/thiên vạn loại|m
千万遍=ngàn vạn lần|m
千万里=ngàn vạn dặm|m
千万重=ngàn vạn trọng|m
千丈=ngàn trượng/nghìn trượng/ngàn trượng|m
千上万=trên vạn|m
千下=dưới ngàn/ngàn lần|m
千两=ngàn lượng/ngàn lạng|m
千亿=trăm tỷ/trăm tỉ|m
千代=Thiên Đại/ngàn đời|m
千件=ngàn cái|m
千伙=ngàn nhóm|m
千余=hơn ngàn/hơn ngàn|m
千余年=hơn nghìn năm/hơn ngàn năm|m
千余米=hơn nghìn thước|m
千余里=hơn nghìn dặm|m
千倍=nghìn lần|m
千儿=thiên nhi|m
千儿八百=xấp xỉ một nghìn/ngót một nghìn|m
千兆=triệu tỉ|m
千刀=ngàn đao/thiên đao|m
千分=ngàn phần|m
千分之一=một phần ngàn|m
千分尺=cái đo vi/trắc vi kế|m
千千=Thiên Thiên|m
千千万=ngàn ngàn vạn/thiên thiên vạn|m
千千万万=ngàn ngàn vạn vạn/thiên thiên vạn vạn|m
千口=ngàn ngụm/ngàn thanh|m
千只=ngàn con/ngàn cái|m
千叶=Thiên Diệp/Chiba|m
千号=số ngàn|m
千名=ngàn tên|m
千周=kJul|m
千团=ngàn đám|m
千块=ngàn khối|m
千堂=thiên đường|m
千处=ngàn nơi|m
千多=hơn ngàn|m
千多年=hơn nghìn năm|m
千天=ngàn ngày|m
千头=ngàn con|m
千套=ngàn bộ|m
千家=Thiên gia|m
千尺=ngàn thước/ngàn thước|m
千层=ngàn tầng|m
千岁=thiên tuế/ngàn tuổi/nghìn tuổi|m
千幅=ngàn bức|m
千年=ngàn năm/thiên niên/nghìn năm/thời gian dài/ngàn năm|m
千座=ngàn tòa/ngàn toà|m
千张=đậu phụ phơi khô/ngàn tấm|m
千户=Thiên hộ|m
千手=thiên thủ|m
千把=ngàn thanh|m
千数=hàng ngàn|m
千斤=ngàn cân/nghìn cân/trách nhiệm nặng nề/cái kích/con cá/cái đội|m
千日=ngàn ngày|m
千月=Thiên Nguyệt|m
千杆=ngàn cái|m
千条=ngàn đầu/thiên điều/ngàn sợi|m
千杯=ngàn chén|m
千枚=ngàn viên|m
千架=ngàn chiếc|m
千株=ngàn cây|m
千根=ngàn cái|m
千次=nghìn lần/ngàn lần|m
千滴=ngàn giọt/ngàn giọt|m
千片=ngàn mảnh|m
千瓦=kilowatt/ki-lô-oát/kilôoát|m
千瓶=ngàn bình|m
千百=trăm ngàn/trăm nghìn/thiên bách|m
千百万=trăm ngàn vạn|m
千百万只=trăm ngàn vạn con|m
千百万年=trăm ngàn vạn năm|m
千百倍=gấp trăm ngàn lần/trăm lần, ngàn lần|m
千百只=trăm ngàn con|m
千百回=trăm ngàn lần|m
千百年=trăm ngàn năm|m
千百度=thiên bách độ/100000000000000|m
千百次=trăm ngàn lần/trăm lần, ngàn lần|m
千百遍=trăm ngàn lần|m
千百道=trăm ngàn đạo|m
千百里=trăm ngàn dặm|m
千眼=thiên nhãn|m
千种=ngàn loại|m
千篇=thiên thiên|m
千粒=ngàn hạt|m
千系=Thiên hệ|m
千股=ngàn cỗ|m
千艘=ngàn chiếc|m
千载=ngàn năm/thiên tái/ngàn năm|m
千辆=ngàn chiếc|m
千遍=ngàn lần|m
千道=nghìn đạo|m
千部=ngàn bộ|m
千重=ngàn trọng/thiên trọng/ngàn tầng|m
千门=thiên môn|m
千阵=thiên trận|m
千零=ngàn lẻ|m
千面=thiên diện|m
千顷=trăm ngàn mẫu|m
千颗=ngàn khỏa/ngàn trái/quả/ngàn quả|m
千首=thiên thủ|m
卅七=ba mươi bảy|m
卅三=ba mươi ba|m
卅二=ba mươi hai|m
卅五=ba mươi lăm|m
卅六=ba mươi sáu|m
卅岁=ba mươi tuổi|m
半万=nửa vạn|m
半丈=nửa trượng|m
半下=nửa lần|m
半丝=nửa điểm/tí ti/chút xíu|m
半两=nửa lượng/nửa lạng|m
半个=nửa cái/nửa|m
半人半=nửa người nửa|m
半亿=nửa trăm triệu|m
半代=nửa đời|m
半件=nửa cái|m
半伏=nửa nằm|m
半伙=nửa nhóm|m
半倍=nửa lần|m
半公斤=nửa ký|m
半分=nửa phần|m
半分钟=nửa phút|m
半刻=nửa khắc|m
半千=nửa ngàn|m
半升=nửa lít|m
半卷=nửa cuốn|m
半口=nửa ngụm/nửa cái|m
半句=nửa câu|m
半只=nửa cái/nửa con|m
半号=số nửa|m
半名=nửa tên|m
半响=nửa ngày/một lúc lâu/hồi lâu|m
半圈=nửa vòng|m
半块=nửa khối|m
半声=nửa tiếng|m
半处=nửa nơi|m
半夜=nửa đêm/khuya khoắt/khuya/giữa đêm giữa hôm/đêm hôm|m
半大=choai choai/nhơ nhỡ/nhỡ|m
半天=nửa ngày/cả buổi/hồi lâu/buổi/lâu|m
半头=một nửa/phân nửa/nửa chừng/nửa đầu/bán cao/nửa con|m
半套=nửa bộ|m
半寸=nửa tấc|m
半尺=nửa thước/nửa xích|m
半层=nửa tầng|m
半岁=nửa tuổi|m
半幅=nửa bức|m
半年=nửa năm|m
半座=nửa toà|m
半开=nửa mở/mở phân nửa|m
半张=hé mở/nửa tấm|m
半成=nửa thành|m
半截=một nửa/nửa đoạn/nửa/nửa mẩu/phân nửa/dở chừng/nửa chừng|m
半批=nửa tốp|m
半把=nửa thanh|m
半抹=nửa vệt|m
半招=nửa chiêu|m
半数=một nửa/nửa số|m
半数左右=chừng nửa số|m
半斤=nửa cân|m
半晌=nửa ngày/sau nửa ngày/một lát/buổi/hồi lâu/mãi|m
半晌道=hồi lâu nói|m
半条=nửa cái|m
半杯=nửa chén|m
半枚=nửa viên|m
半架=nửa chiếc|m
半株=nửa cây|m
半根=nửa cái|m
半桶=nửa thùng|m
半次=nửa lần|m
半步=nửa bước|m
半段=nửa đoạn/một nửa đoạn|m
半滴=nửa giọt|m
半点=nửa điểm/một chút/chút xíu/mảy may/tí xíu|m
半点儿=nửa chút/nửa điểm|m
半点钟=nửa giờ|m
半片=nửa mảnh/chốc lát|m
半瓶=nửa bình|m
半百=năm mươi|m
半碗=nửa bát|m
半种=nửa loại|m
半米=nửa mét/nửa thước/nửa mét|m
半粒=nửa hạt|m
半组=nửa tổ|m
半群=nửa bầy|m
半股=nửa cỗ|m
半艘=nửa chiếc|m
半路=nửa đường/giữa đường/giữa chừng/dở chừng|m
半身=nửa người|m
半轮=nửa vòng|m
半载=nửa năm|m
半辆=nửa chiếc|m
半辈=nửa đời|m
半辈子=nửa đời người/nửa đời|m
半遍=nửa lần|m
半道=nửa đường|m
半部=nửa bộ|m
半里=nửa dặm/nửa dặm|m
半重=nửa trọng/nửa tầng|m
半页=nửa tờ|m
半颗=nửa viên|m
叁=tam|m
叁个=ba|m
叁十=ba mươi|m
叁天=ba ngày|m
叁次=ba lần|m
叁角=tam giác|m
双倍=gấp đôi/nhân đôi|m
双十=hai mươi/song thập/đôi mươi|m
双双=song song|m
双名=tên hai chữ|m
双声=song thanh/lặp lại âm đầu|m
双大眼=đôi mắt to|m
双座=hai chỗ ngồi|m
双开=song khai|m
双排=song bài|m
双日=ngày chẵn/hai mặt trời|m
双眼=hai mắt/cặp mắt|m
双股=hai đùi|m
双轮=song luân/hai bánh|m
双首=hai đầu|m
周岁=tuổi tròn|m
周遭=quanh mình/bốn bề/bốn phía/xung quanh|m
四万=bốn vạn|m
四万七千=bốn vạn bảy ngàn/47,000|m
四万两=bốn vạn lượng|m
四万余=hơn bốn vạn|m
四万多=hơn bốn vạn|m
四丈=bốn trượng|m
四下=bốn phía/mọi nơi|m
四下里=xung quanh/xung/chung quanh/khắp mọi nơi|m
四两=bốn lượng/bốn lạng|m
四个=bốn|m
四五=bốn năm/bốn, năm|m
四五万=bốn, năm vạn|m
四五丈=bốn năm trượng|m
四五个=bốn năm cái|m
四五代=bốn năm đời|m
四五倍=gấp bốn năm lần|m
四五分=bốn năm phần|m
四五分钟=bốn năm phút|m
四五十=bốn năm mươi/bốn mươi năm mươi|m
四五十只=bốn mươi, năm mươi con|m
四五十岁=bốn mươi năm mươi tuổi|m
四五十米=bốn năm mươi mét|m
四五十里=bốn mươi, năm mươi dặm|m
四五千=bốn năm ngàn/4000~5000/bốn, năm ngàn|m
四五千里=bốn, năm ngàn dặm|m
四五只=bốn năm con/bốn, năm con|m
四五天=bốn năm ngày|m
四五年=bốn năm năm|m
四五张=bốn, năm tấm|m
四五成=bốn, năm phần mười|m
四五根=bốn, năm cây|m
四五次=bốn năm lần/bốn, năm lần|m
四五步=bốn năm bước/bốn, năm bước|m
四五百=bốn năm trăm/bốn, năm trăm|m
四五百万=bốn năm trăm vạn/4,5 triệu|m
四五百里=bốn, năm trăm dặm|m
四五米=bốn năm mét/4-5m/4~5m/bốn, năm mét|m
四五遍=bốn, năm lần|m
四五里=bốn năm dặm/bốn, năm dặm|m
四人组=tổ bốn người|m
四亿=bốn trăm triệu/bốn ức/bốn trăm triệu|m
四亿五千万=450 triệu|m
四位=bốn vị/bốn chỗ|m
四余=hơn bốn|m
四倍=bốn lần/gấp bốn|m
四儿=Tứ nhi|m
四六=bốn sáu/bốn, sáu|m
四六分=chia 4:6|m
四六开=chia bốn sáu|m
四具=bốn cỗ|m
四出=tứ xuất|m
四分=bốn phần/bốn điểm/bốn phút|m
四分之三=ba phần tư|m
四列=bốn nhóm|m
四则=cộng trừ nhân chia/bốn phép tính|m
四副=bốn bức|m
四匹=bốn con|m
四十=bốn mươi/bốn mươi|m
四十一=bốn mươi mốt|m
四十七=bốn mươi bảy|m
四十七八岁=bốn mươi bảy bốn mươi tám|m
四十七名=bốn mươi bảy người|m
四十万=bốn mươi vạn|m
四十三=bốn mươi ba/43|m
四十三天=bốn mươi ba ngày|m
四十下=bốn mươi lần|m
四十两=bốn mươi lượng|m
四十个=bốn mươi|m
四十九=bốn mươi chín/49|m
四十九日=bốn mươi chín ngày|m
四十九里=bốn mươi chín dặm|m
四十二=bốn mươi hai|m
四十二章=Chương 42:|m
四十五=bốn mươi lăm|m
四十五两=bốn mươi lăm lượng|m
四十五亿=4,5 tỷ|m
四十五天=bốn mươi lăm ngày|m
四十五里=bốn mươi lăm dặm|m
四十亿=4 tỷ/bốn mươi tỷ/4 tỉ|m
四十余=hơn bốn mươi|m
四十余名=hơn bốn mươi tên/hơn bốn mươi người|m
四十余岁=hơn bốn mươi tuổi|m
四十余里=hơn bốn mươi dặm|m
四十八=bốn mươi tám|m
四十八岁=bốn mươi tám tuổi|m
四十八日=bốn mươi tám ngày|m
四十八里=bốn mươi tám dặm|m
四十公里=bốn mươi km|m
四十六=bốn mươi sáu|m
四十六日=bốn mươi sáu ngày|m
四十几岁=hơn bốn mươi tuổi|m
四十几年=bốn mươi mấy năm|m
四十出头=tuổi hơn bốn mươi/ngoài bốn mươi|m
四十分钟=40 phút/40'|m
四十名=bốn mươi tên|m
四十四=bốn mươi bốn|m
四十多=hơn bốn mươi|m
四十多万=hơn 40 vạn|m
四十多个=hơn bốn mươi|m
四十多天=hơn bốn mươi ngày/hơn 40 ngày|m
四十多岁=hơn bốn mươi tuổi/hơn 40 tuổi|m
四十多年=hơn bốn mươi năm|m
四十多米=hơn bốn mươi mét/hơn 40 mét|m
四十多里=hơn bốn mươi dặm|m
四十天=bốn mươi ngày/40 ngày|m
四十岁=bốn mươi tuổi|m
四十左右=chừng bốn mươi/khoảng bốn mươi|m
四十年=bốn mươi năm|m
四十张=bốn mươi tấm|m
四十日=bốn mươi ngày|m
四十米=bốn mươi mét/40m|m
四十里=bốn mươi dặm|m
四千=bốn ngàn/bốn ngàn|m
四千七百=bốn ngàn bảy trăm/4,700|m
四千万=bốn ngàn vạn/40 triệu/4000 vạn|m
四千两=bốn ngàn lượng|m
四千余=hơn bốn ngàn|m
四千八百=4,800|m
四千多=hơn bốn nghìn/hơn bốn ngàn|m
四千多年=hơn bốn nghìn năm/hơn bốn ngàn năm|m
四千里=bốn ngàn dặm/bốn nghìn dặm|m
四千零三十=4,030|m
四半=bốn mảnh|m
四卷=bốn quyển/quyển bốn|m
四口=bốn chiếc|m
四句=bốn câu|m
四只=bốn con/bốn cái/bốn con|m
四号=số 4/số bốn/số bốn|m
四名=bốn tên/bốn gã|m
四吨=4 tấn|m
四周=bốn phía/bốn tuần/chu vi|m
四周岁=tròn bốn tuổi/bốn tuần tuổi|m
四四=tứ tứ|m
四四方方=vuông vức/tứ tứ phương phương/bốn phía|m
四团=bốn đám|m
四圈=bốn vòng|m
四块=bốn khối|m
四声=bốn tiếng/tứ thanh/dấu giọng|m
四处=bốn phía/bốn chỗ/chung quanh/khắp nơi/xung quanh|m
四多=hơn bốn|m
四天=bốn ngày/bốn ngày|m
四头=bốn đầu/bốn con|m
四季=bốn mùa/tứ quý/bốn mùa|m
四宗=Tứ Tông|m
四家=bốn nhà/Tứ gia/tứ gia|m
四寸=bốn tấc/4 tấc|m
四少=Tứ thiếu/Tứ thiếu/tứ thiếu|m
四尺=bốn thước|m
四层=bốn tầng/tầng bốn/bốn tầng|m
四岁=bốn tuổi/bốn tuổi|m
四席=tứ tịch|m
四幅=bốn bức|m
四年=bốn năm/bốn năm|m
四座=bốn tòa/tứ tọa/bốn ghế|m
四成=bốn thành/bốn phần mười|m
四截=bốn đoạn|m
四手=bốn tay|m
四批=bốn tốp|m
四把=bốn thanh/bốn cái|m
四折=40%/giảm còn 40%/bốn chiết/bốn màn|m
四方=tứ phương/bốn phương/khắp nơi|m
四方八面=bốn phương tám hướng|m
四方步=bước chân thư thả/bước đi thanh thản/tứ phương bộ|m
四方脸=mặt vuông/mặt vuông chữ điền|m
四月=tháng tư/bốn tháng|m
四杆=bốn cây|m
四枚=bốn cái/bốn mai/bốn viên/bốn miếng|m
四架=bốn chiếc|m
四柱=tứ trụ|m
四株=bốn cây|m
四根=bốn cái|m
四桌=bốn bàn|m
四次=bốn lần/bốn lần|m
四步=bốn bước/tứ bộ|m
四段=bốn đoạn/tứ đoạn|m
四滴=bốn giọt|m
四点=bốn điểm/bốn giờ/4 h/bốn điểm : bốn giờ|m
四片=bốn mảnh|m
四班=bốn lớp/lớp bốn/tứ ban|m
四瓶=bốn bình|m
四番=Tứ phiên|m
四百=bốn trăm/400|m
四百万两=bốn trăm vạn lượng/bốn triệu lượng|m
四百三十万=bốn trăm ba mươi vạn/430 vạn|m
四百两=bốn trăm lượng|m
四百五十=bốn trăm năm mươi/450|m
四百余=hơn bốn trăm|m
四百余里=hơn bốn trăm dặm|m
四百八十=bốn trăm tám mươi/480|m
四百六十七=bốn trăm sáu mươi bảy/467|m
四百多=hơn bốn trăm/hơn 400|m
四百多年=hơn bốn trăm năm|m
四百多米=hơn bốn trăm mét|m
四百多里=hơn bốn trăm dặm|m
四百年=bốn trăm năm|m
四百米=bốn trăm mét/400m/400 mét|m
四百里=bốn trăm dặm/400 dặm|m
四眼=bốn mắt|m
四种=bốn loại/bốn loại|m
四秒=bốn giây|m
四章=bốn chương/chương bốn|m
四端=tứ đoan|m
四等=tứ đẳng|m
四米=bốn mét/bốn thước|m
四粒=bốn hạt|m
四级=cấp bốn/bốn cấp/tứ cấp|m
四线=tứ tuyến|m
四组=tổ bốn/bốn tổ|m
四维=bốn chiều/tứ duy|m
四群=bốn bầy|m
四股=bốn cỗ/bốn cổ|m
四艘=bốn chiếc|m
四角=bốn góc/tứ giác|m
四起=nổi lên bốn phía/bốn vụ|m
四轮=bốn vòng/bốn bánh/vòng bốn|m
四载=bốn năm|m
四辆=bốn chiếc|m
四遍=bốn lần|m
四道=bốn đạo|m
四重=tứ trọng/bốn tầng|m
四队=bốn đội/đội bốn|m
四颗=bốn khỏa/bốn viên|m
垧=thưởng|m
壬=nhâm|m
壬戌=nhâm tuất|m
壬辰=nhâm thìn|m
壹佰=một trăm|m
壹天=một ngày|m
多=đa|m
多一些=nhiều một chút/nhiều một ít|m
多一倍=nhiều gấp đôi|m
多一分=nhiều một phần/thêm một phần|m
多一分钟=thêm một phút|m
多一半=hơn/quá nửa/hơn nửa/phần đông/phần nhiều|m
多一点=nhiều một chút|m
多万=vạn hơn|m
多丈=hơn trượng|m
多个=nhiều cái/nhiều/phức tạp/thêm cái|m
多久=bao lâu|m
多亿=nhiều ức/nhiều tỷ/hơn trăm triệu|m
多代=nhiều đời|m
多会儿=khi nào/lúc nào/bao giờ|m
多余=dư thừa/dư/thừa/thừa thãi/không cần/không cần thiết|m
多倍=nhiều lần|m
多元=đa nguyên/nhiều thực thể|m
多几分=nhiều mấy phần|m
多出=thêm ra/nhiều ra/nhiều hơn|m
多分=đa phần/phân thêm/phần lớn|m
多则=nhiều thì/lâu thì|m
多十倍=nhiều gấp bội|m
多半=hơn phân nửa/phần lớn/quá nửa/phần nhiều/chắc là/có lẽ/hơn nửa|m
多半会=chắc chắn sẽ|m
多半天=hơn nửa ngày|m
多半截=phần lớn|m
多发=phát thêm/tỷ lệ phát sinh cao/thường xảy ra nhiều/phát hơn|m
多口=lắm lời|m
多只=nhiều con|m
多名=nhiều tên/hơn nhiều tên/hơn|m
多处=nhiều chỗ|m
多多=nhiều hơn/nhiều|m
多多少少=hoặc nhiều hoặc ít/đa đa thiểu thiểu/nhiều hoặc ít/ít nhiều gì/hoặc nhiều hoặc ít (*)|m
多天=nhiều ngày|m
多头=nhiều mặt/đầu tư cổ phiếu/nhiều phương diện|m
多好几倍=hơn gấp mấy lần|m
多子=Đa tử|m
多少=bao nhiêu/nhiều ít/bấy nhiêu|m
多少倍=gấp bao nhiêu lần/bao nhiêu lần|m
多岁=nhiều tuổi/hơn tuổi/tuổi|m
多峰=Đa Phong|m
多年=nhiều năm/nhiều/hơn năm|m
多支=nhiều chi|m
多数=đa số/số nhiều/phần đông/phần nhiều|m
多数倍=hơn mấy lần|m
多方=nhiều mặt/nhiều cách/cách/mọi cách|m
多方位=nhiều mặt/nhiều phương diện|m
多方面=nhiều phương diện/hướng/mọi mặt/mọi phương diện|m
多日=nhiều ngày/thời gian dài|m
多月=nhiều tháng|m
多条=mấy đầu/hơn|m
多根=nhiều cái|m
多次=nhiều lần|m
多派=phái thêm|m
多点=nhiều một chút/điểm hơn|m
多瓶=hơn bình|m
多种=nhiều loại|m
多种多样=nhiều mặt/đa dạng/nhiều kiểu nhiều loại|m
多端=đa dạng/đa đoan/nhiều chủng loại|m
多米=mét hơn|m
多系=đa hệ|m
多线=đa tuyến|m
多维=đa chiều/đa duy|m
多股=nhiều phần/nhiều|m
多遍=nhiều lần|m
多重=đa trọng/nhiều tầng/nặng hơn/nặng bao nhiêu|m
多门=nhiều môn|m
多面=nhiều mặt/đa diện|m
多页=nhiều trang giấy|m
多项=nhiều hạng/nhiều|m
大一岁=lớn hơn một tuổi|m
大三=năm thứ ba đại học/lớn ba/năm ba|m
大个儿=đại cá nhi|m
大个子=to con/đại cá tử/người cao to/người lực lưỡng/to/lớn|m
大串=chuỗi dài|m
大二=đại nhị/năm thứ hai đại học/năm hai|m
大元=Đại Nguyên|m
大千=đại thiên|m
大半=hơn phân nửa/hơn nửa/quá nửa/đại bộ phận/đa số/rất có thể/chắc là|m
大半个=hơn phân nửa/hơn nửa/hơn một nửa cái|m
大半截=hơn nửa đoạn|m
大半辈子=hơn nửa đời người|m
大卷=đại quyển|m
大名=đại danh/tên/nổi tiếng/tiếng tốt/tiếng tăm|m
大周天=đại chu thiên|m
大四=năm 4/năm thứ tư đại học|m
大堆=đống lớn|m
大声=lớn tiếng/cả tiếng|m
大多=phần lớn/đại thể/đại bộ phận/đa số/lớn hơn nhiều|m
大多数=đại đa số/đa số/phần lớn/số đông|m
大宗=đại tông/hàng loạt/số lượng lớn/khối lượng lớn/nhiều/hàng chủ lực/sản phẩm chính|m
大尺=xích lớn|m
大干=làm lớn|m
大干一场=làm một vố lớn|m
大年=tết/đại niên/được mùa/năm được mùa|m
大年三十=ba mươi tết/30 tết|m
大张=đại trương/mở lớn|m
大截=mảng lớn/đoạn lớn|m
大批=số lớn/rất nhiều/hàng loạt/số nhiều/khối lượng lớn/nhóm lớn|m
大批量=đại lượng|m
大把=bó lớn/rất nhiều/một số lớn/hàng loạt/lượng lớn|m
大捆=bó lớn|m
大月=tháng đủ|m
大桶=thùng lớn|m
大毫=đại hào|m
大溜=dòng nước xiết|m
大碗=chén lớn/tô|m
大笔=đại bút/tuyệt bút/số nhiều/đáng kể/bút lớn|m
大簇=đám lớn|m
大米=gạo/đại mễ|m
大肚量=đại độ lượng|m
大部份=phần lớn|m
大部分=đại bộ phận/phần lớn|m
大部头=tác phẩm vĩ đại/đại bộ đầu|m
大钟=chuông lớn|m
大阵=đại trận|m
好丑=xấu quá/tốt và xấu/tốt xấu/dù sao đi nữa/dù thế nào đi nữa/bất kể thế nào/thật là xấu xí|m
好个=khá lắm|m
好久=rất lâu/đã lâu/lâu/lâu lắm|m
好些=rất nhiều/khá hơn chút/nhiều/tốt hơn một chút|m
好几=mấy/nhiều/hơn/vài/ngoài|m
好几万=hết mấy vạn|m
好几丈=hơn mấy trượng/nhiều trượng|m
好几下=đến mấy lần|m
好几个=mấy cái/nhiều cái|m
好几代=mấy đời|m
好几件=mấy kiện|m
好几倍=gấp mấy lần|m
好几分钟=mấy phút|m
好几十=hơn mấy chục/đến mấy chục|m
好几十年=hơn mấy chục năm|m
好几十里=hơn mấy chục dặm|m
好几双=tận mấy đôi|m
好几只=mấy cái/mấy con|m
好几回=đến mấy lần|m
好几圈=mấy vòng/tầm vài vòng|m
好几年=nhiều năm/đã nhiều năm/tốt mấy năm/đến mấy năm|m
好几批=mấy nhóm|m
好几把=mấy lần/vài cái|m
好几日=mấy ngày/đã vài ngày|m
好几根=tận mấy cái|m
好几步=mấy bước/vào bước|m
好几番=mấy lần|m
好几百=hơn mấy trăm/mấy trăm|m
好几百米=hơn mấy trăm mét|m
好几种=mấy loại|m
好几米=đến mấy mét|m
好几趟=mấy chuyến|m
好几遍=nhiều lần|m
好几道=mấy đạo|m
好几里=mấy dặm|m
好几间=mấy gian|m
好句=câu hay|m
好处多多=rất nhiều chỗ tốt|m
好多=thật nhiều/tốt hơn nhiều/bao nhiêu/|m
好多个=thật nhiều cái|m
好多天=thật nhiều ngày|m
好多遍=rất nhiều lần|m
好把=tiện đem|m
好米=gạo tốt|m
好钟=chuông tốt|m
小俩口=cô dâu mới|m
小半截=gần nửa đoạn|m
少一=thiếu một|m
少些=ít hơn|m
少儿=thiếu nhi|m
少刻=chẳng mấy chốc/không bao lâu|m
少半=gần một nửa|m
少处=nơi vắng vẻ|m
少少=thiểu thiểu|m
少干=bớt làm/làm ít|m
少年=thiếu niên/niên thiếu/tuổi trẻ|m
少数=số ít/thiểu số|m
少数派=phe thiểu số|m
少许=một chút/ít/chút ít/không ít|m
少部=số ít|m
少部分=một số nhỏ/một số ít|m
少量=chút ít/chút đỉnh/số ít|m
少顷=chốc lát/ít khi/khoản khắc/giây lát/khoảnh khắc|m
层次=cấp độ/trình tự/có thứ tự/tầng/nấc/lớp/cấp/mức độ/trình độ/có lớp lang/cấp độ ̣/mức/tầng thứ|m
左下角=góc dưới bên trái/dưới góc trái|m
左半=nửa trái|m
左右=tả hữu/chi phối/khoảng chừng/trái phải|m
左右两个=hai cái trái phải|m
左右两手=hai tay trái phải|m
左右手=tay trái tay phải/trợ thủ đắc lực/phụ tá đắc lực/người giúp việc đắc lực/người tin cậy|m
左天=Tả Thiên|m
左家=Tả gia|m
左座=ghế trái|m
左手=tay trái/phía tay trái/phía bên trái/tả thủ|m
左拳=quyền trái|m
左排=dãy trái|m
左数=trái đếm|m
左方=bên trái/tả phương/phía bên trái|m
左日=tả nhật|m
左派=phái tả/cánh tả/phe tả|m
左眼=mắt trái/con mắt trái|m
左脸=má trái/mặt trái|m
左角=góc trái|m
左路=cánh trái/cánh tả|m
左轮=súng lục/súng ngắn ổ quay|m
左道=tả đạo/Tả Đạo/tà đạo|m
左首=tay trái/phía trái/phía tay trái/phía bên trái|m
己亥=Kỷ Hợi|m
庚午=canh ngọ|m
庚帖=thiếp canh|m
廿=nhập|m
廿八=hai mươi tám|m
廿六=ngày hai mươi sáu|m
廿四=hai mươi bốn|m
廿岁=hai mươi tuổi|m
很丑=rất xấu|m
很久很久=cực kỳ lâu|m
很具=rất có|m
很多=rất nhiều|m
很多很多=rất nhiều rất nhiều|m
很多根=rất nhiều cái|m
很多遍=rất nhiều lần|m
很少=rất ít|m
很群=bầy sói|m
戊戌=Mậu Tuất|m
戊戌年=năm Mậu Tuất|m
成倍=gấp đôi/trở nên gấp mấy lần/gấp mấy lần|m
捌=bát|m
数一=đếm một|m
数一数=đếm một chút|m
数一数二=số một số hai/hạng nhất hạng nhì|m
数万=mấy vạn/mấy vạn|m
数万只=mấy vạn con|m
数万年=vài vạn năm/mấy chục ngàn năm|m
数万里=mấy vạn dặm|m
数丈=mấy trượng|m
数下=mấy cái|m
数两=mấy lạng/mấy lạng|m
数个=mấy cái/mấy|m
数九=vào đông|m
数亩=vài mẫu/sổ mẫu|m
数亿=mấy trăm triệu/mấy ức/mấy tỷ|m
数倍=mấy lần/gấp mấy lần|m
数公里=mấy cây số|m
数出=đếm ra|m
数分=mấy phần|m
数分钟=mấy phút|m
数列=dãy số/mấy dãy/mấy hàng/vài hàng/mấy nhóm|m
数十=mấy chục/hơn mười|m
数十万=mấy chục vạn/mấy trăm ngàn|m
数十万年=mấy chục vạn năm/mấy trăm ngàn năm|m
数十万斤=mấy chục vạn cân|m
数十丈=mấy chục trượng|m
数十下=mấy chục lần|m
数十个=mấy chục cái/hơn mười người/mấy chục|m
数十亿=mấy tỉ|m
数十代=mấy chục đời|m
数十位=hơn mười vị|m
数十余=hơn mười|m
数十倍=mấy chục lần|m
数十具=mấy chục cỗ/mấy chục bộ|m
数十分钟=mấy chục phút|m
数十口=mấy chục cái|m
数十只=mấy chục con/mấy chục cái/mười mấy con|m
数十名=mười mấy tên|m
数十回=mấy chục hồi|m
数十天=mấy chục ngày|m
数十头=mấy chục con|m
数十对=mấy chục đôi|m
数十尊=mấy chục vị|m
数十层=mấy chục tầng|m
数十年=mấy chục năm|m
数十座=mấy chục toà|m
数十张=mấy chục tấm|m
数十把=mấy chục thanh|m
数十招=hơn mười chiêu|m
数十日=mấy chục ngày|m
数十根=mấy chục cây|m
数十次=mấy chục lần/mấy mươi lần|m
数十步=mấy chục bước|m
数十百=mấy chục mấy trăm|m
数十米=mấy chục mét/mấy chục thước|m
数十载=hơn mười năm/mấy chục năm|m
数十遍=vài chục lần/mấy chục lần|m
数十道=mấy chục đạo|m
数十遭=mấy chục lần|m
数十里=mấy chục dặm|m
数千=mấy ngàn/mấy nghìn/mấy ngàn|m
数千万=mấy ngàn vạn|m
数千丈=mấy ngàn trượng|m
数千两=mấy ngàn lượng|m
数千个=mấy ngàn|m
数千亿=mấy trăm tỷ|m
数千只=mấy ngàn con|m
数千头=mấy ngàn con|m
数千年=mấy ngàn năm/mấy nghìn năm|m
数千斤=mấy ngàn cân/mấy nghìn cân|m
数千根=mấy ngàn cây|m
数千米=mấy ngàn mét|m
数千里=mấy ngàn dặm|m
数半=mấy mảnh|m
数厘米=mấy centimet|m
数句=vài câu/mấy câu|m
数只=mấy cái/vài con/mấy con|m
数名=mấy tên/mấy/vài|m
数吨=mấy tấn|m
数周=mấy tuần|m
数圈=mấy vòng|m
数声=mấy tiếng|m
数处=vài chỗ/mấy chỗ/mấy nơi|m
数夜=mấy đêm|m
数天=mấy ngày|m
数套=mấy bộ|m
数寸=vài tấc/mấy tấc|m
数对=vài đôi|m
数尊=mấy tôn|m
数尺=vài thước|m
数岁=mấy tuổi|m
数干年=mấy ngàn năm|m
数年=mấy năm/năm đó|m
数座=vài tòa/mấy toà|m
数张=vài trương/mấy tấm|m
数成=mấy thành|m
数截=mấy khúc/mấy đoạn|m
数批=mấy nhóm/vài đoàn|m
数把=vài thanh/mấy thanh|m
数招=mấy chiêu|m
数排=mấy hàng|m
数支=mấy chi|m
数日=mấy ngày|m
数日里=trong mấy ngày|m
数月=mấy tháng/tháng đó,mấy tháng|m
数条=mấy cái/có vài|m
数杯=vài chén|m
数枚=mấy viên|m
数栋=mấy đống|m
数株=vài gốc/mấy cây|m
数根=mấy cây/vài gốc|m
数棵=vài cây|m
数次=mấy lần|m
数步=mấy bước|m
数滴=vài giọt/mấy giọt|m
数片=mấy mảnh|m
数番=mấy lần|m
数百=mấy trăm/mấy trăm|m
数百万=mấy trăm vạn/mấy triệu|m
数百丈=mấy trăm trượng|m
数百两=mấy trăm lượng|m
数百亿=mấy chục tỷ|m
数百份=mấy trăm phần|m
数百倍=gấp mấy trăm lần|m
数百只=mấy trăm con|m
数百名=mấy trăm tên|m
数百头=mấy trăm đầu/mấy trăm con|m
数百平方米=mấy trăm mét vuông|m
数百年=mấy trăm năm|m
数百张=mấy trăm tấm|m
数百条=mấy trăm đầu|m
数百枚=mấy trăm miếng/mấy trăm quả|m
数百根=mấy trăm cây|m
数百次=mấy trăm lần|m
数百米=vài trăm mét/vài trăm thước/mấy trăm mét|m
数百道=mấy trăm đạo|m
数百里=mấy trăm dặm|m
数盏=mấy chung|m
数着=đếm lấy/đếm/đếm lấy|m
数种=nhiều loại/mấy loại|m
数秒=mấy giây/mấy/vài giây|m
数章=số chương|m
数笔=mấy bút|m
数等=mấy cấp độ|m
数米=mấy mét/mấy thước|m
数股=vài luồng/mấy cỗ|m
数艘=mấy chiếc|m
数起=đếm lên/vài|m
数趟=mấy phen|m
数载=vài năm/sổ tái/mấy năm|m
数辆=mấy chiếc/số lượng|m
数遍=mấy lần/vài lần/tính khắp|m
数部=mấy bộ|m
数里=mấy dặm/vài dặm/|m
数页=vài tờ|m
数颗=mấy viên|m
整个儿=hết thảy|m
整個=cả|m
整双=cả đôi|m
整只=toàn bộ|m
整天=cả ngày|m
整幢=toàn bộ|m
整年=cả năm|m
整座=cả tòa|m
整把=cả thanh|m
整支=cả chi/cả nhánh|m
整月=cả tháng|m
整条=toàn bộ|m
整栋=cả tòa|m
整株=cả cây|m
整根=ngay ngắn/cả cây|m
整阵=chỉnh trận|m
整顿=chỉnh đốn/chấn chỉnh/sửa đổi|m
整颗=cả viên|m
无两=vô lượng|m
无二=không hai|m
无厘头=Vô Ly Đầu|m
无双=vô song/độc nhất vô nhị/có một không hai/Vô Song|m
无数=vô số/nhiều vô kể/rất nhiều/không biết đến nơi đến chốn/không biết chắc/không có dự tính trước|m
无数个=vô số|m
无数代=vô số đời|m
无数回=vô số hồi|m
无数条=vô số đầu/vô số điều|m
无数根=vô số cây|m
无数次=vô số lần|m
无数种=vô số loại|m
无数遍=vô số lần|m
无数颗=vô số viên|m
无米=không gạo|m
极右=cực hữu/bảo thủ cực đoan|m
极少数=cực thiểu số/số rất ít|m
极左派=cực tả phái|m
架次=lượt chiếc/lần chiếc|m
柒=thất|m
毫分=tí tẹo/tí/một tí/mảy may|m
毫子=hào|m
港元=Hồng Kông đô la|m
点点滴滴=từng li từng tí/từng ly từng tý|m
片儿=tấm ảnh/tấm hình/bức hoạ|m
片刻=một lát/chỉ chốc lát/khoảng khắc/phút chốc/chốc lát/giây phút|m
片刻之间=trong chốc lát|m
片刻间=trong chốc lát/chỉ khoảng nửa khắc|m
片名=tên phim|m
片响=giây lát|m
片天=vùng trời|m
片头=đầu phim/tiêu đề/lãnh đạo|m
片尾=cuối phim/đuôi phim/tín dụng kết thúc|m
片晌=một lát|m
片段=đoạn ngắn/mẩu/một đoạn/một nét/mẩu chuyện/phiến đoạn|m
片片=từng mảnh/từng mãnh/từng mảnh từng mảnh|m
片缕=sợi vải|m
玖=cửu|m
甲卯=Giáp Mão|m
甲申年=năm Giáp Thân/giáp Thân Niên|m
百万=trăm vạn/một triệu/cực nhiều/triệu|m
百万两=trăm vạn lượng|m
百万分之一=một phần một triệu|m
百万只=trăm vạn con|m
百万年=trăm vạn năm|m
百万斤=trăm vạn cân/triệu cân|m
百丈=trăm trượng|m
百下=một trăm lần|m
百两=trăm lượng/trăm lạng|m
百个=trăm cái/trăm|m
百五十=trăm năm mươi|m
百亿=chục tỷ/10 tỷ/mười tỉ|m
百件=trăm cái|m
百余=hơn trăm|m
百余丈=hơn trăm trượng|m
百余只=hơn trăm con/hơn trăm cái|m
百余年=hơn trăm năm|m
百余步=hơn trăm bước|m
百余米=hơn trăm mét/hơn trăm thước|m
百余里=hơn trăm dặm|m
百倍=gấp trăm lần/hết mình/hết sức|m
百儿八十=gần trăm/ngót nghét 100|m
百出=chồng chất/đầy rẫy/nhiều lần|m
百分=phần trăm/trăm phần|m
百分之一=một phần trăm/1%/bách phân chi nhất/một phần trăm của một đồng bạc|m
百分之一百=một trăm phần trăm|m
百分之一百二十=120%/một trăm hai mươi phần trăm|m
百分之七=7%/bảy phần trăm|m
百分之七八十=bảy tám mươi phần trăm/70-80%|m
百分之七十=bảy mươi phần trăm/70%|m
百分之七十五=75%/bảy mươi lăm phần trăm|m
百分之三=ba phần trăm/3%|m
百分之三十=ba mươi phần trăm/30%|m
百分之三十五=35%/ba mươi lăm phần trăm|m
百分之三十六=36%/ba mươi sáu phần trăm|m
百分之三四十=30-40%|m
百分之九=9%/chín phần trăm|m
百分之九十=chín mươi phần trăm/90%|m
百分之九十九=chín mươi chín phần trăm/99%|m
百分之九十五=95%/chín mươi lăm phần trăm|m
百分之九十八=chín mươi tám phần trăm/98%|m
百分之二=hai phần trăm/2%|m
百分之二三=2-3% /2-3%|m
百分之二十=hai mươi phần trăm/20%|m
百分之二十九=29%/hai mươi chín phần trăm|m
百分之二十二=22%|m
百分之二十五=hai mươi lăm phần trăm/25%|m
百分之二十几=hai mươi mấy phần trăm|m
百分之二百=hai trăm phần trăm/200%|m
百分之五=năm phần trăm/5%|m
百分之五十=năm mươi phần trăm/50%|m
百分之五十一=51%/năm mươi mốt phần trăm|m
百分之八=8%/tám phần trăm|m
百分之八九十=8-9-10%/8, 9, 10%|m
百分之八十=tám mươi phần trăm/80%|m
百分之八十五=85%/tám mươi lăm phần trăm|m
百分之六=6%/sáu phần trăm|m
百分之六七=6-7% /6-7%|m
百分之六十=sáu mươi phần trăm/60%|m
百分之六十五=65%/sáu mươi lăm phần trăm|m
百分之六十六=66%/sáu mươi sáu phần trăm|m
百分之几十=mấy chục phần trăm|m
百分之十=mười phần trăm/10%|m
百分之十一=11%/mười một phần trăm|m
百分之十七=17%/mười bảy phần trăm|m
百分之十三=13%/mười ba phần trăm|m
百分之十九=19%/mười chín phần trăm|m
百分之十二=12%/mười hai phần trăm|m
百分之十五=mười lăm phần trăm/15%|m
百分之十八=18%/mười tám phần trăm|m
百分之十六=16%/mười sáu phần trăm|m
百分之十四=mười bốn phần trăm/14%|m
百分之四=bốn phần trăm/4%|m
百分之四十=bốn mươi phần trăm/40%|m
百分之四十九=49%/bốn mươi chín phần trăm|m
百分之四十八=bốn mươi tám phần trăm/48%|m
百分之四十四=44%/bốn mươi bốn phần trăm|m
百分之百=trăm phần trăm/100%/toàn bộ/hoàn toàn/đầy đủ/chắc chắn/ăn chắc/chính cống/tuyệt đối/vô điều kiện|m
百分号=ký hiệu phần trăm/phần trăm|m
百分数=số phần trăm/số bách phân|m
百分点=phần trăm|m
百分百=trăm phần trăm|m
百副=trăm bộ|m
百十=trên dưới một trăm/gần một trăm/khoảng một trăm|m
百十年=trên dưới trăm năm|m
百十米=trên dưới một trăm mét/100 mét|m
百十里=gần trăm dặm|m
百千=hàng trăm/trăm ngàn/cực kỳ nhiều/trăm ngàn|m
百升=trăm lít|m
百只=trăm con|m
百名=trăm tên|m
百块=một trăm khối|m
百处=trăm chỗ/bách xử/một trăm nơi|m
百多=hơn trăm|m
百多年=hơn trăm năm|m
百多米=hơn trăm mét|m
百夜=bách dạ/Hyakuya|m
百天=trăm ngày/100 ngày|m
百套=trăm bộ|m
百家=bách gia/nhiều gia đình/nhiều dân tộc/đủ loại trào lưu học thuật/nhiều trường phái/trăm nhà|m
百寸=100 tấc|m
百尊=trăm vị|m
百尺=trăm thước|m
百岁=trăm tuổi|m
百帮=Bách bang|m
百幕=Bách Mộ|m
百平方米=100 mét vuông|m
百年=trăm năm/bách niên/nhiều năm/lâu năm/suốt đời/cả đời/trăm tuổi|m
百座=trăm tòa/trăm toà|m
百张=trăm tờ|m
百把=trăm thanh|m
百折=bách chiết|m
百招=trăm chiêu|m
百支=trăm chiếc|m
百斤=trăm cân|m
百日=trăm ngày|m
百月=bách nguyệt/trăm tháng|m
百条=trăm đầu/trăm cái|m
百枚=trăm viên|m
百枝=trăm nhánh|m
百架=trăm chiếc|m
百株=trăm cây|m
百根=một trăm cái|m
百次=trăm lần|m
百氏=trăm họ|m
百滴=trăm giọt|m
百片=trăm tấm|m
百瓶=trăm bình|m
百眼=trăm mắt|m
百种=trăm loại|m
百米=trăm mét/trăm mét|m
百粒=một trăm hạt|m
百群=một trăm bầy|m
百股=một trăm cỗ|m
百艘=một trăm chiếc|m
百载=trăm năm/bách tái|m
百辆=trăm chiếc|m
百部=một trăm bộ|m
百里=trăm dặm/trăm dặm|m
百零=bách linh|m
百零一=trăm lẻ một|m
百零八=trăm lẻ tám/108|m
百颗=trăm khỏa/trăm viên|m
第一=thứ nhất/đệ nhất/đầu tiên/hạng nhất/bậc nhất/quan trọng nhất|m
第一个=cái thứ nhất/người thứ nhất/thứ nhất|m
第一二=thứ nhất thứ hai|m
第一代=đời thứ nhất|m
第一件=kiện thứ nhất/đệ nhất kiện/cái thứ nhất|m
第一任=đời thứ nhất/đệ nhất nhiệm/đệ nhất đảm nhận/người đầu tiên nhận chức|m
第一份=phần thứ nhất|m
第一位=vị thứ nhất/người thứ nhất|m
第一例=ví dụ đầu tiên/hạng nhứt|m
第一具=cỗ thứ nhất|m
第一册=sách thứ nhất|m
第一刀=đệ nhất đao/đao thứ nhất|m
第一分钟=phút thứ nhất|m
第一千=thứ một ngàn|m
第一卷=quyển thứ nhất/Quyển thứ nhất/quyển thứ nhất|m
第一口=cái thứ nhất|m
第一句=câu đầu tiên/câu thứ nhất|m
第一台=đài thứ nhất/bộ thứ nhất|m
第一名=thứ nhất/hạng nhất/tên thứ nhất/đệ nhất danh|m
第一回=lần thứ nhất/đệ nhất hồi/hồi thứ nhất|m
第一团=đoàn thứ nhất/đệ nhất đám|m
第一圈=vòng thứ nhất/vòng thứ nhất|m
第一场=trận đầu|m
第一块=khối thứ nhất|m
第一声=tiếng thứ nhất|m
第一处=chỗ thứ nhất|m
第一夜=đêm thứ nhất/đêm đầu tiên|m
第一天=ngày đầu tiên/ngày thứ nhất|m
第一套=bộ thứ nhất|m
第一家=nhà thứ nhất/đệ nhất gia|m
第一尊=tôn thứ nhất/vị thứ nhất|m
第一局=ván đầu tiên|m
第一层=tầng thứ nhất|m
第一届=giới thứ nhất/lần thứ nhất|m
第一峰=đệ nhất phong|m
第一幅=bức thứ nhất|m
第一年=năm thứ nhất|m
第一座=tòa thứ nhất|m
第一张=tờ thứ nhất|m
第一手=trực tiếp/mắt thấy tai nghe|m
第一批=nhóm đầu tiên/đệ nhất phê/món thứ nhất|m
第一把=thanh thứ nhất|m
第一把手=nhân vật số một/người cầm đầu/quan chức chịu trách nhiệm cao nhất|m
第一招=chiêu thứ nhất|m
第一拳=quyền thứ nhất|m
第一排=hàng thứ nhất|m
第一支=chi thứ nhất|m
第一期=kỳ thứ nhất|m
第一条=đầu thứ nhất/điều thứ nhất|m
第一杯=chén thứ nhất|m
第一枚=cái thứ nhất/đệ nhất mai/quả thứ nhất|m
第一枪=thương thứ nhất/phát súng đầu tiên|m
第一架=chiếc thứ nhất|m
第一根=cái thứ nhất/đệ nhất cây|m
第一桌=bàn thứ nhất|m
第一桶=thùng thứ nhất|m
第一次=lần thứ nhất/lần đầu tiên|m
第一步=bước đầu tiên/bước thứ nhất|m
第一段=đoạn thứ nhất|m
第一点=điểm thứ nhất|m
第一片=mảnh thứ nhất|m
第一百=thứ một trăm/một trăm|m
第一百个=cái thứ một trăm|m
第一百张=tấm thứ 100|m
第一眼=cái đầu tiên/lần đầu tiên/đầu tiên mắt/đầu tiên nhìn|m
第一碗=chén thứ nhất|m
第一种=loại thứ nhất|m
第一站=trạm thứ nhất|m
第一章=chương thứ nhất|m
第一第二=đệ nhất đệ nhị|m
第一等=đệ nhất đẳng|m
第一篇=thiên thứ nhất/phần đầu tiên|m
第一类=loại thứ nhất|m
第一级=bậc thứ nhất/đệ nhất cấp|m
第一线=tuyến đầu/tuyến đầu tiên|m
第一组=tổ thứ nhất/tổ 1|m
第一缕=luồng thứ nhất|m
第一股=cỗ thứ nhất/cổ thứ nhất|m
第一艘=chiếc thứ nhất|m
第一节=tiết thứ nhất/tiết 1:|m
第一茬=lứa thứ nhất/gốc thứ nhất|m
第一行=hàng ngũ nhứ nhất|m
第一记=đòn thứ nhất|m
第一趟=chuyến thứ nhất|m
第一轮=vòng thứ nhất|m
第一辆=chiếc thứ nhất|m
第一遍=lần thứ nhất|m
第一道=đạo thứ nhất|m
第一遭=lần đầu tiên|m
第一部=bộ thứ nhất/đệ nhất bộ|m
第一重=đệ nhất trọng/tầng thứ nhất|m
第一门=đệ nhất môn/môn thứ nhất|m
第一队=đội thứ nhất|m
第一阵=trận thứ nhất|m
第一集=Tập 1-|m
第一面=lần đầu tiên|m
第一页=tờ thứ nhất/trang thứ nhất|m
第一项=hạng thứ nhất|m
第一顿=bữa thứ nhất|m
第一颗=viên thứ nhất|m
第一首歌=ca khúc thứ nhất|m
第七=thứ bảy/đệ thất|m
第七个=cái thứ bảy|m
第七代=đời thứ bảy|m
第七任=đệ thất nhậm|m
第七位=vị thứ bảy/người thứ bảy|m
第七十=thứ bảy mươi|m
第七十一=thứ bảy mươi mốt|m
第七十一回=hồi thứ bảy mươi mốt|m
第七十七=thứ bảy mươi bảy|m
第七十三=thứ bảy mươi ba|m
第七十三回=hồi thứ bảy mươi ba|m
第七十九=thứ bảy mươi chín|m
第七十二回=hồi thứ bảy mươi hai|m
第七十四=thứ bảy mươi bốn|m
第七十回=hồi thứ bảy mươi|m
第七十章=Chương 70:|m
第七卷=quyển thứ bảy:/quyển thứ bảy/Quyển 7:|m
第七号=thứ bảy|m
第七名=hạng bảy/đệ thất danh/người thứ bảy|m
第七品=đệ thất phẩm/cấp thứ bảy|m
第七回=hồi 7|m
第七场=trận thứ bảy/tràng thứ bảy|m
第七天=ngày thứ bảy|m
第七家=nhà thứ bảy|m
第七封=Đệ Thất Phong|m
第七层=tầng thứ bảy|m
第七年=năm thứ bảy|m
第七把=thanh thứ bảy|m
第七招=chiêu thứ bảy|m
第七日=ngày thứ bảy|m
第七根=đệ thất cây/cây thứ bảy|m
第七次=lần thứ bảy|m
第七步=bước thứ bảy|m
第七章=chương 7:/chương thứ bảy|m
第七篇=thiên thứ bảy|m
第七级=cấp thứ bảy/cấp 7|m
第七节=tiết 7:|m
第七轮=vòng thứ bảy|m
第七道=đạo thứ bảy/đệ thất đạo|m
第七部=bộ thứ bảy|m
第七集=tập 7|m
第七项=hạng thứ bảy|m
第三=thứ ba/đệ tam|m
第三个=cái thứ ba/người thứ ba|m
第三代=đời thứ ba|m
第三任=đời thứ ba|m
第三位=vị thứ ba/người thứ ba|m
第三具=bộ thứ ba|m
第三刀=đao thứ ba|m
第三十=thứ ba mươi|m
第三十一=thứ ba mươi mốt|m
第三十一章=Chương 31:|m
第三十七=thứ ba mươi bảy|m
第三十七章=Chương 37:|m
第三十三=thứ ba mươi ba/thứ 33|m
第三十三章=Chương 33:|m
第三十九=thứ ba mươi chín|m
第三十九章=Chương 39:|m
第三十二=thứ ba mươi hai|m
第三十二代=đời thứ ba mươi hai|m
第三十二章=Chương 32:|m
第三十五=thứ ba mươi lăm|m
第三十五章=Chương 35:|m
第三十八=thứ ba mươi tám|m
第三十八章=Chương 38:|m
第三十六=thứ ba mươi sáu|m
第三十六章=Chương 36:|m
第三十四=thứ ba mươi bốn|m
第三十四章=Chương 34:|m
第三十次=lần thứ ba mươi|m
第三十章=Chương 30:|m
第三卷=quyển thứ ba/Quyển 3:|m
第三口=cái thứ ba|m
第三句=câu thứ ba|m
第三只=cái thứ ba/con thứ ba|m
第三号=thứ ba|m
第三名=thứ ba/tên thứ ba|m
第三周=tuần thứ ba|m
第三品=đệ tam phẩm|m
第三四位=người thứ ba, bốn|m
第三回=hồi 3/hồi thứ ba|m
第三团=đoàn thứ ba|m
第三圈=vòng thứ ba|m
第三场=trận thứ ba|m
第三块=khối thứ ba|m
第三声=tiếng thứ ba|m
第三天=ngày thứ ba|m
第三家=nhà thứ ba|m
第三尊=vị thứ ba|m
第三局=ván thứ ba|m
第三层=tầng thứ ba|m
第三届=giới thứ ba/lần thứ ba|m
第三幅=bức thứ ba|m
第三年=năm thứ ba|m
第三度=lần thứ ba|m
第三座=tòa thứ ba|m
第三张=tấm thứ ba|m
第三批=nhóm thứ ba|m
第三把手=cánh tay thứ ba|m
第三招=chiêu thứ ba/đệ tam chiêu|m
第三拳=quyền thứ ba|m
第三排=hàng thứ ba|m
第三方=phe thứ ba/kẻ thứ ba|m
第三日=ngày thứ ba|m
第三期=kỳ thứ ba/đội ba|m
第三本=cuốn thứ ba|m
第三条=đầu thứ ba/điều thứ ba|m
第三杯=chén thứ ba|m
第三枚=viên thứ ba/cái thứ ba|m
第三样=dạng thứ ba|m
第三根=cái thứ ba/đệ tam cây/cây thứ ba|m
第三次=lần thứ ba|m
第三步=bước thứ ba|m
第三段=đoạn thứ ba|m
第三点=điểm thứ ba|m
第三番=phen thứ ba|m
第三眼=mắt thứ ba|m
第三碗=chén thứ ba|m
第三种=loại thứ ba|m
第三章=chương thứ ba|m
第三篇=thiên thứ ba/đệ tam thiên/trang thứ ba|m
第三级=cấp thứ ba|m
第三组=tổ thứ ba/tổ 3|m
第三股=cỗ thứ ba/cổ thứ ba|m
第三节=tiết thứ ba/tiết 3:/tiết 3|m
第三行=hàng thứ ba|m
第三轮=vòng thứ ba|m
第三遍=lần thứ ba|m
第三道=đạo thứ ba|m
第三部=bộ 3|m
第三重=đệ tam trọng/tầng thứ ba|m
第三间=căn thứ ba|m
第三队=đội thứ ba|m
第三集=tập 3/tập thứ ba|m
第三页=trang thứ ba|m
第三项=hạng thứ ba|m
第三颗=viên thứ ba|m
第九=thứ chín/đệ cửu|m
第九个=thứ chín|m
第九代=đời thứ chín|m
第九位=vị thứ chín/đệ cửu vị/người thứ chín|m
第九十=thứ chín mươi|m
第九十七=thứ chín mươi bảy|m
第九十九=thứ chín mươi chín|m
第九十二=thứ chín mươi hai|m
第九十六=thứ chín mươi sáu|m
第九卷=quyển thứ chín|m
第九号=thứ chín|m
第九名=hạng chín/tên thứ chín/người thứ chín|m
第九品=đệ cửu phẩm|m
第九回=hồi 9|m
第九天=ngày thứ chín|m
第九层=tầng thứ chín/tầng thứ 9|m
第九年=năm thứ chín|m
第九招=chiêu thứ chín|m
第九日=ngày thứ chín|m
第九条=đầu thứ chín/điều thứ chín|m
第九次=lần thứ chín|m
第九步=bước thứ chín|m
第九章=Chương 09:|m
第九篇=Quyển 9:|m
第九节=tiết 9:|m
第九重=đệ cửu trọng/tầng thứ chín|m
第九集=tập 9|m
第二=thứ hai/đệ nhị|m
第二个=cái thứ hai/người thứ hai/thứ hai|m
第二代=đời thứ hai|m
第二件=kiện thứ hai/đệ nhị kiện/cái thứ hai|m
第二任=đời thứ hai|m
第二份=phần thứ hai|m
第二位=vị thứ hai/người thứ hai|m
第二刀=đao thứ hai|m
第二分=phần thứ hai|m
第二列=đoàn thứ hai|m
第二则=cái thứ hai|m
第二副=bản thứ hai|m
第二十=thứ hai mươi|m
第二十一=thứ hai mươi mốt|m
第二十一回=hồi 21|m
第二十一次=lần thứ hai mươi mốt|m
第二十一章=Chương 21:|m
第二十七=thứ hai mươi bảy/thứ 27|m
第二十七章=Chương 27:|m
第二十三=thứ hai mươi ba|m
第二十三回=hồi 23|m
第二十三章=Chương 23:|m
第二十九=thứ hai mươi chín|m
第二十九章=Chương 29:|m
第二十二=thứ hai mươi hai|m
第二十二位=người thứ hai mươi hai|m
第二十二回=hồi 22|m
第二十二次=lần thứ hai mươi hai|m
第二十二章=Chương 22:|m
第二十五=thứ hai mươi lăm/đệ nhị thập ngũ|m
第二十五章=Chương 25:|m
第二十位=người thứ hai mươi|m
第二十八=thứ hai mươi tám|m
第二十八章=Chương 28:|m
第二十六=thứ 26/thứ hai mươi sáu|m
第二十六章=Chương 26:|m
第二十四=thứ hai mươi bốn/hai mươi bốn|m
第二十四卷=quyển thứ hai mươi bốn|m
第二十四章=Chương 24:|m
第二十四集=tập thứ 24|m
第二十回=hồi 20|m
第二十次=lần thứ hai mươi|m
第二十章=Chương 20:|m
第二卷=quyển thứ hai/Quyển 2:|m
第二口=chiếc thứ hai|m
第二句=câu thứ hai|m
第二只=cái thứ hai/con thứ hai|m
第二号=thứ hai|m
第二名=thứ hai/tên thứ hai|m
第二回=lần thứ hai/hồi 2|m
第二圈=vòng thứ hai|m
第二场=trận thứ hai|m
第二块=khối thứ hai|m
第二声=tiếng thứ hai|m
第二处=chỗ thứ hai|m
第二夜=đêm thứ hai|m
第二天=ngày thứ hai/ngày hôm sau|m
第二家=nhà thứ hai|m
第二局=ván thứ hai|m
第二层=tầng thứ hai|m
第二届=giới thứ hai|m
第二幅=bức thứ hai|m
第二年=năm thứ hai|m
第二座=tòa thứ hai|m
第二张=tấm thứ hai/tờ thứ hai|m
第二手=cũ/gián tiếp/trung gian/thứ yếu|m
第二批=nhóm thứ hai|m
第二把=thanh thứ hai|m
第二把手=người đứng thứ hai/người về thứ hai|m
第二招=chiêu thứ hai|m
第二拳=quyền thứ hai|m
第二排=hàng thứ hai|m
第二日=ngày thứ hai|m
第二期=kỳ thứ hai|m
第二本=cuốn thứ hai|m
第二条=đầu thứ hai/điều thứ hai|m
第二杯=chén thứ hai|m
第二枚=viên thứ hai/cái thứ hai|m
第二枪=phát súng thứ hai/thương thứ hai|m
第二架=chiếc thứ hai|m
第二根=cái thứ hai/đệ nhị cây|m
第二次=lần thứ hai|m
第二步=bước thứ hai/bước thứ hai|m
第二段=đoạn thứ hai|m
第二点=điểm thứ hai|m
第二片=mảnh thứ hai|m
第二百=thứ hai trăm|m
第二盘=bàn thứ hai|m
第二眼=nhìn lần thứ hai/cái nhìn thứ hai|m
第二碗=chén thứ hai|m
第二种=loại thứ hai|m
第二站=trạm thứ hai|m
第二章=Chương 02:|m
第二第三=thứ hai thứ ba|m
第二篇=thiên thứ hai/phần thứ hai|m
第二类=loại thứ hai|m
第二级=cấp thứ hai|m
第二组=tổ thứ hai/tổ 2|m
第二股=cỗ thứ hai/cổ thứ hai|m
第二节=tiết thứ hai|m
第二行=hàng thứ hai|m
第二记=đòn thứ hai|m
第二趟=chuyến thứ hai|m
第二轮=vòng thứ hai/đợt thứ hai|m
第二辆=chiếc thứ hai|m
第二遍=lần thứ hai|m
第二道=đạo thứ hai|m
第二部=bộ 2|m
第二重=đệ nhị trọng/tầng thứ hai|m
第二间=căn thứ hai|m
第二队=đội thứ hai|m
第二阵=trận thứ hai|m
第二集=tập 2/tập thứ hai|m
第二面=mặt thứ hai/mặt thứ hai|m
第二页=trang thứ hai/tờ thứ hai|m
第二项=hạng thứ hai|m
第二颗=viên thứ hai|m
第五=thứ năm/đệ ngũ|m
第五个=cái thứ năm/thứ năm|m
第五代=đời thứ năm|m
第五任=đời thứ năm|m
第五位=vị thứ năm/người thứ năm|m
第五十=thứ năm mươi|m
第五十一=thứ năm mươi mốt|m
第五十一回=hồi thứ năm mươi mốt|m
第五十一章=Chương 51:|m
第五十七=thứ năm mươi bảy|m
第五十七回=hồi thứ năm mươi bảy|m
第五十七章=Chương 57:|m
第五十三=thứ năm mươi ba|m
第五十三回=hồi thứ năm mươi ba|m
第五十三章=Chương 53:|m
第五十九=thứ năm mươi chín|m
第五十九回=hồi thứ năm mươi chín|m
第五十九章=Chương 59:|m
第五十二=thứ năm mươi hai|m
第五十二回=hồi thứ năm mươi hai|m
第五十二章=Chương 52:|m
第五十五=thứ năm mươi lăm|m
第五十五回=hồi thứ năm mươi lăm|m
第五十五章=Chương 55:|m
第五十八=thứ năm mươi tám|m
第五十八回=hồi thứ năm mươi tám|m
第五十八章=Chương 58:|m
第五十六=thứ năm mươi sáu|m
第五十六回=hồi thứ năm mươi sáu|m
第五十六章=Chương 56:|m
第五十四=thứ năm mươi bốn|m
第五十四回=hồi thứ năm mươi bốn|m
第五十四章=Chương 54:|m
第五十回=hồi thứ năm mươi|m
第五十日=ngày thứ năm mươi|m
第五十章=Chương 50:|m
第五卷=quyển thứ năm|m
第五号=thứ năm|m
第五名=hạng năm/tên thứ năm/người thứ năm|m
第五回=hồi 5|m
第五场=trận thứ năm|m
第五块=khối thứ năm|m
第五天=ngày thứ năm|m
第五层=tầng thứ năm|m
第五年=năm thứ năm|m
第五批=nhóm thứ năm|m
第五招=chiêu thứ năm|m
第五日=ngày thứ năm|m
第五条=đầu thứ năm/điều thứ năm|m
第五枚=cái thứ năm|m
第五根=cây thứ năm/đệ ngũ cây/cái thứ năm|m
第五次=lần thứ năm|m
第五步=bước thứ năm|m
第五种=loại thứ năm|m
第五章=Chương 05:|m
第五等=đệ ngũ đẳng|m
第五篇=thiên thứ năm|m
第五组=tổ thứ năm/tổ 5|m
第五节=tiết thứ năm|m
第五轮=vòng thứ năm|m
第五遍=lần thứ năm|m
第五道=đạo thứ năm/đệ ngũ đạo|m
第五部=bộ thứ năm|m
第五重=đệ ngũ trọng/tầng thứ năm|m
第五集=tập 5|m
第五项=hạng thứ năm|m
第八=thứ tám|m
第八个=cái thứ tám|m
第八代=đời thứ tám|m
第八位=vị trí thứ tám/người thứ tám|m
第八十=thứ tám mươi|m
第八十七=thứ tám mươi bảy|m
第八十三=thứ tám mươi ba|m
第八十九=thứ tám mươi chín|m
第八十八=thứ tám mươi tám|m
第八卷=Quyển 8:|m
第八号=thứ tám|m
第八名=hạng tám/tên thứ tám/người thứ tám|m
第八品=đệ bát phẩm|m
第八回=hồi 8|m
第八天=ngày thứ tám|m
第八层=tầng thứ tám/tầng thứ 8|m
第八年=năm thứ tám|m
第八把=thanh thứ tám|m
第八招=chiêu thứ tám|m
第八日=ngày thứ chín/ngày thứ tám|m
第八条=đầu thứ tám|m
第八次=lần thứ tám|m
第八步=bước thứ tám|m
第八章=Chương 08:|m
第八篇=thiên thứ tám|m
第八节=tiết 8:|m
第八轮=vòng thứ tám|m
第八道=đạo thứ tám/đệ bát đạo|m
第八集=Tập 8/tập thứ tám|m
第六=thứ sáu|m
第六个=cái thứ sáu/thứ sáu|m
第六代=đời thứ sáu|m
第六位=vị thứ sáu/người thứ sáu|m
第六十=thứ sáu mươi|m
第六十一=thứ sáu mươi mốt|m
第六十一回=hồi thứ sáu mươi mốt|m
第六十一章=Chương 61:|m
第六十七回=hồi thứ sáu mươi bảy|m
第六十七章=Chương 67:|m
第六十三=thứ sáu mươi ba|m
第六十三回=hồi thứ sáu mươi ba|m
第六十三章=Chương 63:|m
第六十九=thứ sáu mươi chín|m
第六十九章=Chương 69:|m
第六十二=thứ sáu mươi hai|m
第六十二回=hồi thứ sáu mươi hai|m
第六十二章=Chương 62:|m
第六十五=thứ sáu mươi lăm|m
第六十五回=hồi thứ sáu mươi lăm|m
第六十五章=Chương 65:|m
第六十六=thứ sáu mươi sáu|m
第六十六回=hồi thứ sáu mươi sáu|m
第六十六章=Chương 66:|m
第六十四=thứ sáu mươi bốn|m
第六十四回=hồi sáu mươi bốn|m
第六十四章=Chương 64:|m
第六十回=hồi thứ sáu mươi|m
第六十章=Chương 60:|m
第六卷=quyển thứ sáu/quyển 6 :|m
第六号=thứ sáu|m
第六名=hạng sáu/tên thứ sáu/người thứ sáu|m
第六品=đệ lục phẩm|m
第六回=hồi 6|m
第六块=khối thứ sáu|m
第六天=ngày thứ sáu/đệ lục thiên|m
第六层=tầng thứ sáu|m
第六年=năm thứ sáu|m
第六批=nhóm thứ sáu|m
第六招=chiêu thứ sáu|m
第六日=ngày thứ sáu|m
第六根=cây thứ sáu/đệ lục cây|m
第六次=lần thứ sáu|m
第六步=bước thứ sáu|m
第六种=loại thứ sáu|m
第六章=Chương 06:|m
第六篇=thiên thứ sáu/đệ lục thiên|m
第六节=tiết thứ sáu|m
第六轮=vòng thứ sáu|m
第六道=đạo thứ sáu/đệ lục đạo|m
第六部=bộ thứ sáu|m
第六集=tập 6|m
第六项=hạng thứ sáu|m
第几=thứ mấy/đệ mấy|m
第几个=cái thứ mấy|m
第几代=đời thứ mấy|m
第几名=tên thứ mấy|m
第几天=ngày thứ mấy|m
第几层=tầng thứ mấy|m
第几条=đầu thứ mấy|m
第几次=lần thứ mấy|m
第几百次=lần thứ mấy trăm|m
第几轮=vòng thứ mấy|m
第十=thứ mười/đệ thập|m
第十一=thứ mười một/đệ thập nhất|m
第十一位=người thứ mười một|m
第十一卷=Quyển 11:/quyển thứ mười một|m
第十一名=tên thứ mười một/người thứ mười một|m
第十一回=hồi 11|m
第十一天=ngày thứ mười một|m
第十一层=tầng thứ mười một|m
第十一招=chiêu thứ mười một|m
第十一次=lần thứ mười một|m
第十一章=Chương 11:|m
第十一篇=Quyển 11:|m
第十七=thứ mười bảy|m
第十七回=hồi 17|m
第十七次=lần thứ mười bảy|m
第十七章=Chương 17:|m
第十三=thứ mười ba|m
第十三代=đời thứ mười ba|m
第十三位=vị thứ mười ba|m
第十三分钟=phút thứ mười ba|m
第十三卷=quyển 13|m
第十三名=tên thứ mười ba/người thứ mười ba|m
第十三回=hồi 13|m
第十三天=ngày thứ mười ba|m
第十三层=tầng thứ mười ba|m
第十三招=chiêu thứ mười ba|m
第十三次=lần thứ mười ba|m
第十三章=Chương 13:|m
第十个=cái thứ mười/cái(người) thứ mười|m
第十九=thứ mười chín/thứ 19|m
第十九代=đời thứ mười chín|m
第十九回=hồi 19|m
第十九次=lần thứ mười chín|m
第十九章=Chương 19:|m
第十二=thứ mười hai/đệ thập nhị|m
第十二个=cái thứ mười hai|m
第十二代=đời thứ mười hai|m
第十二位=người thứ mười hai|m
第十二卷=quyển thứ mười hai|m
第十二名=tên thứ mười hai/người thứ mười hai|m
第十二回=hồi 12|m
第十二天=ngày thứ mười hai|m
第十二层=tầng thứ mười hai|m
第十二招=chiêu thứ mười hai|m
第十二次=lần thứ mười hai|m
第十二章=Chương 12:|m
第十五=thứ mười lăm|m
第十五位=người thứ mười lăm|m
第十五卷=quyển 15|m
第十五名=người thứ mười lăm|m
第十五回=hồi 15|m
第十五天=ngày thứ mười lăm|m
第十五次=lần thứ mười lăm|m
第十五章=Chương 15:|m
第十五集=tập 15|m
第十代=đời thứ mười|m
第十位=người thứ mười|m
第十八=thứ mười tám|m
第十八代=đời thứ mười tám|m
第十八回=hồi 18|m
第十八天=ngày thứ mười tám|m
第十八层=tầng thứ 18|m
第十八次=lần thứ mười tám|m
第十八章=Chương 18:|m
第十六=thứ mười sáu|m
第十六位=người thứ mười sáu|m
第十六回=hồi 16|m
第十六次=lần thứ mười sáu|m
第十六章=Chương 16:|m
第十六集=tập 16|m
第十卷=quyển thứ mười|m
第十名=hạng mười/tên thứ mười/người thứ mười|m
第十四=thứ mười bốn/đệ thập tứ|m
第十四代=đời thứ mười bốn|m
第十四位=người thứ mười bốn|m
第十四卷=quyển 14|m
第十四名=người thứ mười bốn|m
第十四天=ngày thứ mười bốn|m
第十四把=thanh thứ mười bốn|m
第十四招=chiêu thứ mười bốn|m
第十四次=lần thứ mười bốn|m
第十四章=Chương 14:|m
第十回=hồi 10|m
第十天=ngày thứ mười|m
第十层=tầng thứ mười/tầng thứ 10|m
第十招=chiêu thứ mười|m
第十次=lần thứ mười|m
第十章=Chương 10:|m
第十篇=Quyển thứ mười:/thiên thứ mười|m
第十轮=vầng thứ mười|m
第十集=tập 10|m
第四=thứ tư/đệ tứ/thứ tư|m
第四个=cái thứ tư/người thứ tư/thứ tư/đệ tứ|m
第四代=đời thứ tư/đời thứ bốn|m
第四任=đời thứ tư|m
第四位=vị thứ tư/vị trí thứ tư/người thứ bốn|m
第四十=thứ bốn mươi|m
第四十一=thứ 41/thứ bốn mươi mốt|m
第四十一章=Chương 41:|m
第四十七=thứ bốn mươi bảy|m
第四十七章=Chương 47:|m
第四十三=thứ 43/thứ bốn mươi ba|m
第四十三章=Chương 43:|m
第四十九=thứ bốn mươi chín|m
第四十九章=Chương 49:|m
第四十二=thứ bốn mươi hai|m
第四十二章=Chương 42:|m
第四十五=thứ bốn mươi lăm|m
第四十五章=Chương 45:|m
第四十八=thứ bốn mươi tám|m
第四十八章=Chương 48:|m
第四十六=thứ bốn mươi sáu|m
第四十六章=Chương 46:|m
第四十名=người thứ bốn mươi|m
第四十四=thứ bốn mươi bốn|m
第四十日=ngày thứ tư mươi|m
第四十章=Chương 40:|m
第四卷=quyển thứ tư/Quyển 4:|m
第四号=thứ tư|m
第四名=thứ tư/tên thứ tư|m
第四回=hồi 4/hồi thứ tư|m
第四场=trận thứ tư|m
第四块=khối thứ bốn|m
第四声=tiếng thứ tư|m
第四天=ngày thứ tư|m
第四局=ván thứ tư|m
第四层=tầng thứ tư|m
第四届=giới thứ tư/lần thứ tư|m
第四幅=bức thứ tư|m
第四年=năm thứ tư|m
第四座=tòa thứ tư|m
第四张=tờ thứ tư|m
第四批=nhóm thứ tư|m
第四招=chiêu thứ tư/chiêu thứ bốn|m
第四拳=quyền thứ tư|m
第四方=phe thứ tư|m
第四日=ngày thứ tư|m
第四条=đầu thứ tư/điều thứ tư|m
第四枚=viên thứ tư|m
第四架=chiếc thứ tư|m
第四根=cây thứ thư/cái thứ tư|m
第四次=lần thứ tư/lần thứ bốn|m
第四步=bước thứ tư/đệ tứ bộ|m
第四点=điểm thứ tư|m
第四碗=chén thứ tư|m
第四种=loại thứ tư|m
第四章=Chương 04:|m
第四第五=thứ tư thứ năm|m
第四等=đệ tứ đẳng|m
第四篇=đệ tứ thiên|m
第四组=tổ thứ tư/tổ 4|m
第四维=chiều thứ tư|m
第四节=tiết thứ tư|m
第四轮=vòng thứ tư|m
第四道=đạo thứ tư|m
第四部=bộ 4/bộ thứ tư|m
第四重=đệ tứ trọng/tầng thứ bốn|m
第四间=căn thứ tư|m
第四队=đội thứ tư|m
第四集=tập 4/tập thứ tư|m
第四页=trang thứ tư|m
第四项=hạng thứ tư|m
第四颗=viên thứ tư|m
第次=lần thứ|m
第零=thứ 0|m
终天=cả ngày/suốt ngày/suốt đời/cả đời/trọn đời|m
终年=quanh năm/hưởng thọ/suốt năm/cả năm/tuổi lúc chết/hưởng dương|m
终点站=trạm cuối cùng/trạm cuối|m
绝代=tuyệt đại/tuyệt thế/độc nhất vô nhị/vô song|m
绝口=không hề/im bặt/nín thinh/lặng thinh/lặng yên|m
绝句=tuyệt cú/thơ tứ tuyệt|m
绝大多数=tuyệt đại đa số|m
绝大部分=tuyệt đại bộ phận/tuyệt đại bộ phân/phần lớn|m
绝天=Tuyệt Thiên/tuyệt thiên|m
绝户=tuyệt hậu/không con cháu/không người nối dõi/người không con/cả nhà|m
绝招=tuyệt chiêu/tuyệt kỹ/tay nghề tuyệt vời/mẹo/bí quyết|m
绝种=tuyệt chủng/mất giống/tuyệt giống|m
绝笔=tuyệt bút/tác phẩm cuối cùng/tác phẩm cuối đời|m
绝粒=tuyệt thực/nhịn ăn|m
绝路=tuyệt lộ/cùng đường/hết cách|m
绝阵=tuyệt trận|m
绝顶=tuyệt đỉnh/vô cùng/rất/hết sức/đỉnh cao nhất/tột bậc/tột cùng/tột đỉnh|m
美丑=đẹp xấu/xấu đẹp|m
美分=cent|m
美名=mỹ danh/tên gọi hay/tên hay|m
美声=mỹ thanh/giọng nói đẹp/bel canto|m
美少年=mỹ thiếu niên|m
美日=mỹ nhật/mặt trời chói chang|m
美月=Mỹ Nguyệt|m
美滴=mỹ tích|m
美眼=mắt đẹp|m
美脸=mỹ kiểm|m
美起=mỹ khởi|m
美餐=thức ăn ngon/bữa ăn ngon|m
良多=rất nhiều/lương đa|m
良种=giống tốt/loại tốt|m
若只=nếu chỉ|m
若家=Nhược gia|m
若干=một số/chắc chắn/bao nhiêu/nhược can/ngần ấy cái/nhược kiền|m
若纸=như tờ giấy|m
英名=anh danh/tên tuổi anh hùng/rạng rỡ/lẫy lừng|m
英招=Anh Chiêu|m
英磅=bảng anh/cân Anh/Pound|m
见天=mỗi ngày/hàng ngày|m
许三多=Hứa Tam Đa|m
许下=ưng thuận|m
许久=hồi lâu/rất lâu/lâu|m
许久许久=rất rất lâu/rất lâu sau đó|m
许些=có chút ít/có chút|m
许人=khen người|m
许儿=Hứa nhi|m
许多=rất nhiều/nhiều|m
许多代=rất nhiều đời|m
许多天=rất nhiều ngày|m
许多年=rất nhiều năm|m
许多次=rất nhiều lần/rất nhiều lần|m
许多遍=rất nhiều lần|m
许大少=Hứa đại thiếu|m
许天=Hứa Thiên|m
许家=Hứa gia|m
许少=Hứa thiếu|m
许年=khoảng một năm|m
许许多多=rất nhiều/hứa hứa đa đa/rất rất nhiều|m
诸位=chư vị/các vị/các ngài|m
诸多=rất nhiều/chư đa/nhiều/chứa nhiều/tất cả/rất nhiều|m
诸多方面=rất nhiều phương diện|m
诸天=chư thiên|m
诸子百家=bách gia chư tử/chư tử bách gia/Trăm trường phái tư tưởng, các trường phái tư tưởng khác nhau và các cơ sở của chúng trong thời Xuân Thu và Chiến Quốc|m
贰=nhị|m
贰佰万=hai trăm vạn|m
辆车=chiếc xe|m
辛丑年=năm Tân Sửu/tân sửu niên|m
辛亥=tân hợi/Tân Hợi/辛亥革命 [Xin1 hai4 Ge2 ming4], Cách mạng Tân Hợi năm 1911|m
酉戌=Dậu Tuất|m
零七=lẻ bảy|m
零三=lẻ ba|m
零下=âm/dưới không/dưới 0/dưới/dưới âm|m
零九=lẻ chín|m
零二=lẻ hai|m
零六=lẻ sáu|m
零四=lẻ bốn|m
零摄氏度=0°C|m
零零发=Không Không Tắm|m
首个=đầu tiên/cái đầu|m
首位=thủ vị/vị trí đầu não|m
首卷=thủ quyển|m
首家=thủ gia/đầu tiên|m
首尾=đầu đuôi/trước sau/từ đầu đến cuối|m
首层=tầng đầu/tầng một|m
首届=lần thứ nhất/lần đầu/kì thứ nhất|m
首座=thủ tọa|m
首批=đám đầu tiên|m
首数=thủ sổ:đầu tiên/thủ sổ/đầu tiên|m
首日封=ngày đầu tiên dùng|m
首次=lần đầu|m
首轮=vòng đầu/vòng đầu tiên|m
首重=thủ trọng|m
首页=trang đầu|m
