一丝丝=một tia/một chút xíu/từng tia/từng tia một|mq
一度=một trận/một lần/một dạo/có một lần|mq
一方面=một phương diện/cùng lúc/một mặt/một mặt|mq
一月份=tháng một|mq
一脚=một cước|mq
一道道=từng đạo/từng đạo từng đạo|mq
三伙=ba nhóm|mq
三分之一=một phần ba|mq
三分钟=ba phút/3 phút|mq
三场=ba trận|mq
三月份=ba tháng|mq
三脚=ba cước|mq
三面=ba mặt|mq
十月份=lúc tháng mười|mq
哪一点=điểm kia/điểm nào|mq
哪朝=triều nào|mq
哪条=đầu nào|mq
四件=bốn kiện/bốn cái|mq
四份=bốn phần|mq
四分之一=một phần tư|mq
四分钟=bốn phút|mq
四场=bốn trận|mq
四月份=tháng tư|mq
四脚=bốn chân|mq
四色=tứ sắc/bốn màu|mq
四面=tứ phía/tứ diện/bốn mặt/bốn phương/xung quanh/bốn bề/bốn phía|mq
此钟=chuông này|mq
这件=cái này|mq
这份=phần này|mq
这口钟=chiếc chuông này|mq
这回=lúc này|mq
这场=trận này/tràng này|mq
这帮=đám này/bang này|mq
这方面=phương diện này|mq
这朝=triều này|mq
这根=căn này/cây này|mq
这点=điểm này/điểm ấy|mq
这脚=cước này/chân này|mq
这辆=chiếc này|mq
这部分=bộ phận này|mq
这钟=cái chuông này|mq
这面=mặt này/mì này/phía này|mq
那口钟=chiếc chuông kia|mq
那场=trận kia|mq
那帮=đám kia/cái nhóm này/vậy giúp|mq
那条=đầu kia/đầu nào|mq
那根=cây kia/căn kia/cái kia|mq
那脚=vậy chân/cặp chân kia|mq
那辆=chiếc kia|mq
零件=linh kiện/linh liện/phụ tùng|mq
零度=không độ|mq
零部件=linh bộ kiện|mq
