佬=lão|ng
俑=dũng|ng
俳=bài|ng
冢=trủng|ng
刃=nhận|ng
勳=huân|ng
卉=hủy|ng
嗣=tự|ng
圃=phố|ng
圹=khoáng|ng
坞=ổ|ng
垠=ngân|ng
垣=viên|ng
垸=viện|ng
埂=canh|ng
埙=huân|ng
埠=phụ|ng
塬=nguyên|ng
墟=khư|ng
壑=hác|ng
夷=di|ng
婿=tế|ng
寨=trại|ng
屿=tự|ng
巾=cân|ng
帚=trửu|ng
幡=phiên|ng
庑=vũ|ng
庖=bào|ng
庵=am|ng
役=dịch|ng
忱=thầm|ng
戟=kích|ng
斋=trai|ng
杖=trượng|ng
栎=lịch|ng
梢=sao|ng
椒=tiêu|ng
楦=tuyên|ng
楫=tiếp|ng
槌=chùy|ng
槎=tra|ng
槽=tào|ng
樯=tường|ng
樽=tôn|ng
橹=lỗ|ng
檐=diêm|ng
涧=giản|ng
涯=nhai|ng
溴=xú|ng
犊=độc|ng
玺=tỳ|ng
甏=bảnh|ng
畔=bạn|ng
痹=tý|ng
痺=tí|ng
眚=sảnh|ng
眶=khuông|ng
础=sở|ng
磬=khánh|ng
祉=chỉ|ng
秆=cán|ng
稗=bại|ng
竿=can|ng
筏=phiệt|ng
箫=tiêu|ng
篙=cao|ng
簋=quỹ|ng
籁=lại|ng
籍=tịch|ng
粹=túy|ng
繭=kiển|ng
绪=tự|ng
绶=thụ|ng
缨=anh|ng
羹=canh|ng
脛=hĩnh|ng
腠=thấu|ng
膛=thang|ng
舶=bạc|ng
茔=oanh|ng
茗=mính|ng
莺=oanh|ng
菇=cô|ng
葩=ba|ng
蓮=liên|ng
蕊=nhị|ng
蕙=huệ|ng
虏=lỗ|ng
蝇=dăng|ng
蠍=hiết|ng
衫=sam|ng
袂=mệ|ng
裳=thường|ng
觚=cô|ng
讯=tấn|ng
谊=nghị|ng
貉=hạc|ng
赂=lộ|ng
跤=giao|ng
辏=thấu|ng
辰=thần|ng
邑=ấp|ng
邦=bang|ng
酯=chỉ|ng
錘=chuy|ng
钋=bộc|ng
钍=thổ|ng
钗=thoa|ng
钬=hoả|ng
钴=cỗ|ng
钺=việt|ng
钽=đán|ng
铌=ni|ng
铳=súng|ng
锑=đễ|ng
锶=tư|ng
镞=thốc|ng
阄=cưu|ng
阍=hôn|ng
隅=ngung|ng
隙=khích|ng
雉=trĩ|ng
雹=bạc|ng
霭=ải|ng
韁=cương|ng
颊=giáp|ng
颏=hài|ng
馓=tản|ng
驹=câu|ng
髯=nhiêm|ng
鬢=tấn|ng
鬲=cách|ng
鳇=hoàng|ng
鸥=âu|ng
鹄=hộc|ng
鹊=thước|ng
鹗=ngạc|ng
鹜=vụ|ng
麓=lộc|ng
麟=lân|ng
黍=thử|ng
龛=ham|ng
