万绮=Vạn Ỷ|nrfg
严世蕃=Nghiêm Thế Phiên|nrfg
严皓=Nghiêm Hạo|nrfg
乔榛=Kiều Trăn|nrfg
习近平=Tập Cận Bình|nrfg
于岱=Vu Đại|nrfg
令棠=lệnh đường|nrfg
任芝=Nhậm Chi|nrfg
余秋雨=Dư Thu Vũ|nrfg
俞岱岩=Du Đại Nham|nrfg
俞淼=Du Miểu|nrfg
六韬=Lục Thao|nrfg
关晓彤=Quan Hiểu Đồng|nrfg
刀修=đao tu|nrfg
刘备=Lưu Bị|nrfg
刘姓=họ Lưu|nrfg
刘姥姥=Lưu mỗ mỗ/lưu mỗ mỗ|nrfg
刘家=Lưu gia|nrfg
刘承佑=Lưu Thừa Hữu|nrfg
刘淼=Lưu Miểu|nrfg
刘睿=Lưu Duệ|nrfg
刘魁=lưu khôi|nrfg
则安之=vậy thì yên ổn mà ở thôi|nrfg
叶玉嫣=Diệp Ngọc Yên|nrfg
吴娟=Ngô Quyên|nrfg
吴小绮=Ngô Tiểu Ỷ|nrfg
吴建皓=Ngô Kiến Hạo|nrfg
吴彤=ngô đồng|nrfg
吴棠=Ngô Đường|nrfg
周岱=Chu Đại|nrfg
周绮=Chu Khởi|nrfg
唐煜=đường dục|nrfg
夏娟=Hạ Quyên|nrfg
姚家=Diêu gia|nrfg
姨姥姥=bà dì/chị em gái của bà ngoại|nrfg
孔家=Khổng gia|nrfg
孙坤=Tôn Khôn|nrfg
孙家=Tôn gia|nrfg
孙淼=Tôn Miễu|nrfg
孙皓=Tôn Hạo|nrfg
宁姓=họ Ninh|nrfg
宁远=Ninh Viễn|nrfg
安澜=êm đềm/thái bình/trời yên bể lặng|nrfg
宋家=Tống gia|nrfg
宋绮=Tống Khỉ|nrfg
小珂=tiểu Kha|nrfg
就冲进=liền vọt vào|nrfg
展子虔=Triển Tử càn|nrfg
左宗棠=Tả Tông Đường/Zuo Zongtang|nrfg
左齐=Tả Tề|nrfg
席娟=Tịch Quyên|nrfg
庄睿=Trang Duệ|nrfg
庄稼人=nông dân/nhà nông/người làm ruộng|nrfg
庄稼汉=anh nông dân/ông nông dân|nrfg
康熙=Khang Hi|nrfg
张叫=thẻ gọi là|nrfg
张娟娟=Trương Quyên Quyên|nrfg
张家=Trương gia|nrfg
张小娟=Trương Tiểu Quyên|nrfg
张居正=Trương Cư Chính|nrfg
张新一=Trương Tân Nhất|nrfg
张澜=Trương Lan|nrfg
张绮=Trương Khỉ|nrfg
彦青=ngạn thanh|nrfg
徐家=Từ gia|nrfg
徐渭=từ vị|nrfg
志强=chí cường|nrfg
放弛=phóng túng|nrfg
放洋=du học/xuất dương du học/ra nước ngoài du học/đi sứ nước ngoài/viễn dương|nrfg
放皓=hừng sáng|nrfg
放青=thả ra bãi cỏ xanh/cho đi ăn cỏ/thả cho ăn cỏ|nrfg
方孝孺=Phương Hiếu Nhụ|nrfg
方恬=Phương Điềm|nrfg
施琅=Thi Lang|nrfg
易姓=họ Dịch|nrfg
曹彬=Tào Bân|nrfg
曼成=Mạn Thành|nrfg
朱家=Chu gia|nrfg
朱自清=Chu Tự Thanh|nrfg
朱高燧=Chu Cao Toại|nrfg
李云成=Lý Vân Thành|nrfg
李光睿=Lý Quang Duệ|nrfg
李双成=Lý Song Thành|nrfg
李向前=Lý Hướng Tiền|nrfg
李和=lý hòa|nrfg
李天进=Lý Thiên Tiến|nrfg
李姓=họ Lý|nrfg
李姥姥=Lý mỗ mỗ|nrfg
李家=Lý gia|nrfg
李建成=Lý Kiến Thành|nrfg
李建明=Lý Kiến Minh|nrfg
李弘成=Lý Hoằng Thành|nrfg
李强=Lý Cường|nrfg
李彤=Lý Đồng|nrfg
李彬=Lý Bân|nrfg
李恪=Lý Khác|nrfg
李成=Lý Thành|nrfg
李文和=Lý Văn Hòa|nrfg
李淼=Lý Miểu|nrfg
李煜=Lý Dục|nrfg
李玄成=Lý Huyền Thành|nrfg
李美娟=Lý Mỹ Quyên|nrfg
李自成=Lý Tự Thành|nrfg
李自成起义=cuộc khởi nghĩa ' Lý Tự Thành'/cuộc khởi nghĩa 'Lý Tự Thành'|nrfg
李艺彤=Lý Nghệ Đồng|nrfg
李进=Lý Tiến|nrfg
李道一=Lý Đạo Nhất|nrfg
李道远=Lý Đạo Viễn|nrfg
李道长=Lý đạo trưởng|nrfg
李长春=Lý Trường Xuân|nrfg
李长顺=Lý Trường Thuận|nrfg
李雪稚=Lý Tuyết Trĩ|nrfg
杨姓=họ Dương|nrfg
杨家=Dương gia|nrfg
杨成=Dương Thành|nrfg
杨澜=Dương Lan|nrfg
杨炯=Dương Quýnh|nrfg
杨皓=Dương Hạo|nrfg
杨魁=Dương Khôi|nrfg
林姓=họ Lâm|nrfg
林淑贞=Lâm Thục Trinh|nrfg
林皓=Lâm Hạo|nrfg
林莽=xanh tươi rậm rạp/xanh tốt|nrfg
柳咏=Liễu Vịnh|nrfg
柳淑月=Liễu Thục Nguyệt|nrfg
桑梓=quê cha đất tổ|nrfg
梁咏琪=Lương Vịnh Kỳ|nrfg
梁家=Lương gia|nrfg
橐驼=lạc đà/con lạc đà|nrfg
江彬=Giang Bân|nrfg
汪家=Uông gia|nrfg
沈彤=Thẩm Đồng|nrfg
沈煜=Thẩm Dục|nrfg
火蟾=Hỏa Thiềm|nrfg
王彤=Vương Đồng|nrfg
王珂=Vương Kha|nrfg
王皓=Vương Hạo|nrfg
王美娟=Vương Mỹ Quyên|nrfg
王韬=Vương Thao|nrfg
珂珂=Kha Kha|nrfg
田坤=Điền Khôn|nrfg
田家=Điền gia/nông dân|nrfg
白皓=Bạch Hạo|nrfg
祖冲之=Tổ Xung Chi|nrfg
祥和=tường hòa/an lành|nrfg
秦佑=Tần Hữu|nrfg
秦娟=Tần Quyên|nrfg
秦嫣=Tần Yên|nrfg
程淑美=Trình Thục Mỹ|nrfg
罗娟娟=La Quyên Quyên|nrfg
罗彤=La Đồng|nrfg
老成=lão thành/từng trải/lão luyện/dày dạn kinh nghiệm/già dặn|nrfg
聂盖=Nhiếp Cái|nrfg
聂远=Nhiếp Viễn|nrfg
胡家=Hồ gia|nrfg
胡说=nói bậy/nói xằng/nói càn/nói ẩu/nói bừa/nói nhảm/nói xằng bậy/xuyên tạc|nrfg
苏臻=Tô Trăn|nrfg
荀彧=Tuân Úc|nrfg
莫说=chớ nói/đừng nói|nrfg
萧淑妃=Tiêu Thục phi|nrfg
蒙恬=Mông Điềm/Tướng Tần Mạnh Thiên|nrfg
袁彬=Viên Bân|nrfg
解颐=hớn hở/tươi cười|nrfg
许娟=Hứa Quyên|nrfg
许淑玲=Hứa Thục Linh|nrfg
谢娟=Tạ Quyên|nrfg
谢嫣=Tạ Yên|nrfg
谢家=Tạ gia|nrfg
谭家=Đàm gia|nrfg
谭晓娟=Đàm Hiểu Quyên|nrfg
贞洁=trong trắng/trinh tiết/trong sạch|nrfg
费彬=Phí Bân|nrfg
贾嫣=Giả Yên|nrfg
赵家=Triệu gia|nrfg
赵睿=Triệu Duệ|nrfg
连一成=liền một thành|nrfg
连成=hợp thành/gắn bó/nối liền/liền/liên tục - thành/nối thành|nrfg
邹家=Trâu gia|nrfg
郑和=Trịnh Hòa|nrfg
郑家=Trịnh gia|nrfg
郑成功=Trịnh Thành Công/Koxinga|nrfg
郑板桥=Trịnh Bản Kiều|nrfg
郑淑明=Trịnh Thục Minh|nrfg
郭咏琴=Quách Vịnh Cầm|nrfg
郭娟=Quách Quyên|nrfg
郭孝恪=Quách Hiếu Khác|nrfg
金庸=Kim Dung|nrfg
金焰=kim diễm|nrfg
金煜=Kim Dục|nrfg
金蟾=kim thiềm|nrfg
陆彬=Lục Bân|nrfg
陈和=Trần Hòa|nrfg
陈家=Trần gia|nrfg
陈彬=Trần Bân|nrfg
陈晓娟=Trần Hiểu Quyên|nrfg
陈有和=trần hữu hòa|nrfg
陈淑敏=Trần Thục Mẫn|nrfg
陈玉娟=Trần Ngọc Quyên|nrfg
陈珂=Trần Kha|nrfg
陈睿=Trần Duệ|nrfg
陈芜=Trần Vu|nrfg
陈说=nói rõ/trần thuật/trình bày/nói/phát biểu|nrfg
降尊纡贵=khiêm tốn hạ mình/hàng tôn hu quý|nrfg
雪珂=Tuyết Kha|nrfg
霍仲孺=Hoắc Trọng Nhụ|nrfg
韦淼=Vi Miểu|nrfg
韩家=Hàn gia|nrfg
韩进=Hàn Tiến|nrfg
额前=trên trán|nrfg
马岱=Mã Đại|nrfg
马自达=Mazda|nrfg
马荣成=Mã Vinh Thành|nrfg
高大魁梧=khôi ngô cao lớn|nrfg
高桥优=Takahashi Yu|nrfg
高珊=Cao San|nrfg
鲁智深=Lỗ Trí Thâm|nrfg
鸣叫声=tiếng kêu to|nrfg
黄子韬=Hoàng Tử Thao|nrfg
黄彬=Hoàng Bân|nrfg
黄文娟=Hoàng Văn Quyên|nrfg
黄皓=Hoàng Hạo|nrfg
齐家=Tề gia|nrfg
龙皓=Long Hạo|nrfg
