一堆堆=từng đống|ns
一封封=từng phong từng phong|ns
一州=một châu|ns
一棵树=một cái cây/một thân cây|ns
一路平安=lên đường bình an|ns
一马平川=vùng đất bằng phẳng|ns
七中=Thất Trung|ns
七伯=Thất bá|ns
七哥=Thất ca/thất ca|ns
七楼=lầu bảy/lầu 7|ns
七武海=Thất Vũ Hải|ns
七海=thất hải/Nanami|ns
七灵岛=Thất Linh Đảo|ns
七绝=thất tuyệt/thơ thất tuyệt|ns
七阴=thất âm|ns
七雄=Thất Hùng|ns
万东=vạn năm|ns
万古=vạn cổ/muôn đời/muôn thuở|ns
万山=vạn sơn|ns
万花山=Vạn Hoa Sơn|ns
万里长城=Vạn Lý Trường Thành|ns
三中=tam trung|ns
三临=ba lần tới|ns
三亚=Tam Á|ns
三伯=Tam bá|ns
三国=Tam quốc/ba nước/tam quốc|ns
三大州=tam đại châu|ns
三宫六院=tam cung lục viện|ns
三家村=Tam gia thôn|ns
三山=Tam Sơn|ns
三山五岳=tam sơn ngũ nhạc|ns
三岔口=ngã ba đường|ns
三岔路口=ngã ba đường|ns
三峡=Tam Hạp|ns
三座大山=ba hòn núi lớn|ns
三春=ba tháng mùa xuân|ns
三本=ba bản/ba quyển|ns
三极=ba cấp/cấp ba/tam cực|ns
三江=Tam Giang|ns
三江五湖=ba sông năm hồ/Tam Giang Ngũ Hồ|ns
三河市=thành phố Tam Hà|ns
三河镇=Tam Hà Trấn|ns
三清山=Tam Thanh sơn/Tam thanh sơn|ns
三班六房=tam ban lục phòng|ns
三省=ba tỉnh|ns
三藏=Tam Tạng|ns
三角区=khu tam giác|ns
三角旗=cờ tam giác|ns
三角洲=vùng châu thổ/Delta|ns
三里屯=tam lý truân/Sanyu/Sanlitun|ns
三阳=tam dương|ns
三鲜=tam tiên|ns
三黄鸡=gà tam hoàng/gà ba màu vàng|ns
上京=lên kinh/kinh thành|ns
上兵伐谋=thượng binh phạt mưu|ns
上刀山=lên núi đao|ns
上半场=hơn nửa hiệp/nửa đầu trận đấu|ns
上古=thượng cổ|ns
上台=lên đài/lên sân khấu/lên bục giảng/nhậm chức/lên nắm quyền|ns
上国=thượng quốc|ns
上坡=lên dốc|ns
上坡路=đường dốc/con đường tiến lên/con đường phía trước rộng mở/con đường rộng mở|ns
上城=lên thành|ns
上堂=thăng đường/lên lớp/vào lớp/thướng đường/lên thềm|ns
上士=thượng sĩ|ns
上官大哥=Thượng Quan đại ca|ns
上宾=khách quý/thượng tân/thượng khách/khách quý|ns
上山=lên núi|ns
上岗=vào cương vị|ns
上岛=lên đảo|ns
上峰=cấp trên/quan trên/thượng quan|ns
上市=đưa ra thị trường/đi chợ/đến chợ/thượng thị/ra thị trường|ns
上杉家=nhà Uesugi|ns
上梁=Thượng Lương|ns
上楼=lên lầu|ns
上殿=lên điện|ns
上江=thượng du Trường Giang/Thượng Giang|ns
上河=thượng hà|ns
上洛=thượng Lạc|ns
上流人士=thượng lưu nhân sĩ|ns
上海=Thượng Hải/thành phố Thượng Hải|ns
上海滩=ghềnh Thượng Hải/lên bãi biển/Bến Thượng Hải/nơi được mệnh danh là phố WALL của Trung Quốc.|ns
上清丹=Thượng Thanh Đan|ns
上联=vế trên|ns
上苍=trời xanh/thượng thương|ns
上苑=thượng uyển/vườn thượng uyển/ngự uyển|ns
上街=ra đường/trên đường phố|ns
上西天=lên tây thiên/vào thiên đàng|ns
上谷=Thượng Cốc|ns
上贵=thượng quý|ns
上路=lên đường/ra đi/khởi hành/chết/tử vong/mạng vong/đại lộ/đường lớn/lĩnh hội/hiểu/trên đường|ns
上铺=giường trên|ns
上门=tới cửa/đến thăm/nhà/đến cửa/đến nhà/đến chơi/then cửa/ở rể/thượng môn|ns
上马=lên ngựa/khởi công|ns
下半旗=kéo cờ rủ/treo cờ rủ|ns
下坡=xuống dốc|ns
下山=xuống núi/há sơn/hạ sơn|ns
下江=hạ lưu Trường Giang|ns
下河=xuống sông|ns
下海=xuống biển/ra biển/đi biển/ra khơi/trở thành diễn viên chuyên nghiệp|ns
下湖=xuống hồ|ns
下联=vế dưới/vế sau|ns
下车伊始=mới đến nhiệm sở/chân ướt chân ráo đến nơi|ns
下马威=ra oai phủ đầu/tác oai tác phúc/cho biết tay/áp đảo tinh thần/hạ mã uy|ns
下龙湾=Vịnh Hạ Long|ns
不丹=Bu-tan/Bhutan|ns
不列颠=Britain|ns
不太熟悉=không quá quen thuộc|ns
不干什=không làm gì|ns
不津=bất tân|ns
且夫=thả phù/vả chưng|ns
东三省=ba tỉnh Đông Bắc|ns
东东=ý tứ/đông đông|ns
东临=đông lâm|ns
东云国=Đông Vân Quốc|ns
东亚=Đông Á|ns
东亚地区=địa khu Đông Á/Đông Á|ns
东京=Đông Kinh/Tokyo|ns
东京湾=vịnh Tokyo/Vịnh Tokyo|ns
东京都=thủ đô Tokyo|ns
东六国=Đông Lục Quốc|ns
东兴=Đông Hưng|ns
东北=Đông Bắc|ns
东区=khu Đông/Khu Đông/khu vực phía đông|ns
东华门=Đông Hoa môn|ns
东南=Đông Nam|ns
东南亚=Đông Nam Á|ns
东南西北=phương hướng|ns
东台=Đông Đài|ns
东吴=Đông Ngô|ns
东国=nước Đông|ns
东坡=Đông Pha/Quận Dongpo của thành phố Meishan 眉山 市 [Mei2 shan1 Shi4], Tứ Xuyên|ns
东城=đông thành|ns
东城区=khu Đông Thành/khu đông thành|ns
东域=Đông Vực/đông vực|ns
东夷=Đông Di|ns
东奔西跑=chạy ngược chạy xuôi/chạy đôn chạy đáo/chạy lăng xăng/đông bôn tây bào|ns
东安=Đông An|ns
东宫=Đông cung|ns
东山=Đông Sơn|ns
东岭=Đông Lĩnh|ns
东峰=đông phong|ns
东川=Đông Xuyên|ns
东州=Đông Châu|ns
东巴=Đông Ba|ns
东平=Đông Bình|ns
东支西吾=quanh co lập lờ|ns
东昌=Đông Xương|ns
东木=Đông Mộc|ns
东村=Đông thôn|ns
东林=Đông Lâm|ns
东梧=Đông Ngô|ns
东欧=Đông Âu|ns
东水=Đông Thủy|ns
东江=Đông Giang|ns
东河=đông hà|ns
东洋=Đông Doanh/Nhật Bản/Đông Dương|ns
东洋大海=Đông Dương Đại Hải|ns
东洲=Đông châu|ns
东浮=Đông Phù|ns
东海=Đông Hải|ns
东港=Đông Cảng|ns
东游西荡=đi vòng vòng/đi không mục đích|ns
东湖=Đông hồ/Đông Hồ|ns
东畔=bờ đông|ns
东绝=Đông tuyệt|ns
东莞=Đông Hoàn/Đông Hoản|ns
东莱=Đông Lai|ns
东街=Đông nhai|ns
东裕国=Đông Dụ Quốc|ns
东西=đồ vật/thứ/thứ đồ vật/đông tây/phía đông và phía tây/từ đông sang tây/đồ/vật/đồ đạc/đồ vật đồ|ns
东西南北=đông tây nam bắc|ns
东西南北中=Đông Tây Nam Bắc Trung|ns
东观西望=nhìn bốn phía/nhìn xung quanh|ns
东跑西颠=chạy ngược chạy xuôi/chạy đông chạy tây điên/Chạy vòng vòng，chạy ngược chạy xuôi|ns
东路=đông lộ/Đường Đông|ns
东辽=Đông Liêu|ns
东道国=nước chủ nhà/nước đăng cai|ns
东野=Đông Dã|ns
东门=Đông Môn/cửa Đông/đông môn|ns
东阳=Đông Dương|ns
东阳市=Đông dương thị|ns
东阿=Đông A/Quận Dong'e ở Liaocheng 聊城 [Liao2 cheng2], Sơn Đông|ns
东陵=Đông Lăng|ns
东非=Đông Phi|ns
两坪=6m2|ns
两州=hai châu|ns
两汉=Lưỡng Hán|ns
两江=Lưỡng Giang|ns
两湖=Lưỡng Hồ|ns
两粤=Quảng Đông & Quảng Tây|ns
严山=Nghiêm Sơn|ns
中不中=trúng hay không|ns
中东=trung đông/vùng Trung Đông|ns
中东地区=khu vực Trung Đông|ns
中丹=trung đan|ns
中亚=Trung Á/trung á|ns
中京=trung kinh|ns
中佐=trung tá|ns
中俄=Nga Hoa|ns
中关=trung quan|ns
中兴=trung hưng/phục hưng/Trung Hưng|ns
中华人民共和国=Trung Hoa nhân dân cộng hòa quốc|ns
中南海=Trung Nam Hải|ns
中南美洲=trung Nam châu Mỹ|ns
中卫=trung vệ|ns
中原=Trung Nguyên/vùng Trung Nguyên|ns
中古=trung cổ/thời trung cổ/xã hội phong kiến/Trung Cổ|ns
中和殿=Trung Hòa điện|ns
中国=Trung Quốc|ns
中堂=phòng chính/gian nhà chính/bức hoạ lớn treo giữa nhà/nội các đại học sĩ|ns
中士=trung sĩ/Trung sĩ|ns
中夏=Trung Hạ|ns
中娄府=Trung Lâu phủ|ns
中山=Trung Sơn/Nakagawa/Nakayama|ns
中山大道=đại lộ Trung Sơn|ns
中山狼=vong ân bội nghĩa/người lấy oán trả ơn/bạc tình bạc nghĩa/kẻ vô lương tâm|ns
中岳=trong núi lớn|ns
中峰=Trung Phong|ns
中川=Trung Xuyên|ns
中州=Trung Châu|ns
中巴=trung ba/Trung Quốc và Pakistan/Trung Quốc-Bahamas|ns
中巴车=xe buýt cỡ trung|ns
中平=trung bình|ns
中度=trung độ|ns
中庭=trung đình|ns
中心区=khu trung tâm|ns
中断=gián đoạn/ngắt quãng/giữa đường gãy gánh/cắt đứt|ns
中栏=thi chạy vượt rào 400m|ns
中欧=Trung Âu/Trung - Âu|ns
中武=trung võ|ns
中波=sóng trung/sóng trung bình|ns
中洲=Trung Châu|ns
中海=Trung Hải|ns
中环=trung hoàn/trung tâm/Trung tâm, Đảo Hồng Kông|ns
中田=trung điền|ns
中田英寿=Nakata Hidetoshi/Hidetoshi Nakata|ns
中科=trung khoa|ns
中立国=nước trung lập/trung lập/quốc gia trung lập|ns
中美洲=trung châu Mỹ/Trung Mỹ|ns
中考=thi cấp ba/trung khảo|ns
中西=Trung Tây/Trung Quốc và Phương Tây|ns
中西亚=Trung Tây Á|ns
中西合璧=Trung Tây hợp bích/sự kết hợp hài hòa giữa yếu tố Trung Quốc và phương Tây|ns
中超联赛=Chinese Super League|ns
中跑=chạy vừa|ns
中路=phổ thông/phổ biến/bình thường/chất lượng trung bình/trung lộ|ns
中道=nửa đường/giữa đường/nửa chừng/đạo trung dung/trung đạo/đạo chân chính không thiên bên nào|ns
中阳=trung dương|ns
中青班=trung thanh ban|ns
中非=Trung Phi/Central African Republic/cộng hoà Trung Phi|ns
中韩=Trung Hàn|ns
中风=trúng gió|ns
丰城=Phong thành|ns
丰都=Phong Đô|ns
串联=xâu chuỗi/móc nối/thành đợt/hàng loạt/ghép nối tiếp/mắc nối tiếp/đấu kế tiếp/xuyến liên|ns
临仙城=Lâm Tiên thành|ns
临别依依=không nở chia tay|ns
临别时=trước khi chia tay|ns
临南=Lâm Nam|ns
临国=Lâm quốc|ns
临安=Lâm An/thành phố cấp quận Lin'an ở Hàng Châu 杭州 [Hang2 zhou1], Chiết Giang|ns
临峰=Lâm Phong|ns
临川=Lâm Xuyên|ns
临州=Lâm Châu|ns
临州城=thành Lâm Châu|ns
临摩=lâm ma|ns
临朐=Lâm Cù|ns
临末=xong việc|ns
临水=gặp nước/lâm thủy|ns
临江=Lâm Giang|ns
临池=tập viết chữ/tập viết thư pháp|ns
临汾=Lâm Phần|ns
临沂=Lâm Nghi/thành phố cấp tỉnh Lâm Nghi ở Sơn Đông|ns
临河=ven sông|ns
临波=Lâm Ba|ns
临洮=Lâm Thao|ns
临海=gần biển/đối biển|ns
临淄=Lâm Truy/Quận Linzi của thành phố Truy Bác 淄博 市 [Zi1 bo2 shi4], Sơn Đông|ns
临渊=Lâm Uyên|ns
临潼=Lâm Đồng|ns
临盆=lâm bồn/chuyển dạ/trở dạ/sắp sinh|ns
临脚=đột nhiên|ns
临街=sát đường/đối diện đường cái|ns
临门=lâm môn/tới nhà/tới cửa/sút vào khung thành|ns
丹丘=Đan Khâu|ns
丹东=Đan Đông|ns
丹丹=Đan Đan|ns
丹典=Đan điển|ns
丹内=trong nội đan|ns
丹圣=Đan Thánh|ns
丹城=Đan thành|ns
丹多洛=Dandolo|ns
丹尼尔斯=Đan Ni Nhĩ Tư|ns
丹尼斯=Dennis/Đan Ni Tư|ns
丹徒县=Đan Đồ huyện|ns
丹水=sông Đán/Dan River/đan thủy|ns
丹流=đan lưu|ns
丹海=đan hải|ns
丹纳=Deimne|ns
丹阳=Đan Dương|ns
丹顿=Đan Đốn|ns
丹麦=Đan Mạch|ns
丽亚=Lệ Á|ns
丽安=Liane|ns
丽山=Lệ Sơn|ns
丽川=sông Lệ|ns
丽水=Lệ Thuỷ|ns
丽江=Lệ Giang|ns
丽沙=Lisa|ns
丽萨=Lieza|ns
丽西=Lệ Tây|ns
丽都=Lệ Đô|ns
乃尔=như vậy/như thế|ns
乃木坂=Nokizaka|ns
乃木阪=Nokizaka|ns
义乌市=Nghĩa ô thị|ns
义州=Nghĩa châu|ns
之乐耳=vui tai|ns
之列=liệt kê/nhóm/hàng ngũ|ns
之塔=chi tháp|ns
之壮=chi tráng|ns
之夫=phu quân|ns
之威=chi uy/oai|ns
之宁=Chi Ninh|ns
之密=bí mật|ns
之山=chi sơn|ns
之峰=đỉnh cao|ns
之志=ý chí|ns
之托=nhờ/nhờ vả|ns
之林=chi lâm|ns
之树=chi thụ|ns
之水=chi thủy/nước|ns
之河=chi hà/sông|ns
之泉=chi tuyền|ns
之牙=chi nha|ns
之环=chi hoàn|ns
之盛=chi thịnh/quá lớn|ns
之约=ước hẹn|ns
之美=vẻ đẹp/chuyện tốt|ns
之虞=mà lo lắng|ns
之遥=xa/chi diêu|ns
之都=chi đô|ns
之颠=đỉnh|ns
之龙=chi long|ns
乌兰=Ô Lan|ns
乌兹别克=Uzbekistan/Ô Tư Biệt Khắc|ns
乌兹别克斯坦=Uzbekistan|ns
乌利=Ully|ns
乌古=Ô Cổ|ns
乌坦镇=Ô Thản Trấn|ns
乌山=Ô Sơn|ns
乌拉圭=Uruguay/Urugoay|ns
乌斯=Us|ns
乌斯藏=Ô Tư Tàng|ns
乌江=Ô Giang|ns
乌海=Ô Hải|ns
乌涂=nước âm ấm/chần chừ/do dự/không dứt khoát|ns
乌苏里江=sông Ussuri/Sông Ussuri|ns
乌迪内斯=Udinese|ns
乌里=Oury|ns
乌门=Môn|ns
乌鲁木齐=Ô Lỗ Mộc Tề/Ürümqi|ns
乌鸡=gà ác/gà đen/Gallus gallus domesticus Brisson|ns
乌黑=đen nhánh/đen thùi/đen thui/đen sẫm/đen sì|ns
乍富=giàu xổi|ns
乍得=Sát/Chad/cộng hoà Sát|ns
乍舌=tặc lưỡi/sạ thiệt/chắt lưỡi|ns
乍起=lóe sáng/chợt nổi lên/nổi lên|ns
乐山=Nhạc Sơn/nhạc sơn|ns
乔治敦=Georgetown/Kiều Trì Đôn|ns
九丘=cửu khâu/các thứ trong chín châu đều hợp cả ở đấy|ns
九伯=Cửu bá|ns
九华山=Cửu Hoa Sơn|ns
九原=cửu nguyên/1.cửu tuyền/vậy|ns
九国=cửu quốc|ns
九夷=Cửu Di|ns
九宫=cửu cung/cung điệu|ns
九宫山=Cửu Cung sơn|ns
九寨沟=Cửu Trại Câu|ns
九尾=Cửu Vĩ/cửu vĩ|ns
九山=cửu sơn|ns
九峰=Cửu Phong|ns
九峰山=Cửu Phong sơn|ns
九嶷=Cửu Nghi|ns
九州=Cửu Châu/Kyushu/Cửu châu|ns
九州岛=cửu châu đảo|ns
九归=cửu quy|ns
九曲桥=cầu cửu khúc|ns
九江=Cửu Giang|ns
九波=chín làn sóng|ns
九洲=Cửu Châu|ns
九绝=cửu tuyệt|ns
九考=cửu khảo|ns
九连=cửu liên|ns
九连山=Cửu Liên sơn|ns
九连环=cửu liên hoàn/chín liên hoàn|ns
九门=chín môn/cửu môn|ns
九阳=Cửu Dương/cửu dương|ns
九阴=Cửu Âm|ns
九黎=Cửu Lê|ns
九龙坡=Cửu Long Pha/Quận Jiulongpo của đô thị trung tâm Trùng Khánh, trước đây thuộc Tứ Xuyên|ns
九龙山=Cửu Long sơn|ns
书圣=thư thánh|ns
乳牙=răng sữa/Răng sữa|ns
乾坤袋=túi Càn Khôn|ns
二三其德=chần chừ do dự/hai ba kỳ đức|ns
二哥=nhị ca/Nhị ca|ns
二房东=cò nhà|ns
二本=hai bản/cao đẳng|ns
二连=nhị liên|ns
于国=với đất nước|ns
于洋=Vu Dương|ns
云中=trong mây|ns
云兴=Vân Hưng|ns
云北=Vân Bắc|ns
云南=Vân Nam|ns
云原=Vân Nguyên|ns
云台=Vân Đài|ns
云国=vân quốc|ns
云城=Vân Thành|ns
云头=đám mây/đụn mây|ns
云山=Vân Sơn|ns
云岛=Vân Đảo/vân đảo|ns
云岭=Vân Lĩnh|ns
云峰城=Vân Phong thành|ns
云崖=vân nhai/núi cao vút tận tầng mây|ns
云川=Vân Xuyên|ns
云州=Vân Châu|ns
云市=vân thị|ns
云广都=Vân Nghiễm Đô|ns
云林=Vân Lâm|ns
云楼=vân lâu/Vân Lâu|ns
云水=vân thủy|ns
云汉=ngân hà/sông ngân/trời cao|ns
云河=Vân Hà|ns
云洲=Vân Châu|ns
云海=biển mây/vân hải|ns
云湖=Vân Hồ|ns
云省=Vân tỉnh|ns
云耳=vân nhĩ|ns
云达=Werder|ns
云里雾里=như lọt vào trong sương mù/rơi vào trong sương mù|ns
云阳=Vân Dương|ns
云集=tụ tập/tập hợp/tập trung|ns
云雾山=Vân vụ sơn/Vân Vụ sơn|ns
云龙=vân long|ns
云龙山=Vân Long sơn|ns
五伯=Ngũ bá|ns
五关=năm cửa|ns
五原=Ngũ Nguyên|ns
五台山=Ngũ Đài Sơn|ns
五圣=Ngũ Thánh|ns
五岳=Ngũ Nhạc|ns
五指山=Ngũ Chỉ sơn|ns
五旗=ngũ kỳ/Ngũ kỳ|ns
五洲=năm châu/toàn thế giới|ns
五洲四海=năm châu bốn biển/khắp nơi trên thế giới|ns
五湖=Ngũ Hồ|ns
五绝=ngũ tuyệt/thơ ngũ tuyệt/thơ bốn câu năm chữ|ns
五荒=ngũ hoang|ns
五角大楼=Lầu Năm Góc|ns
五陵=Ngũ Lăng|ns
五龙山=Ngũ Long Sơn|ns
井口=miệng giếng|ns
井水=nước giếng|ns
亚丁湾=vịnh Aden|ns
亚东=Á Đông|ns
亚伦=Yaren/Á Luân|ns
亚伯=Abe/A Bá|ns
亚兰=Á Lan/Aram|ns
亚兹=Yazid|ns
亚列=Ariel|ns
亚利桑那=Arizona/Á Lợi Tang Na|ns
亚加=Yaga/Á Gia|ns
亚历克=Alex/Alec|ns
亚历克斯=Alex|ns
亚历山大=Alexander|ns
亚历山德=Alexander|ns
亚历山德拉=Alexandra|ns
亚历山德罗=Elessandro|ns
亚圣=Á Thánh|ns
亚太地区=khu vực Châu Á - Thái Bình Dương|ns
亚山=Ashan|ns
亚平=Á Bình|ns
亚平宁=Apennine|ns
亚得里亚海=biển Adriatic|ns
亚德里亚=Adria|ns
亚拉巴马=Alabama/Á Lạp Ba Ma|ns
亚撒=Asa|ns
亚撒西=yasashii/Asaxi|ns
亚斯=Á Tư|ns
亚朗=Alan|ns
亚格=Á Cách|ns
亚欧=Á Âu|ns
亚沙=Yasha|ns
亚洲=Châu Á/Á Châu/Châu|ns
亚特兰=Atlan/Á Đặc Lan|ns
亚特兰大=Atlanta|ns
亚玛萨那度=Yamaxanadu|ns
亚的斯亚贝巴=Addis Ababa|ns
亚纳=Janne|ns
亚细亚=châu Á/Châu Á|ns
亚美=Á Mỹ/Á Mĩ|ns
亚美利加=America/Châu Mỹ|ns
亚美尼亚=Armenia|ns
亚萨=ASSA|ns
亚萨西=yasashii/Yassisi|ns
亚连=Á Liên|ns
亚都=Á Đô|ns
亚里亚=Aria|ns
亚里沙=Arisa|ns
亚非=Á Phi|ns
亚马孙河=sông Amazon|ns
亚马逊河=sông Amazon|ns
亚鲁=Yaru|ns
亚龙=á long|ns
亚龙湾=vịnh Á Long/Vịnh Yalong|ns
京中=trong kinh|ns
京内=trong kinh|ns
京城=kinh thành/kinh đô|ns
京州=Kinh Châu|ns
京巴=Pekingese|ns
京杭=Kinh Hàng|ns
京津=Kinh Tân/Bắc Kinh và Thiên Tân|ns
京白=kinh bạch|ns
京省=Kinh tỉnh|ns
京邑=Kinh ấp|ns
京都=kinh đô/kinh thành/Kinh Đô/Kyoto|ns
京里=trong kinh|ns
人山人海=người đông nghìn nghịt|ns
什刹海=Thập Sát Hải|ns
仁人义士=nhân nhân nghĩa sĩ/người đàn ông của tầm nhìn|ns
仁川=Incheon/thành phố đô thị Incheon ở tỉnh Gyeonggi 京畿 道 [Jing1 ji1 dao4], Hàn Quốc|ns
仙丹=tiên đan/tiên đơn/thuốc tiên/tiên dược|ns
仙云殿=Tiên Vân Điện|ns
仙兰=tiên lan|ns
仙国=tiên quốc|ns
仙宫=Tiên cung/Tiên Cung|ns
仙山=tiên sơn/Tiên Sơn|ns
仙岛=tiên đảo/Tiên đảo|ns
仙州=Tiên Châu|ns
仙河=tiên hà|ns
仙湖=tiên hồ|ns
仙灵池=Tiên Linh Trì|ns
仙福居=Tiên Phúc cư|ns
仙罗=Tiên La|ns
仙都=tiên đô|ns
仙雅=Tiên Nhã|ns
以安=dẹp an|ns
以色列=Israel|ns
仰角=góc ngắm chiều cao|ns
任断沧=Nhậm Đoạn Thương|ns
伊亚=Ea|ns
伊兰=Ilan/Ilhan|ns
伊内=trong đó|ns
伊利亚=Illya|ns
伊利斯=Elis|ns
伊南=Y Nam|ns
伊卡=Ica|ns
伊塞亚=Isiah|ns
伊巴=Hiba|ns
伊敦=Idun|ns
伊斯=Ess|ns
伊斯兰=Islam|ns
伊斯兰堡=Islamabad/Islamabat|ns
伊朗=Iran|ns
伊比利亚=Iberia|ns
伊沙=Isa|ns
伊犁=y lê/Y Cày|ns
伊犁河=sông Ili/Sông Ili ở Trung Á|ns
伊甸=Eden|ns
伊甸园=vườn địa đàng/cõi cực lạc/nơi tiên cảnh/chốn bồng lai|ns
伊索=Aesop|ns
伊苏=Issu|ns
伊萨=Iza|ns
伊蒙=y mông|ns
伊西=Isi|ns
伊西斯=Iset|ns
伊门=Imène|ns
伊顿=Eaton|ns
伏尔加格勒=Volgograd|ns
伏尔加河=sông Volga|ns
伏拜=phục bái|ns
伏牛山=Phục Ngưu sơn|ns
伏首=cúi đầu|ns
休宁=Hưu Ninh|ns
休斯敦=Houston|ns
休火山=núi lửa tạm ngưng hoạt động|ns
会宁=Hội Ninh|ns
会徽=tiêu chí/huy hiệu/biểu tượng/tượng trưng|ns
伦也=Tomoya|ns
伦克=Lenk|ns
伦墩=Luân Đôn|ns
伦巴=Rumba/Rum-ba/nhảy rum-ba/điệu rum-ba|ns
伦常=luân thường|ns
伦德=Lund|ns
伦敦=Luân Đôn|ns
伦敦市=thành phố London|ns
伦斯=Plens|ns
伦次=thứ tự/trình tự bài văn/mạch lạc|ns
伦比=sánh ngang/ngang hàng/lạ thường|ns
伦特=Lunt|ns
伦理=luân lý|ns
伦纳=Sensenbrenner|ns
伦蒂亚=Luân Đế Á|ns
伦西亚=Valencia|ns
伦达=Luân Đạt|ns
伪国=ngụy quốc|ns
伯南=Bá Nam|ns
伯南布哥=Pernambuco|ns
伯国=bá quốc|ns
伯牙=Bá Nha|ns
伯罗奔尼撒=Peloponnesian|ns
伶仃孤苦=linh đinh cô khổ/lênh đênh khổ sở|ns
伶姨=Linh di|ns
佐伯=Tá bá|ns
佐汉=Djohan|ns
佐治亚=Georgia/Georgia, tiểu bang Hoa Kỳ|ns
余沧海=Dư Thương Hải|ns
余脉=dư mạch|ns
佛典=kinh Phật/kinh điển Phật giáo|ns
佛国=Phật quốc|ns
佛山=Phật Sơn/thành phố cấp tỉnh Phật Sơn ở Quảng Đông|ns
佛州=phật châu|ns
佛得角=Cape Verde/Phật Đắc Giác|ns
佛海=phật hải|ns
佛牙=răng Phật|ns
佛罗伦=Fioren|ns
佛罗伦萨=Florence|ns
佛罗多=Frodo|ns
佛罗里达=Florida|ns
佛脚=chân phật|ns
佛蒙特=Vermont/Phật Mông Đặc|ns
佛藏=Phật tàng|ns
佛门=Phật môn/Phật giáo/cửa Phật/nhà Phật/|ns
佳丽=giai lệ/mỹ nữ/giai nhân/đẹp/mỹ nhân/người đẹp/người con gái dẹp|ns
佳县=Giai Huyện|ns
佳城=nghĩa trang/nghĩa địa/bãi tha ma|ns
佳木斯=Giai Mộc Tư|ns
佳瑶=Giai Ngọc|ns
依海=tựa vào biển|ns
俄中=Nga Trung|ns
俄亥俄=Ohio|ns
俄克拉何马=Oklahoma|ns
俄克拉荷马=Nga Khắc Lạp Hà Mã|ns
俄勒冈=Oregon/Origon|ns
俄勒冈州=bang Oregon/Oregon|ns
俄国=nước Nga/Nga quốc|ns
俄尔=một chút/Ore/Nga/xem 俄而 [e2 er2]|ns
俄浦=Russia|ns
俄狄浦斯=Oedipus|ns
俄罗斯=Nga/nước Nga/liên bang Nga/Russia/Nga La Tư/Nga Sô|ns
俄里翁=Orion|ns
保加利亚=Bulgaria/Bảo Gia Lợi Á|ns
保家卫国=bảo vệ quốc gia|ns
保山=người bảo lãnh/ông mai/bà mai/cò/người trung gian/người làm mối/người môi giới|ns
保罗三世=Paolo đệ III|ns
保鲜=giữ tươi|ns
信口开河=ăn nói lung tung/ăn nói ba hoa/tín khẩu khai hà/ăn nói ba hoa|ns
修罗场=Tu La tràng|ns
修齐治平=tu tề trị bình|ns
偃师=Yển Sư|ns
偃松=cây yển tùng|ns
儋州=Đam Châu|ns
光州=Quang Châu|ns
克兰=Clun|ns
克南=Kénan|ns
克律萨俄耳=Chrysaor|ns
克海=Khắc Hải|ns
克罗地亚=Croatia|ns
克西=ksi|ns
兖州=Duyện Châu|ns
入内门=vào nội môn|ns
入口=cửa vào/vào miệng/nhập khẩu/vào cửa/nhập cảng/cổng vào/vào miệng : lối vào|ns
入寺=vào chùa|ns
入庙=vào miếu|ns
入时=hợp thời/đúng lúc|ns
入春=vào xuân|ns
入格=nhập cách/hợp cách|ns
入梅=vào mùa mai vàng|ns
入海=vào biển/xuống biển|ns
入海口=cửa sông/cửa biển|ns
入港=nhập cảng/hợp nhau/tâm đầu ý hợp|ns
入都=nhập đô|ns
入门=nhập môn/vào cửa/mới vào nghề/mới học nghề/sơ đẳng/sơ cấp|ns
八嘎=baka/bát dát/baka (ngu ngốc)|ns
八达岭=bát đạt lĩnh/Bát Đạt Lĩnh/Badaling, một phần cụ thể của Vạn Lý Trường Thành là điểm du lịch yêu thích|ns
八连=đại đội tám/Đại đội 8|ns
八阪=Yasako|ns
六博=lục bác|ns
六哥=lục ca/Lục ca|ns
六城=sáu thành|ns
六本木=Roppongi|ns
六楼=lầu sáu|ns
六波=sáu làn sóng|ns
六甲=lục giáp/chữ để tập viết/phụ nữ có mang/phụ nữ có thai/bà bầu|ns
六耳=Lục Nhĩ|ns
六边=sáu cạnh|ns
六镇=lục trấn|ns
六阳=lục dương|ns
兰兰=Lan Lan|ns
兰利=Langley|ns
兰州=Lan Châu|ns
兰陀寺=Lan Đà tự|ns
兰陵=Lan Lăng|ns
共和国=nước cộng hoà/nước cộng hòa|ns
关东=Quan Đông/Kanto|ns
关兴=Quan Hưng|ns
关塔那摩=Guantanamo|ns
关塔那摩湾=Vịnh Guantanamo|ns
关山=quan ải/quan san|ns
关岛=đảo Guam|ns
关河=phòng ngự/phòng thủ|ns
关津=cửa khẩu/bến sông|ns
关联=liên quan/quan hệ/liên hệ|ns
关芝琳=Quan Chi Lâm|ns
关西=Quan Tây/Kansai|ns
关门大吉=đóng cửa|ns
兴云镇=trấn Hưng Vân|ns
兴华路=đường Hưng Hoa|ns
兴国=hưng quốc|ns
兴城=Hưng Thành|ns
兴安=Hưng Yên/tỉnh Hưng Yên|ns
兴旺=thịnh vượng/hưng thịnh/phồn thịnh/hưng vượng|ns
兴旺发达=hưng vượng phát đạt/thịnh vượng và phát triển/hưng thịnh|ns
兴海=Hưng Hải|ns
兴隆=thịnh vượng/may mắn/hưng thịnh|ns
兵库县=quận Hyōgo|ns
冀北=Ký Bắc|ns
冀州=Ký Châu|ns
内丹=nội đan|ns
内加尔=Nergal|ns
内华达=Nevada/Nội Hoa Đạt|ns
内华达州=tiểu bang Nevada/Nevada/Nevada, tiểu bang Hoa Kỳ|ns
内城=nội thành|ns
内尔=Nell/Nội Nhĩ|ns
内布拉斯加=Nebraska|ns
内河=nội hà/trong sông/dòng sông lục địa/dòng sông nội địa|ns
内海=nội hải/biển trong đất liền/biển lục địa/hải phận/vùng biển chủ quyền|ns
内湖=nội hồ|ns
内省=tự kiểm điểm trong lòng|ns
内蒙=Nội Mông|ns
内蒙古=Nội Mông Cổ/Nội Mông|ns
冈山=Okayama|ns
冈崎=Okazaki|ns
冈比亚=Gambia|ns
冈陵=gò đồi|ns
冰坨=tảng băng/đóng băng|ns
冰城=Băng Thành|ns
冰封=băng phong/đóng băng|ns
冰山=băng sơn/núi băng/chỗ dựa mỏng manh/chỗ nương tựa không thể nhờ cậy lâu dài được|ns
冰岛=Iceland/Băng Đảo/Ai-xơ-len/băng đảo|ns
冰川=sông băng/băng hà/băng xuyên|ns
冰河=sông băng/băng hà/Băng Hà|ns
冰海=băng hải|ns
冰湖=băng hồ/hồ băng|ns
冲克=xúc phạm|ns
冲阳=Trùng Dương|ns
准噶尔=Junggar|ns
准噶尔盆地=bồn địa Junggar|ns
凉山=lương sơn|ns
凉州=Lương Châu|ns
凉开水=nước đun sôi để nguội|ns
凉白开=nước sôi để nguội|ns
凌国=lăng quốc|ns
凌城=Lăng thành|ns
几内亚=Guinea/Ghine|ns
几匹马=mấy thớt ngựa|ns
几只羊=mấy con dê|ns
几希=ít/ít ỏi/không nhiều|ns
几省=vài/mấy tỉnh|ns
几米远=xa mấy mét|ns
凡尔赛宫=cung điện Versailles|ns
凤凰山=Phượng Hoàng Sơn|ns
凤凰岭=Phượng Hoàng Lĩnh|ns
凤尾=đuôi phượng|ns
凤阳=Phượng Dương|ns
凭陵=xâm phạm/mượn cớ/vin cớ|ns
列国=liệt quốc/các nước|ns
列岛=quần đảo/các đảo|ns
列支敦士登=Liechtenstein|ns
刚克=Cương Khắc|ns
刚州=vừa mới|ns
利亚=Lợi Á|ns
利兹联=Leeds United|ns
利利索索=lợi lợi tác tác|ns
利国=lợi quốc|ns
利川=Lợi Xuyên|ns
利州=Lợi châu|ns
利比亚=Li-bi|ns
利比里亚=Liberia/Lợi Bỉ Lý Á|ns
利牙=răng sắc|ns
利物浦=Liverpool|ns
利物浦港=cảng Liverpool|ns
刺秦=giết Tần|ns
剑丹=Kiếm Đan|ns
剑云=kiếm vân|ns
剑伯=Kiếm bá|ns
剑兰=Kiếm Lan|ns
剑圣=Kiếm Thánh|ns
剑山=kiếm sơn|ns
剑峰=Kiếm Phong|ns
剑州=Kiếm Châu|ns
剑庐=Kiếm Lư|ns
剑明=kiếm minh|ns
剑树=kiếm thụ|ns
剑桥=Cambridge|ns
剑水=Kiếm Thủy|ns
剑河=kiếm hà|ns
剑河罗=Kiếm Hà La|ns
剑海=kiếm hải|ns
剑湖宫=Kiếm Hồ Cung/cung Kiếm Hồ|ns
剑灵=kiếm linh|ns
剑眉=mày kiếm/lông mày lưỡi mác|ns
剑翔=Kiếm Tường|ns
剑花宫=Kiếm Hoa cung|ns
剑里=trong kiếm|ns
剑阁=Kiếm Các|ns
剑霞=kiếm hà|ns
剑龙=Kiếm Long|ns
加亚=Goa|ns
加仑=gallon|ns
加伦=Galen|ns
加兰=Galen|ns
加内特=Garnett|ns
加利亚=Gia Lợi Á|ns
加利亚尼=Galliani|ns
加利利=Galilee/Ga-li-lê|ns
加利福尼亚=California|ns
加利福尼亚州=bang California|ns
加利西亚=José María|ns
加勒比海=biển Ca-ri-bê|ns
加大力度=tăng lớn cường độ|ns
加宾=Gabin|ns
加密=mã hóa/mã hoá/làm chặt hơn/gia mật|ns
加尔各答=Calcutta/Gia Nhĩ Cáp|ns
加州=California|ns
加德满都=Katmandu/Gia Đức Mãn|ns
加拉加斯=Caracas/Gia Lạp Tư|ns
加拉斯=Gia Lạp Tư|ns
加拿大=Canada|ns
加斯=Gass/Garth|ns
加普亚=Gapua|ns
加朗=gia lãng|ns
加比列=Gia Bỉ Liệt|ns
加泰罗尼亚=Catalonia|ns
加盟=gia nhập liên minh|ns
加蓬=Ga-bông/Gabon/Gabông|ns
加西亚=Garcia/Gia Tây Á/García|ns
加里=Gally|ns
加里曼丹=Kalimantan/Gia Lý Mạn Đan|ns
加门=Gia Môn|ns
加雅=Kaya|ns
努努嘴=bĩu bĩu môi|ns
努嘴=bĩu môi/giảo mồm|ns
勃兰登堡=Brandenburg|ns
勃海=Bột Hải|ns
勐龙=mãnh long|ns
匈牙利=Hungary|ns
北京=Bắc Kinh|ns
北京城=thành Bắc Kinh|ns
北仓=Bắc Thương|ns
北关=Bắc quan/cổng bắc/cửa bắc|ns
北冰洋=Bắc Băng Dương|ns
北区=Bắc khu|ns
北半球=Bắc bán cầu|ns
北卡罗来纳=North Carolina/Bắc Tạp Lai Nạp|ns
北原=Bắc Nguyên|ns
北口=cửa bắc|ns
北国=Bắc quốc|ns
北城=thành Bắc|ns
北堂=Bắc Đường|ns
北大荒=vùng hoang dã phương Bắc|ns
北大西洋=Bắc Đại Tây Dương|ns
北宁=Bắc Ninh/tỉnh Bắc Ninh|ns
北宫=Bắc Cung|ns
北山=Bắc Sơn|ns
北岩=Bắc Nham|ns
北岳=Bắc Nhạc|ns
北崖=bắc nhai|ns
北川=Bắc Xuyên|ns
北州=Bắc Châu|ns
北平=Bắc Bình|ns
北广场=quảng trường phía Bắc|ns
北庄=Bắc Trang|ns
北庭=Bắc Đình|ns
北曲=Bắc khúc/khúc điệu phương Bắc/hí khúc . Xem thêm Tạp kịch|ns
北朝鲜=Bắc Triều Tiên|ns
北极=Bắc Cực|ns
北极光=Bắc Cực quang|ns
北极海=Bắc Cực hải|ns
北欧=Bắc Âu|ns
北江=Bắc Giang|ns
北河=Bắc Hà|ns
北洋=Bắc Dương|ns
北洲=Bắc châu|ns
北海=Bắc Hải/bắc hải/|ns
北海道=Hokkaido|ns
北港=Bắc cảng|ns
北湾=Bắc vịnh|ns
北瓜=bí đỏ/bí ngô/bí rợ|ns
北疆=Bắc Cương|ns
北白川=Kitashirakawa|ns
北直隶=Bắc Trực Lệ|ns
北省=Bắc Tỉnh|ns
北约=NATO|ns
北美=Bắc Mĩ|ns
北美洲=châu Bắc Mĩ|ns
北苍=Bắc Thương|ns
北荒=Bắc Hoang|ns
北街=Bắc nhai/phố Bắc|ns
北角=góc bắc|ns
北越=Bắc Việt|ns
北路=bắc lộ|ns
北辽=Bắc Liêu/Tên một tỉnh ở miền Nam phần Việt Nam. Ta quen gọi là Bạc Liêu.|ns
北达科他=North Dakota|ns
北连=bắc liên|ns
北郊=bắc ngoại ô/vùng ngoại ô phía bắc/Khu ngoài thành phía bắc.Lễ tế đất/do nhà vua đứng tế.|ns
北都=Bắc đô|ns
北门=Bắc môn/cửa Bắc|ns
北陵=Bắc Lăng|ns
北非=Bắc Phi|ns
北韩=Bắc Hàn|ns
北风=gió bấc/gió Bắc/gió bắc/gió bấc|ns
北齐=Bắc Tề|ns
匹兹堡=Pittsburgh/Thất Tư Bảo|ns
匹夫=thất phu/người bình thường/dân thường/người vô học/bọn thất phu|ns
匹萨=Pizza|ns
十宫=thập cung|ns
千代田区=khu Chiyoda|ns
千古=thiên cổ/nghìn đời/nghìn xưa|ns
千山=thiên sơn|ns
千岛=thiên đảo|ns
千岛湖=hồ Ngàn Đảo|ns
千里路=ngàn dặm đường/nghìn dặm đường|ns
千里马=thiên lý mã/tuấn mã|ns
午休=nghỉ trưa|ns
午安=chào buổi trưa/buổi trưa hảo/chàng buổi chiều/Chao buổi chiêu!|ns
午门=Ngọ môn|ns
半半拉拉=dở dang/nửa chừng/chưa hết/chưa xong/chưa hoàn thành/chưa hoàn chỉnh|ns
半壁江山=nửa giang sơn/nửa giang san/một nửa giang sơn|ns
半封建=nửa phong kiến|ns
半山=lưng chừng núi/sườn dốc/sườn núi|ns
华东=Hoa Đông|ns
华中=Hoa Trung/hoa trung|ns
华兹华斯=Wordsworth|ns
华北=Hoa Bắc|ns
华北平原=đồng bằng Hoa Bắc|ns
华南=Hoa Nam|ns
华园=hoa viên|ns
华国=Hoa quốc/nước Hoa/Hoa Quốc|ns
华城=Hoa Thành/hoa thành|ns
华夏=Hoa Hạ|ns
华威=Hoa Uy|ns
华尔街=Phố Wall|ns
华屋=nhà đẹp/nhà tráng lệ/phòng lộng lẫy|ns
华山=Hoa Sơn|ns
华昌=Hoa Xương|ns
华氏温度=độ F/độ Fahrenheit|ns
华沙=Warsaw|ns
华海=biển hoa|ns
华盛顿=Washington|ns
华纳=Warner|ns
华联=Hoa Liên|ns
华西=Hoa Tây|ns
华里=hoa lý/dặm Trung Quốc|ns
华阳=Hoa Dương|ns
华阴=Hoa Âm|ns
华陀=Hoa Đà|ns
卑尔根=Bergen|ns
卑斯=Beis|ns
南丁格尔=Nightingale|ns
南中国海=biển nam Trung Quốc/Biển Đông|ns
南丰=Nam Phong|ns
南临=Nam Lâm|ns
南亚=Nam Á|ns
南京=Nam Kinh|ns
南京城=thành Nam Kinh|ns
南充=Nam Sung/thành phố cấp tỉnh Nanchong ở Tứ Xuyên|ns
南兰=Nam Lan|ns
南关=Nam Quan|ns
南加=nam gia|ns
南加州=châu Nam Mỹ/Miền Nam California|ns
南北=nam bắc/từ nam đến bắc/chiều dọc/từ nam chí bắc|ns
南北极=Nam Bắc Cực|ns
南半球=nam bán cầu|ns
南卡=Nam Tạp|ns
南卡罗来纳=South Carolina/Nam Tạp Lai Nạp|ns
南口=cửa nam/southgate|ns
南国=nam quốc/miền nam|ns
南坛=Nam Đàn|ns
南城=Nam Thành|ns
南多=Nando|ns
南太平洋=Nam Thái Bình Dương|ns
南夷=Nam Di|ns
南奥塞梯=Nam Ossetia|ns
南宁=Nam Ninh|ns
南安普敦=Southampton/Southampton, thị trấn ở miền nam nước Anh|ns
南安普顿=Southampton|ns
南定=Nam Định/tỉnh Nam Định|ns
南宫=Nam Cung|ns
南山=nam sơn|ns
南山寺=Nam Sơn tự|ns
南岗=Nam Cương|ns
南岭=Nam Lĩnh|ns
南岳=Nam Nhạc|ns
南峰=Nam Phong|ns
南川=Nam Xuyên/Quận Nanchuan của vùng ngoại ô Fuling của đô thị Trùng Khánh, trước đây thuộc Tứ Xuyên|ns
南州=Nam Châu|ns
南平=Nam Bình|ns
南府=Nam phủ|ns
南康=Nam Khang|ns
南开=Nam Khai|ns
南斯=Nance|ns
南昌=Nam Xương|ns
南明=Nam Minh|ns
南曲=Nam Khúc|ns
南极=Nam Cực|ns
南极洲=Châu Nam Cực|ns
南林=Nam Lâm|ns
南梁=Nam Lương|ns
南欧=Nam Âu|ns
南汉=Nam Hán|ns
南江=Nam Giang|ns
南沙=Trường sa|ns
南沙群岛=quần đảo Trường sa|ns
南河=Nam Hà|ns
南泥湾=Nam Nê Loan/Nanniwan|ns
南洋=Nam Dương|ns
南洲=Nam Châu|ns
南浩街=Nam Hạo nhai|ns
南海=Nam Hải|ns
南渡=Nam Độ|ns
南港=Nam cảng|ns
南湖=Nam Hồ|ns
南溪=nam khê|ns
南瓜=bí đỏ/bí rợ/bí ngô/quả bí đỏ/trái bí rợ|ns
南疆=Nam Cương|ns
南直隶=Nam Trực Lệ|ns
南省=Nam tỉnh|ns
南竹=tre|ns
南粤=Nam Việt|ns
南美=Nam Mĩ|ns
南美洲=châu Nam Mĩ|ns
南翔=Nam Tường|ns
南苑=Nam Uyển|ns
南荒=Nam Hoang|ns
南街=Nam nhai/phố Nam|ns
南西=Nancy|ns
南越=Nam Việt/nam Việt|ns
南越国=Nam Việt quốc|ns
南路=nam lộ|ns
南达科他=South Dakota/Nam Dakota, tiểu bang Hoa Kỳ|ns
南郊=Nam Giao|ns
南郑=Nam Trịnh|ns
南都=Nam đô/nam đô|ns
南锡=nam tích|ns
南门=Nam môn/cửa Nam|ns
南阳=Nam Dương|ns
南院=Nam Viện|ns
南陵=Nam Lăng|ns
南雄=Nam Hùng|ns
南非=Nam Phi|ns
南齐=Nam Tề|ns
博古=bác cổ/Bác Cổ/thông hiểu việc xưa/vẽ bác cổ/cách vẽ lấy đồ cổ làm đề tài|ns
博斯腾湖=Bác Tư Đằng Hồ|ns
博洛尼亚=Bologna|ns
卡亚=Tạp Á|ns
卡利亚=Qalya|ns
卡口=khe gắn|ns
卡哇伊=kawaii/kute|ns
卡哇依=kawaii|ns
卡地亚=Cartier|ns
卡塔尼亚=Catania/Catania, Sicily|ns
卡戴珊=Kardashian|ns
卡欧=Caio|ns
卡累利阿=Kareliya/Karelian|ns
卡约=Tạp Ước|ns
卡西亚=Garcia/Carcia|ns
卡西欧=Casio|ns
卡门=Carmen|ns
卢瓦尔河=sông Loire/Sông Loire, Pháp|ns
卢甘斯克=Luhansk|ns
卧佛=Phật nằm|ns
卧虎藏龙=ngọa hổ tàng long/đầm rồng hang hổ|ns
卧龙=Ngọa Long|ns
卧龙岗=Ngọa Long cương|ns
卫国=vệ quốc/Vệ quốc|ns
印加=Inca|ns
印加帝国=đế quốc Inca|ns
印台=hộp mực đóng dấu|ns
印地安=Indian|ns
印堂=ấn đường|ns
印堂发黑=ấn đường biến đen/ấn đường phát đen|ns
印尼=Indonesia|ns
印山=Ấn Sơn|ns
印巴=Ấn Độ - Pakistan/Inba/Ấn Độ và Pakistan|ns
印度=Ấn Độ|ns
印度尼西亚=Indonesia|ns
印度支那=Indochina/Đông Dương|ns
印度洋=Ấn Độ Dương|ns
印张=ấn trương/trang in|ns
印本=sách in|ns
印欧=Ấn Âu|ns
印第安=Anh Điêng/Indian/Ấn Độ|ns
印第安纳=Indiana|ns
印第安纳州=bang Indiana/Indiana, tiểu bang Hoa Kỳ|ns
印第安纳波利斯=Indianapolis/Indianapolis, Indiana|ns
印青=Ấn Thanh|ns
印鼻=núm triện/núm con dấu|ns
危地马拉=Guatemala|ns
即将来临=sắp xảy ra/lại sắp tới|ns
厄休拉=Ursula|ns
厄俄斯=Eos|ns
厄立特里亚=Eritrea/Lập Đặc Lý Á|ns
原班人马=nguyên ban nhân mã/lực lượng có sẵn|ns
厦门=Hạ Môn|ns
厦门市=Hạ Môn thành phố|ns
发乾=phát khô|ns
叙利亚=Syria/Xyri|ns
叙旧=ôn chuyện/nói chuyện cũ/nói về kỷ niệm xưa/tự cựu|ns
叠岭=núi non trùng điệp|ns
叠罗汉=xếp chồng người/chồng người|ns
口乾=miệng khô|ns
古典=cổ điển/điển cố/điển tích|ns
古国=cổ quốc/quốc gia cổ/nước có lịch sử lâu đời|ns
古埃及=Cổ Ai Cập|ns
古城=cổ thành/thành cổ|ns
古城区=khu cổ thành|ns
古城堡=cổ thành bảo|ns
古堡=cổ bảo/lâu đài cổ/pháo đài cổ kính/pháo đài cổ|ns
古寺=chùa cổ|ns
古山=núi cổ|ns
古川=cổ xuyên|ns
古巴=Cu Ba/Cuba|ns
古巴比伦=cổ Babylon|ns
古希腊=Hy Lạp cổ đại|ns
古庙=miếu cổ/cổ miếu|ns
古本=cổ bản|ns
古根海姆=Guggenheim|ns
古河=Cổ Hà|ns
古罗马=thời La Mã cổ đại|ns
古董店=tiệm đồ cổ|ns
古藏=cổ tàng|ns
古街=cổ nhai|ns
古都=cố đô/kinh đô cũ|ns
古镇=cổ trấn|ns
台上台下=trên đài dưới đài|ns
台东=Thai Đông|ns
台东区=khu Taitō|ns
台北=Đài Bắc|ns
台南=Đài Nam|ns
台地=cao nguyên/bãi đất cao/vùng cao nguyên|ns
台城=Đài Thành|ns
台子上=trên bàn/trên đài|ns
台州市=Đài Châu thị|ns
台布=khăn bàn/khăn trải bàn|ns
台平=khu vực nền tảng|ns
台徽=biểu tượng|ns
台新=máy mới|ns
台港=thai cảng|ns
台湾=Đài Loan|ns
台站=Ðài điếm/đồn canh gác ngoài biên thùy|ns
台风=bão/thai phong|ns
右联=liễn phải|ns
右都=hữu đô|ns
叶县=Diệp Huyện|ns
叶尼塞河=sông Enisei/sông Yenise|ns
各奔东西=đường ai nấy đi/ai đi đường nấy|ns
合众国=hợp chủng quốc|ns
合浦=Hợp Phổ|ns
合邑=hợp ấp/cả ấp|ns
合龙=hợp long/nối lại/nối liền lại|ns
吉亚=Gea|ns
吉他=ghita|ns
吉兰=Guilhem/Kylan|ns
吉利=may mắn/Cát Lợi/thuận lợi/êm xuôi/cát lợi|ns
吉安=Jihane|ns
吉尔加美什=Gilgamesh|ns
吉山=Cát Sơn|ns
吉川=Cát Xuyên|ns
吉庆=may mắn/cát tường|ns
吉时=giờ lành/ngày lành tháng tốt|ns
吉昌=cát xương|ns
吉林=Cát Lâm|ns
吉林省=tỉnh Cát Lâm|ns
吉欧=Cát Âu|ns
吉水=Cát Thủy|ns
吉萨=Giza|ns
吉蒙里=Gremory|ns
吊古=thăm danh lam thắng cảnh/viếng di tích|ns
吊威亚=treo dây|ns
同庆=cùng chúc mừng|ns
同盟国=nước đồng minh/các nước đồng minh/khối đồng minh|ns
名山大川=danh sơn đại xuyên|ns
后山=phía sau núi|ns
后黎=Hậu Lê|ns
吐丝=nhả tơ/phun tơ|ns
吐口=nói ra|ns
吐地=thổ địa|ns
吐故纳新=bỏ cũ lấy mới/bỏ xấu lấy tốt|ns
吐气扬眉=thổ khí dương mi/bật hơi nhướng mày|ns
吐泡=phun bọt|ns
吐纳=thổ nạp|ns
吐舌头=le lưỡi/le lưởi/le đầu lưỡi|ns
吐苦水=tố khổ/nhổ nước đắng/phàn nàn một cách cay đắng|ns
吐蕃=Thổ Phiên|ns
吐鲁番=Thổ Lỗ Phiên/thành phố Turpan ở Tân Cương|ns
向北=hướng bắc|ns
吕海=Lữ Hải|ns
君临=quân lâm|ns
君主国=nước quân chủ/nước có vua|ns
君国=quân quốc|ns
君子国=nước quân tử|ns
君山=Quân Sơn|ns
启东=Khải Đông|ns
启亚=Khải Á|ns
吴县=Ngô Huyện/Hạt Wu ở Giang Tô|ns
吴国=Ngô quốc|ns
呼伦贝尔草原=thảo nguyên Hô Luân Bối Nhĩ|ns
呼和浩特=Hồi Hột|ns
呼罗珊=Khorasan|ns
和平岛=Hòa Bình đảo|ns
和氏璧=Hòa Thị Bích/Hoà Thị Bích|ns
咸丰=Hàm Phong|ns
咸水=nước mặn/nước muối|ns
咸水湖=hồ nước mặn|ns
咸津津=hơi mặn/mằn mặn|ns
咸海=biển Aral|ns
咸阳=Hàm Dương|ns
哈亚=Cáp Á|ns
哈伯=Harper|ns
哈兰=Halaa|ns
哈利=Harry|ns
哈尔滨=Cáp Nhĩ Tân|ns
哈根=Hagen|ns
哥亚=Goa|ns
哥伦布=Columbus|ns
哥伦比亚=Colombia|ns
哥哥=ca ca/anh/anh trai/anh họ|ns
哥尔=Gol|ns
哥布伦=goblin|ns
哥德=Gogh|ns
哥德堡=Göteborg/Gothenburg|ns
哥斯拉=Godzilla|ns
哥斯达黎加=Costa Rica/Costarica|ns
哥本哈根=Copenhagen|ns
哥特=Gothic|ns
哥萨克=Cossack/Ca Tát Khắc|ns
唐古拉山=Đường Cổ Lạp Sơn/Tanglha|ns
唐国=Đường Quốc|ns
唐山市=Đường Sơn thị|ns
商城=thương thành|ns
商州=Thương Châu|ns
商海=Thương Hải|ns
商港=thương cảng|ns
商都=thương đô|ns
喀丝丽=Kha Tư Lệ|ns
喀兹=Kazi|ns
喀喀=rắc rắc/khách khách/tiếng nôn ọe|ns
喀喇汗=Ca Lạt Hãn|ns
喀喇汗国=Khách Lạt Hãn quốc|ns
喀土穆=Khartoum/Khách Thổ Mục|ns
喀山=Kazan|ns
喀布尔=Kabul/Khách Bố Nhĩ|ns
喀拉=răng rắc|ns
喀斯特=Cast|ns
喀麦隆=Cameroon/Camerun|ns
喜乐=hỉ nhạc/vui vẻ|ns
喜大普奔=khắp chốn mừng vui/vui vẻ chạy/ly kỳ đến nỗi mọi người đều vui mừng và lan truyền từ này|ns
喜孜孜=vui mừng/hỉ tư tư|ns
喜宁=Hỉ Ninh|ns
喜庆=vui mừng/ăn mừng/việc đáng mừng vui|ns
喜洋洋=hớn hở/niềm vui tràn ngập/niềm vui tràn trề|ns
喜玛拉雅=Himalaya|ns
喜联=câu đối đám cưới|ns
喜脉=hỉ mạch|ns
喜马拉雅=Himalaya|ns
喜马拉雅山=Himalaya|ns
喜马拉雅山脉=dãy Himalaya/Himalayas|ns
喝口水=uống miếng nước/uống ngụm nước|ns
喝墨水=đi học/học hành/học|ns
喝西北风=uống gió tây bắc/ăn không khí/nhịn đói/không có gì ăn/cóc có gì ăn/hát tây bắc phong|ns
嘉利顿=Garriton|ns
嘉定=Gia Định|ns
嘉宾=khách quý/gia tân|ns
嘉峪关=Gia Dự quan|ns
嘉庆=Gia Khánh|ns
噶厦=ca-xi-a/caxia|ns
四中=Tứ Trung|ns
四乡=làng xã chung quanh/làng xã xung quanh|ns
四伯=Tứ bá|ns
四哥=tứ ca/Tứ ca|ns
四坪=tứ bình|ns
四壁=bốn vách tường/bốn bức tường/bốn vách|ns
四夷=tứ di|ns
四姑娘山=núi Tứ Cô Nương/Núi Tứ Cô Nương|ns
四季海棠=hải đường bốn mùa|ns
四岳=Tứ Nhạc|ns
四川=Tứ Xuyên|ns
四明=Tứ Minh|ns
四本=bốn bản/bốn bản|ns
四极=Tứ Cực|ns
四桥=Tứ Kiều|ns
四楼=lầu bốn/bốn lầu|ns
四海=tứ hải/bốn biển/khắp nơi|ns
四灵根=tứ linh căn|ns
四环=tứ hoàn|ns
四绝=tứ tuyệt|ns
四荒=Tứ Hoang|ns
四营=Tứ doanh|ns
四郊=ngoại thành/ngoại ô|ns
四野=khắp nơi/đồng ruộng mênh mông|ns
四门=bốn môn/tứ môn/bốn cửa|ns
回京=hồi kinh/về kinh|ns
回国=về nước/trở về nước|ns
回城=về thành/trở về thành|ns
回疆=Hồi Cương|ns
回鹘=Hồi Hột|ns
团徽=đoàn huy|ns
团拜=họp mặt chúc tết|ns
固山=Cố Sơn|ns
图林根=Thüringen|ns
图江=Đồ Giang|ns
圆柏=tùng sà/Viên Bách|ns
圆藏山=núi Enzou|ns
圈中=trong vòng|ns
土中=trong đất|ns
土地庙=thổ địa miếu|ns
土坡=sườn đất|ns
土城=thổ thành|ns
土屯=đất dấp|ns
土山=thổ sơn|ns
土库曼=Thổ Khố Mạn (Turkmenistan)|ns
土库曼斯坦=Turkmenistan/Thố Khố Mạn Tư|ns
土沟=khe đất|ns
土灵根=thổ linh căn|ns
土耳其=Thổ Nhĩ Kỳ|ns
圣丹=thánh đan/Thánh Đan|ns
圣伯纳=Saint-Bernard|ns
圣典=Thánh Điển/thánh điển|ns
圣卢西亚=St. Lucia|ns
圣地亚哥=Santiago|ns
圣城=Thánh thành|ns
圣塔伦=Santarém|ns
圣安东尼奥=St.Antonio|ns
圣安德烈=Saint-André|ns
圣山=Thánh Sơn|ns
圣庙=thánh miếu/miếu Khổng Tử|ns
圣彼得堡=St. Petersburg|ns
圣日耳曼=Saint-Germain|ns
圣明=thánh minh/sáng suốt như thánh|ns
圣汀岛=đảo Sandy|ns
圣河=thánh hà/Thánh hà|ns
圣煌=Thánh Hoàng|ns
圣玛丽亚=St. Maria|ns
圣玛利亚=Santa Maria|ns
圣约=thánh ước|ns
圣罗兰=Saint Laurent|ns
圣赫勒拿岛=Saint Helena/Thánh Hắc Lạp|ns
圣雄甘地=Mahatma Gandhi|ns
圪垯=mụn cơm/gò đất nhỏ|ns
圪蹴=ngồi xổm/ngồi chồm hổm|ns
圭亚那=Guyana/Khuê Á Na|ns
圭多=Guido|ns
圭角=tài cán/tài năng/dấu tích/dấu vết|ns
地中海=Địa Trung Hải|ns
地兰=địa lan|ns
地北天南=địa bắc thiên nam|ns
均阳=Quân Dương|ns
坎儿井=giếng ngầm/giếng thông|ns
坎宁安=Cunningham|ns
坎瑞亚=Khaenri'ah|ns
坤元=khôn nguyên|ns
坤哥=Khôn ca|ns
坤宁宫=Khôn Ninh cung|ns
坤宁门=Khôn Ninh môn|ns
坤宫=Khôn cung|ns
坤州=Khôn Châu|ns
坤沙=Khôn Sa|ns
坤造=khôn tạo/đàng gái/nhà gái|ns
坦桑尼亚=Tanzania|ns
坦纳=Thản Nạp|ns
坦纳斯=Thản Nạp Tư|ns
坪地=bình địa|ns
坪坝=đất đai bằng phẳng/bãi phẳng|ns
垦区=khu khai khẩn/vùng khai hoang|ns
埃克=Ecker/Ecques|ns
埃兰=Elan|ns
埃利=Eli|ns
埃利斯=Elis|ns
埃匹兹=Ai Thất Tư|ns
埃及=Ai Cập|ns
埃塞俄比亚=Ethiopia|ns
埃尔加=Elgar|ns
埃尔南=Hernan|ns
埃尔南德斯=Hernandez/Hernández|ns
埃斯=Ace|ns
埃罗斯=Eros|ns
埃蒙=Eamon|ns
埃贡=Egon|ns
埃达=Edda|ns
埃里=Ai Lý|ns
城东=thành đông/Thành Đông|ns
城中城=thành trong thành|ns
城中村=Thành trung thôn|ns
城关=thành quan/vùng sát cổng thành/ven thành|ns
城关镇=Thành Quan trấn/Thành quan trấn|ns
城南=thành nam|ns
城垣=tường thành/thành luỹ|ns
城堡=tòa thành/thành nhỏ/thành luỹ/pháo đài/thành bảo|ns
城寨=thành trại|ns
城市=thành thị/đô thị/thành phố|ns
城建=xây thành/xây dựng thành phố/thành kiến|ns
城根=vùng ven/ven thành/chân thành/sát tường thành|ns
城西=thành tây/Thành Tây|ns
城邑=thành thị/thành ấp|ns
城镇=thành trấn/thành phố và thị trấn|ns
城门口=cửa thành|ns
城隍=Thành Hoàng/hào/hào quanh thành/thành hào|ns
城隍庙=miếu Thành Hoàng|ns
堪培拉=Canberra/Kham Bối Lạp|ns
堪察加=Kamchatka|ns
堪舆=phong thuỷ/kham dư|ns
堪舆家=nhà phong thủy|ns
堪萨斯=Kansas/Kham Tát Tư|ns
堪萨斯州=bang Kansas/Kansas, tiểu bang Hoa Kỳ|ns
堪虞=đáng lo/bấp bênh|ns
堰塞湖=đập nước|ns
塔克拉玛干=Takla Makan|ns
塔利亚=Talia|ns
塔南=Tarnum|ns
塔台=đài quan sát/tháp quan sát/tháp chỉ huy/tháp thai|ns
塔外=ngoài tháp|ns
塔多城=thành Tháp Đa|ns
塔多湖=hồ Tháp Đa|ns
塔尼亚=Tania|ns
塔拉哈西=Tallahassee/Tháp Lạp Cáp Tây|ns
塔斯马尼亚=Tasmania|ns
塔林=tháp lâm/Ta-lin/Tallinn|ns
塔楼=tháp lâu/toà nhà hình tháp/nhà hình tháp/toà tháp/tháp nhỏ/lầu tháp|ns
塔沟=Tháp Câu|ns
塔门=cửa tháp|ns
塔顶=đỉnh tháp|ns
塞亚=Isaiah|ns
塞内加尔=Senegal/Tắc Nội Gia Nhĩ|ns
塞利=Tắc Lợi|ns
塞北=tái bắc|ns
塞堡=Seribian|ns
塞拉利昂=Sierra Leona/Tắc Lạp Lợi Ngang|ns
塞浦=Cyprus|ns
塞浦路斯=Cyprus/Tắc Phổ Lộ Tư|ns
塞牙=tê răng|ns
塞班岛=Tắc Ban Đảo|ns
塞纳河=sông Seine/sông Tắc Nạp|ns
塞维利亚=Tắc Lợi Duy Á|ns
塞舌尔=Seychelles|ns
塞车=kẹt xe|ns
墨城=Mặc Thành|ns
墨尔本=Melbourne|ns
墨山=Mặc Sơn|ns
墨岭=Mặc Lĩnh|ns
墨水=mực nước/mực lọ/mực chai/mực viết/học hành/trí thức/học vấn/có kiến thức/mực|ns
墨江=Mặc Giang|ns
墨海=Mặc Hải|ns
墨田区=khu Sumida|ns
墨西=Mặc Tây|ns
墨西哥=Mexico|ns
墨西哥城=thành phố Mexico|ns
墨西哥湾=vịnh Mexico/Vịnh Mexico|ns
墨阳=Mặc Dương|ns
墨黑=đen như mực/mực đen|ns
壶中天地=cuộc sống thần tiên/trời đất trong bình|ns
壶中日月=cuộc sống thần tiên/bình trung nhật nguyệt|ns
壶井=Tsuboi|ns
壶内=trong bầu|ns
壶嘴=hồ nước/miệng bình/miệng ấm|ns
壶底=đáy hũ|ns
壶水=nước trong bầu/ấm nước|ns
壶盖=nắp ấm|ns
壶里=trong ấm/trong bầu|ns
复国=phục quốc|ns
夏侯惇=Hạ Hầu Đôn|ns
夏国=Hạ quốc|ns
夏威夷岛=đảo Hawaii|ns
夏州=Hạ Châu|ns
夔龙=Quỳ Long|ns
夕阳=trời chiều/mặt trời chiều/ánh tà/tà dương/nắng chiều|ns
夕阳西下=mặt trời chiều ngã về tây|ns
外刚内柔=ngoài cứng trong mềm|ns
外县=huyện khác/ngoài huyện|ns
外国=ngoại quốc/nước ngoài|ns
外弛内张=ngoại chùng nội căng|ns
外番=ngoại phiên|ns
多利亚=Dolias|ns
多哥=Tô-gô/Togo/Tôgô|ns
多嘴=lắm miệng/lắm mồm/nhiều chuyện/nhiều lời/bép xép/bẻm mép/lắm lời|ns
多牟=Đa Mưu|ns
多瑙河=sông Đa Nuýp|ns
大不列颠=Great Britain|ns
大不里士=Tabriz/thành phố Tabriz ở tây bắc Iran, thủ đô của Đông Azerbaijan Iran|ns
大丘=gò đất lớn|ns
大丰县=huyện Đại Phong|ns
大京国=Đại Kinh Quốc|ns
大伯=Đại bá/đại bá/bác cả|ns
大公国=đại công quốc|ns
大关=đại quan/cửa ải lớn|ns
大兴土木=xây dựng rầm rộ|ns
大兴安岭=núi Đại Hưng An|ns
大冷=rét đậm|ns
大别山=Đại Biệt sơn|ns
大县=huyện lớn|ns
大吴=Đại Ngô|ns
大哥大=điện thoại di động/điện thoại cầm tay/mô-bai phôn|ns
大嘴巴=miệng rộng/miệng rộng/vả mồm|ns
大回环=đại hồi hoàn|ns
大国=đại quốc|ns
大圣=đại thánh/Đại Thánh|ns
大圭=đại khuê|ns
大地回春=đại địa hồi xuân/xuân về trên đất nước|ns
大坝=đập lớn/đập nước lớn/đập nước|ns
大城=thành lớn/đại thành|ns
大城市=thành phố lớn/thủ phủ/đại thành thị|ns
大城镇=đại thành trấn|ns
大堡=pháo đài lớn/Pháo đài Lớn|ns
大宁=Đại Ninh|ns
大安市=Đại An thị|ns
大寺=đại tự|ns
大屋里=trong phòng lớn|ns
大山=đại sơn/núi lớn|ns
大屿山=Đại Tự Sơn|ns
大岛=đại đảo|ns
大岳=núi lớn|ns
大川=đại xuyên/sông rộng|ns
大州=đại châu|ns
大巴山=Đại Ba sơn|ns
大庄园=đại trang viên|ns
大庆=đại khánh/quốc khánh/đại thọ/lễ mừng thọ|ns
大庾岭=dãy Đại Dữu/Dãy núi Dayu giữa tây nam Giang Tây và Quảng Đông|ns
大建=xây dựng/tháng đủ|ns
大拿=người có quyền/kẻ quyền thế/bậc đàn anh|ns
大昌=đang thịnh|ns
大月国=Đại Nguyệt quốc|ns
大桥=cầu lớn/đại kiều|ns
大槐树=cây hòe lớn/cây hoè lớn|ns
大汉=đại hán/người đàn ông vạm vỡ/con người cao lớn/Đại Hán|ns
大江=đại giang/sông lớn/Trường Giang|ns
大江南北=đại giang nam bắc|ns
大汶河=Đại Vấn Hà|ns
大河=sông lớn/Hoàng Hà|ns
大洋=đại dương/biển cả/bể/đồng bạc|ns
大洋彼岸=bên kia bờ đại dương|ns
大洋洲=Châu Đại Dương|ns
大洲=lục địa/đại lục/châu lục|ns
大海=biển cả/biển rộng/đại hải|ns
大清国=Đại Thanh quốc|ns
大港=cảng lớn|ns
大湖=hồ lớn|ns
大潭=đầm lớn|ns
大牙=răng hàm/răng cửa|ns
大石桥=cầu đá lớn|ns
大英博物馆=bảo tàng Anh/Bảo tàng Anh/Viện bảo tàng Anh|ns
大英帝国=đế quốc Anh|ns
大荆=Đại Kinh|ns
大藏=Đại Tàng/Loại kinh Phật, chép lời giảng của Phật.|ns
大藏省=Đại Tàng tỉnh|ns
大街=đường cái/phố lớn/phố phường/đường phố|ns
大西洋=Đại Tây Dương|ns
大辽=Đại Liêu|ns
大迦=Đại Già|ns
大都=phần lớn/đại đô/đa số/đại bộ phận|ns
大都城=đại đô thành|ns
大都市=thành phố lớn/đại đô thị|ns
大金国=Đại Kim Quốc|ns
大门口=cửa chính/cửa lớn|ns
大阪=Osaka|ns
大院里=trong đại viện|ns
大雅=phong nhã/thanh nhã/lịch sự|ns
大韩民国=Đại Hàn dân quốc/Hàn Quốc|ns
大饭店=khách sạn lớn|ns
大马=đại mã/con ngựa lớn/Malaysia|ns
大黑=đại hắc|ns
天乌=thiên ô|ns
天云山=Thiên Vân sơn|ns
天京=Thiên Kinh|ns
天人丹=Thiên Nhân Đan|ns
天伦=Thiên Luân/thiên luân/quan hệ cha con, anh em|ns
天伯=Thiên bá|ns
天兰=Thiên Lan|ns
天半=ngày rưỡi|ns
天南=Thiên Nam/trời nam|ns
天南地北=thiên nam địa bắc/BẮC/trời nam đất bắc/xa cách đôi nơi/Sâm Thương đôi nơi/đất trời cách biệt/nói chuyện huyên thuyên/chuyện phiếm/chuyện trên trời dưới đất|ns
天南海北=trời nam biển bắc|ns
天卢国=Thiên Lô Quốc|ns
天古=thiên cổ|ns
天台山=núi Thiên Đài|ns
天吴=Thiên Ngô|ns
天国=Thiên quốc/thiên quốc/Thiên Quốc/thiên đường/thế giới lý tưởng|ns
天圣=thiên thánh|ns
天城=thiên thành|ns
天大地大=trời đất bao la|ns
天威=thiên uy|ns
天宁寺=Thiên ninh tự|ns
天安门=Thiên An Môn|ns
天安门广场=quảng trường Thiên An Môn|ns
天定城=Thiên Định Thành|ns
天宫=Thiên Cung|ns
天山=Thiên Sơn|ns
天州=Thiên Châu|ns
天庆=Thiên Khánh|ns
天极=thiên cực/chân trời/Thiên Cực|ns
天桥=cầu vượt/cầu bắc qua đường/dụng cụ thể thao/thiên kiều/Thiên kiều|ns
天武国=Thiên Vũ Quốc|ns
天武门=Thiên Vũ Môn|ns
天江=Thiên Giang|ns
天池=thiên trì|ns
天沟=máng xối/máng nước/thiên câu|ns
天河=Thiên Hà|ns
天河路=đại lộ Thiên Hà|ns
天波=sóng trời/thiên ba/Thiên Ba|ns
天津=Thiên Tân|ns
天津市=Thiên tân thị|ns
天津桥=Thiên Tân Kiều|ns
天海=thiên hải/Thiên Hải|ns
天湖=Thiên Hồ|ns
天瀑山=Thiên Bộc Sơn|ns
天牢内=trong thiên lao|ns
天牢里=trong thiên lao|ns
天环=thiên hoàn|ns
天瑞岛=Thiên Thụy Đảo|ns
天疆=Thiên Cương|ns
天目山=Thiên Mục sơn|ns
天竺=Thiên Trúc|ns
天罗国=Thiên La quốc|ns
天芒岛=Thiên Mang Đảo|ns
天蓬=Thiên Bồng|ns
天那=thiên na|ns
天都峰=Thiên Đô Phong|ns
天门=Thiên môn/cửa thiên cung/cổng thiên đàng/cửa trời/cổng cung điện vua chúa/giữa trán/tâm|ns
天门山=Thiên Môn Sơn|ns
天风国=Thiên Phong Quốc|ns
天风城=Thiên Phong thành|ns
天香国=Thiên Hương quốc|ns
天马=thiên mã/Thiên Mã|ns
天高皇帝远=trời cao hoàng đế xa|ns
天鹅湖=Thiên Nga hồ|ns
天黑=trời tối/bầu trời tối đen|ns
天龙山=Thiên Long sơn|ns
太仓=thái thương|ns
太仓县=Thái Thương huyện|ns
太冷=quá lạnh|ns
太半=hơn phân nửa/quá nửa|ns
太华山=Thái Hoa Sơn/Thái hoa sơn|ns
太华门=Thái Hoa Môn|ns
太原=Thái Nguyên|ns
太古=Thái Cổ|ns
太吴=Thái Ngô|ns
太多大=có bao lớn|ns
太太平平=thái thái bình bình|ns
太嫩=quá non|ns
太安=thái an/Thái An|ns
太山=Thái Sơn|ns
太平=thái bình/BÌNH/bình yên/an ninh/Thái Bình/tỉnh Thái Bình|ns
太平天国=Thái Bình Thiên Quốc|ns
太平山=Thái bình sơn/quá Bình Sơn|ns
太平梯=thang|ns
太平洋=Thái Bình Dương|ns
太平盛世=thái bình thịnh thế/thanh bình/thái bình|ns
太平道=Thái Bình đạo|ns
太平镇=Thái Bình Trấn|ns
太平门=cửa bên/cửa ra vào|ns
太庙=thái miếu|ns
太旧=quá cũ kỹ|ns
太昌=Thái Xương|ns
太极=Thái Cực|ns
太清门=Thái Thanh môn|ns
太湖=Thái Hồ|ns
太田=Rangu|ns
太白山=Thái Bạch sơn/núi Thái Bạch|ns
太苍=Thái Thương|ns
太行山=Thái Hành sơn/Thái Hành Sơn|ns
太阳=mặt trời/thái dương/vầng thái dương/ánh sáng mặt trời/ánh nắng/màng tang/huyệt thái dương/Thái Dương|ns
太阳城=Thái Dương thành|ns
太阳宫=Thái Dương Cung|ns
太阳旗=cờ mặt trời|ns
太阳穴=huyệt Thái Dương|ns
太阳黑子=lỗ đen/đốm đen|ns
太阴=thái âm/Thái Âm|ns
太阿=Thái A|ns
太高兴=rất cao hứng/thật cao hứng|ns
夫国=phu quốc|ns
夷平=san bằng|ns
夷陵=Di Lăng|ns
夸下海口=khoe khoang khoác lác|ns
夸海口=nói bốc nói phét/nói phét tới mây xanh/khoác lác|ns
奈何桥=cầu Nại Hà|ns
奈威=Neville|ns
奈洛比=Nairobi|ns
奈美=Nami|ns
奉天=phụng thiên/thừa lệnh vua|ns
奉安=Phụng An/Chôn cất cho người trên.|ns
奉家=Phụng gia|ns
奎木狼=Khuê Mộc Lang|ns
奎茵=Quinn|ns
契丹=Khiết Đan|ns
契卡=Cheka|ns
契约=khế ước/hợp đồng|ns
奥东=Odón|ns
奥兰=Aurane/Áo Lan|ns
奥利维亚=Olivia|ns
奥古=Áo Cổ|ns
奥古斯都=Augustus|ns
奥国=nước Áo/Áo|ns
奥地利=Áo/Áo Đích Lợi|ns
奥巴马=Obama|ns
奥斯曼帝国=đế quốc Ottoman/Đế chế Ottoman|ns
奥斯本=Osborn|ns
奥本=Auburn|ns
奥绝=sông trong nhà, không giao tiếp với bên ngoài|ns
奥里亚=Áo Lý Á|ns
好哇=Tốt a/hảo oa/Wow|ns
好莱坞=Hollywood|ns
如林=như rừng|ns
妙绝=diệu tuyệt/tuyệt vời|ns
姑苏=Cô Tô|ns
委内瑞拉=Venezuela/Ủy Nội Thụy Tạp|ns
委顿=uể oải/mệt mỏi/mệt nhọc|ns
姥姥家=nhà bà ngoại|ns
威伯=Weber|ns
威尔士=Wales|ns
威斯敏斯特=Westminster|ns
威灵顿=Wellington|ns
威虎山=Uy Hổ sơn|ns
娑娜=Sona|ns
娑罗树=cây sa la|ns
婆罗洲=Borneo|ns
婆罗门=Bà La Môn|ns
嫩嫩=non nớt|ns
子京=Tử Kinh|ns
孚众望=tạo lòng tin cho chúng nhân|ns
孟城=Mạnh Thành|ns
孟山=mạnh sơn|ns
孟津=Mạnh Tân|ns
孟那=Mạnh Na|ns
孟都=Mạnh đô|ns
孟阳=Mạnh Dương|ns
宁化=Ninh Hóa|ns
宁南=Trữ Nam|ns
宁县=Ninh Huyện|ns
宁哥=Ninh ca|ns
宁国县=Ninh Quốc Huyện|ns
宁城=Ninh Thành|ns
宁夏=Ninh Hạ|ns
宁宁=Ninh Ninh|ns
宁安=Ninh An/thành phố cấp quận Ninh An ở Mudanjiang 牡丹江, Hắc Long Giang|ns
宁山=Trữ sơn|ns
宁州=Ninh Châu|ns
宁水=Ninh Thủy|ns
宁江=Ninh Giang|ns
宁波=Ninh Ba|ns
宁海=Ninh Hải|ns
宁港=Ninh cảng|ns
宁阳=Ninh Dương|ns
安丘=An Khâu|ns
安东=An Đông|ns
安乐=yên vui/an nhàn/thanh thản/thoải mái/an lạc/an vui|ns
安乐窝=tổ ấm/an lạc tổ/nơi thoải mái, căn phòng ấm áp|ns
安亚=Anja|ns
安利=Amway|ns
安南=An nam|ns
安和乐利=ổn định hòa bình|ns
安哥=An ca|ns
安国=An quốc|ns
安塔利亚=Antalya|ns
安大略省=Ontario/Tỉnh Ontario, Canada|ns
安宁=an bình/an ninh/trật tự/trị an/yên lòng|ns
安安=An An|ns
安安定定=yên yên ổn ổn|ns
安家=an gia/An gia/an cư/thu xếp gia đình/xếp đặt chuyện nhà/ổn định cuộc sống/lập gia đình/xây dựng gia đình/kết hôn|ns
安尼塔=Anita|ns
安山=An Sơn|ns
安州=An Châu|ns
安德鲁斯=Andrew|ns
安徽=An Huy|ns
安昌=An Xương|ns
安江=An Giang/tỉnh An Giang|ns
安海=An Hải|ns
安源=An Nguyên|ns
安溪=An Khê|ns
安第斯=Andean|ns
安纳塞隆=An Nạp Tắc Long|ns
安营下寨=dựng trại đóng quân/cắm trại xuống trại|ns
安西=An Tây|ns
安达卢西亚=Andalucía|ns
安邦定国=mang lại hoà bình và sự ổn định cho đất nước|ns
安阳=An Dương|ns
安陆=An Lục|ns
安顿=dàn xếp/bố trí ổn thoả/thu xếp/thu xếp ổn thoả/giao cho/đưa cho/đưa vào làm/đặt vào/gửi/ổn định/yên ổn/yên/đâu vào đấy|ns
定军山=Định Quân Sơn|ns
定岗=định trách nhiệm|ns
定州=Định Châu/thành phố cấp quận Định Châu ở Bảo Định 保定 [Bao3 ding4], Hà Bắc|ns
定河=Định Hà|ns
定海=định hải|ns
定襄=Định Tương|ns
定颜丹=Định Nhan Đan|ns
宛城=Uyển Thành|ns
宜伦=Nghi Luân|ns
宜兴=Nghi Hưng|ns
宜城=Nghi Thành|ns
宜安=Nghệ An/tỉnh Nghệ An|ns
宜家=Nghi gia|ns
宜居=thích hợp cư ngụ/nghi cư/Nghi Cư|ns
宜山=Nghi Sơn|ns
宜春=Nghi Xuân|ns
宜阳=Nghi Dương|ns
宝匣=hộp báu/hộp kho báu|ns
宝岛=Đài Loan/Formosa|ns
宝州=Bảo Châu|ns
宝莱坞=Bollywood|ns
宣城=Tuyên Thành|ns
宫掖=cung thất/cung đình|ns
宽宏大度=khoan dung đại độ/rộng lượng/có đầu óc rộng rãi|ns
宾利=Bentley|ns
宾夕法尼亚=Pennsylvania|ns
宾夕法尼亚州=bang Pennsylvania/Pennsylvania|ns
宾根=Bingen|ns
宾阳=Tân Dương|ns
宿州=Túc Châu/thành phố cấp tỉnh Tô Châu ở An Huy|ns
宿根=gốc cây sống lâu năm túc căn|ns
密云=mây dày|ns
密克罗尼西亚=Micronesia|ns
密寺=Mật Tự|ns
密封=bịt kín/phong kín/đậy kín/dán kín/gói kín/mật phong|ns
密尔=Mill|ns
密斯=tiểu thư/cô|ns
密林=rừng rậm|ns
密歇根=Michigan/Mật Hiết Căn|ns
密约=mật ước/bí mật đính ước/ngầm hẹn ước|ns
密苏里=Missouri/Mật Tô Lý|ns
密西西比=Mississippi|ns
富县=huyện giàu|ns
富国=phú quốc/làm nước giàu/nước giàu/Phú Quốc/|ns
富山=Phú Sơn|ns
富江=Phú Giang|ns
富省=tỉnh giàu|ns
寿山=Thọ Sơn|ns
寿州=Thọ châu|ns
寿比南山=thọ sánh Nam Sơn|ns
寿阳=Thọ Dương|ns
小亚细亚=Tiểu Á|ns
小人国=Tiểu Nhân quốc|ns
小国=tiểu quốc/nước nhỏ|ns
小桥流水=cầu nhỏ nước chảy/nước chảy cầu nhỏ|ns
小河沟=con lạch nhỏ|ns
小海=tiểu Hải|ns
小苏=Tiểu Tô/tiểu Tô|ns
小黎=Tiểu Lê|ns
尖嘴=mỏ nhọn|ns
尖沙=Tiêm Sa|ns
尖沙咀=Tiêm Sa Chủy|ns
尖牙=răng nanh/răng nhọn|ns
尤利西斯=Ulysses|ns
尧典=nghiêu điển|ns
尼丘=Ni Khâu|ns
尼亚加拉=Niagara|ns
尼伯地=Liberté|ns
尼加拉瓜=Nicaragua|ns
尼南=Ni Nam/Neenan|ns
尼古斯=Ni Cổ Tư|ns
尼斯湖=hồ Loch Ness|ns
尼日利亚=Nigeria/Nigiêria|ns
尼根=Ni Căn|ns
尼治=Niji|ns
尼科西亚=Nicosia/Ni Khoa Tây Á|ns
尼罗河=sông Nin|ns
尼萨=Ni Tát|ns
尼龙绳=dây ni lông|ns
尾崎=Ozaki/Osaki|ns
尾牙=vĩ nha/tiệc cuối năm|ns
居庸关=cư dong quan/Cư Dung Quan|ns
屯田=đồn điền|ns
屯门=Đồn Môn/Quận Tuen Mun của Lãnh thổ Mới, Hồng Kông|ns
山丘=gò núi|ns
山东=Sơn Đông|ns
山丹=hoa loa kèn/hoa huệ tây/củ loa kèn/củ hoa loa kèn|ns
山伯=Sơn Bá|ns
山冈=gò núi|ns
山区=vùng núi/miền núi/miền ngược/vùng rẻo cao|ns
山南=Sơn Nam|ns
山南海北=nơi xa xôi/non nam bể bắc/chân trời góc biển|ns
山口=sơn khẩu/đèo/miệng núi/Yamakuchi|ns
山和树=núi cùng cây|ns
山哥=Sơn ca|ns
山嘴=rìa núi/mép núi/sơn chủy/mỏm núi|ns
山国=sơn quốc/quốc gia/khu vực|ns
山地车=xe đạp leo núi/xe đèo/Xe đạp địa hình/xe leo núi|ns
山坞=thung lũng|ns
山坡=dốc núi/sườn núi/triền núi/đồi|ns
山坡地=rẫy/triền núi|ns
山坡路=đường núi dốc|ns
山城=sơn thành/thành phố núi/phố núi|ns
山寨=sơn trại/hàng nhái/thôn xóm miền núi/bản làng rẻo cao|ns
山山水水=sơn sơn thủy thủy|ns
山岗=núi đồi/núi/sơn cương/đồi/gò|ns
山岛=sơn đảo/Đảo Núi|ns
山岩=đá núi/sơn nham/núi đá|ns
山岭=sơn lĩnh/núi non trùng điệp/dãy núi|ns
山岳=sơn nhạc/núi cao/đồi núi/núi non|ns
山峡=khe núi/đèo|ns
山峰=sơn phong/ngọn núi/đỉnh núi/mỏm núi/chóp núi|ns
山崖=vách núi/sườn núi|ns
山川=sông núi/sơn xuyên/núi sông|ns
山庄=sơn trang|ns
山本=Yamamoto|ns
山村=sơn thôn|ns
山林=sơn lâm/núi rừng|ns
山根=chân núi|ns
山梁=triền núi/lưng núi/sườn núi|ns
山梨县=tỉnh Yamanashi|ns
山水=sơn thủy/nước từ trên núi chảy xuống/cảnh sơn thuỷ/cảnh thiên nhiên/phong cảnh/tranh sơn thuỷ/tranh phong cảnh/tranh thuỷ mặc|ns
山沟=khe suối/khe núi/sơn cốc/thung lũng/vùng núi hẻo lánh/hốc núi|ns
山沟沟=thâm sơn cùng cốc/khe núi/thung lũng xa xôi|ns
山河=sơn hà/núi sông/non sông/giang sơn/đất nước|ns
山泉=sơn tuyền|ns
山泉水=nước suối|ns
山洞=sơn động/hang núi/động|ns
山海=sơn hải|ns
山海关=Sơn Hải quan|ns
山海城=Sơn Hải thành|ns
山湾=sơn loan|ns
山溪=khe núi/sơn khê/con suối|ns
山田=sơn điền/Yamada|ns
山罗=Sơn La/tỉnh Sơn La|ns
山羊=dê rừng/sơn dương/dê rừng|ns
山脉=sơn mạch/dãy núi/núi non/rặng núi|ns
山脚=chân núi|ns
山西=Sơn Tây|ns
山越=Sơn Việt|ns
山野=sơn dã/sơn thôn/rừng núi/vùng núi/dân gian/thô lỗ/cục mịch|ns
山门=sơn môn/cửa chùa/Phật giáo|ns
山阳=Sơn Dương|ns
山阴=Sơn Âm|ns
山陵=núi non/lăng tẩm/lăng mộ/sơn lăng|ns
山雄=Sơn Hùng|ns
山颠=đỉnh núi|ns
山高皇帝远=núi cao hoàng đế xa/hoàng đế núi cao xa xôi|ns
山鸡=gà rừng/chim trĩ/gà gô/gà núi/Gà Rừng|ns
岐山=Kỳ Sơn|ns
岐嶷=kì ngực/bé mà có khí tranh vanh khác người|ns
岐黄=trung y/kỳ hoàng|ns
岚山=Lam Sơn|ns
岚脚=Lam Cước|ns
岛根县=Shimane|ns
岛津=Shimazu|ns
岩前=trước mỏm đá|ns
岩海=biển dung nham|ns
岭东=Lĩnh Đông|ns
岭南=Lĩnh Nam|ns
岱庙=Đại miếu|ns
岳峙渊渟=trầm ổn/Nhạc Động Uyên|ns
岳州=Nhạc Châu|ns
岳灵珊=Nhạc Linh San|ns
岳肃=Nhạc Túc|ns
岷山=Dân Sơn|ns
岷江=Mân Giang|ns
峡湾=vịnh hẹp/hạp loan|ns
峨山=Nga Sơn|ns
峨眉=Nga Mi|ns
峨眉山=núi Nga Mi|ns
崂山=Lao sơn|ns
崆峒=Không Động|ns
崆峒山=Không Động Sơn|ns
崇山峻岭=núi non trùng điệp|ns
崇明县=huyện Sùng Minh/Hạt đảo Chongming, Thượng Hải|ns
崇洋=me Tây/Takahiro/Chong Yang/thần tượng những thứ nước ngoài|ns
崖山=sườn núi/nhai sơn|ns
嵩山=Tung Sơn|ns
嵩洛=Tung Lạc|ns
川中=Xuyên Trung/xuyên trung|ns
川岛=Kawashima|ns
川崎=Kawasaki|ns
川川=Xuyên Xuyên|ns
川省=Xuyên tỉnh|ns
川西=Xuyên Tây/Tây Tứ Xuyên|ns
川马=ngựa Tứ Xuyên|ns
巢湖=Sào Hồ/Hồ Chaohu|ns
巢窟=hang/sào huyệt|ns
巩县=Củng huyện|ns
巫地=Vu địa|ns
巫山=Vu sơn|ns
巫江=Vu Giang|ns
巴乌=bawu/bau/bawu, một nhạc cụ hơi bằng sậy miễn phí có hình dạng giống như một cây sáo và được chơi ngang dọc, đặc biệt gắn liền với các nền văn hóa thiểu số của Vân Nam|ns
巴伐利亚=Bavaria|ns
巴伦=Baron|ns
巴伦西亚=Valencia/Valencia, Tây Ban Nha|ns
巴克=Buck/Ba Khắc|ns
巴克利=Barkley/Ba Khắc Lợi|ns
巴兰=Balan|ns
巴其=Buggy|ns
巴兹=Bazz|ns
巴列=Valle|ns
巴利斯=Paris|ns
巴勒斯=Vales|ns
巴勒斯坦=Palestine/Ba Lặc Tư Thản|ns
巴厘岛=đảo Bali/Bali|ns
巴哈马=Bahamas|ns
巴地=ba/Bà Rịa|ns
巴基斯坦=Pakistan|ns
巴塔哥尼亚=Patagonia|ns
巴塞罗纳=Barcelona|ns
巴塞罗那=Barcelona|ns
巴士=xe buýt/ô-tô buýt/bus/ba sĩ|ns
巴士底狱=ngục Bastille|ns
巴尔=Bael|ns
巴尔干=Balkans|ns
巴尔的摩=Baldimore|ns
巴尼亚=Bania|ns
巴尼特=Barnett|ns
巴山=Ba Sơn/Ba sơn|ns
巴州=ba châu|ns
巴巴=chằn chặt/Baba/rất|ns
巴布亚=Papua|ns
巴布亚新几内亚=Papua New Guinea|ns
巴库=Baku|ns
巴度=Bardo|ns
巴彦浩特=Ba Ngạn Hạo Đặc|ns
巴拉克=Barak|ns
巴拉圭=Paraguay/Ba Lạp Khuê|ns
巴拿马=Panama|ns
巴拿马运河=kênh đào Panama|ns
巴斯=Bath|ns
巴斯卡=Pascal|ns
巴斯蒂亚=Bastia|ns
巴林=Ba Lâm/Bahrain|ns
巴比伦=Babylon|ns
巴比特=Babit|ns
巴洛=Ba Lạc|ns
巴特列=Bateel|ns
巴特利=Bathory|ns
巴盟=Ba Minh|ns
巴索=Ba Tác|ns
巴罗斯=Barros|ns
巴萨=Basa|ns
巴西=Brazil|ns
巴西利亚=Brasilia/Ba Tây Lợi Á|ns
巴路=Balou|ns
巴达=Bada|ns
巴里=bên trong/Ba Lý|ns
巴陵=Ba Lăng|ns
巴隆=Ballon|ns
巴顿=Patton|ns
巴鲁=Baru|ns
巴黎=Paris|ns
巴黎圣母院=Nhà thờ Đức Bà Paris/Nhà thờ Đức Bà|ns
巴黎市=thành phố Paris|ns
布伦特兰=Bruntland|ns
布兰=Bran|ns
布宜诺斯艾利斯=Buenos Aires|ns
布店=tiệm vải|ns
布拉西=Bố Lạp Tây|ns
布欧=Buu|ns
布猗=Bố Y|ns
布莱克本=Blackburn/Cúp liên đoàn|ns
布达拉宫=Bố Lạp Đạt cung/cung điện Bố Lạp Đạt (Potala thuộc Tây Tạng)|ns
布鲁塞尔=Brussels/Bố Lỗ Tắc Nhĩ|ns
希亚=Zya|ns
希城=Hi Thành|ns
希塞=Greek|ns
希安=Scian|ns
希林=Schilling|ns
希欧=Shio|ns
希波=Hi Ba|ns
希瓦=Shiva|ns
希纳=Sinah|ns
希腊=Hi Lạp|ns
帕累托=Pareto|ns
帕苏=Pasu|ns
帝俄=Sa Hoàng|ns
常山=Thường Sơn/thường sơn|ns
常川=thường xuyên/không ngừng/liên tục|ns
常州=Thường Châu|ns
平冈=Bình Cương|ns
平南=Bình Nam|ns
平原=bình nguyên/đồng bằng|ns
平地上=trên đất bằng|ns
平地风波=sóng gió bất thường/đất bằng nổi sóng/việc xảy ra bất ngờ|ns
平山=Bình Sơn|ns
平川=đồng bằng/XUYÊN/vùng bằng phẳng/Bình Xuyên/bình xuyên/bình nguyên|ns
平州=Bình Châu|ns
平平和和=bình bình hoà hoà|ns
平平安安=bình an|ns
平江=Bình Giang|ns
平津=Bình Tân|ns
平洲=Bình Châu|ns
平湖=hồ phẳng/Hồ Bình|ns
平西=mặt trời lặn|ns
平邮=bình bưu|ns
平阳=đồng bằng/Bình Dương/tỉnh Bình Dương|ns
并州=Tịnh Châu/Tịnh châu|ns
并联=quan hệ song song/mắc song song/nối song song|ns
并蒂莲=tịnh đế liên/tình vợ chồng mặn nồng|ns
广东=Quảng Đông|ns
广东省=Tỉnh Quảng Đông|ns
广义=nghĩa rộng/NGHĨA/Quảng Ngãi/tỉnh Quảng Ngãi/Quảng Nghĩa|ns
广南=Quảng Nam/tỉnh Quảng Nam|ns
广博=uyên bác/rộng/uyên thâm/rộng rãi|ns
广原=Quảng Nguyên|ns
广厦=nhà cao cửa rộng/cao ốc|ns
广哥=Quảng ca/Nghiễm ca|ns
广城=Quảng thành|ns
广威=Quảng Uy|ns
广宁=Quảng Ninh|ns
广安=Quảng An/thành phố cấp tỉnh Quảng An ở Tứ Xuyên|ns
广岛=Hiroshima|ns
广州=Quảng Châu|ns
广布=trải rộng|ns
广平=Quảng Bình/tỉnh Quảng Bình|ns
广度=chiều rộng/độ rộng/quảng bá|ns
广开=mở rộng|ns
广德=Nghiễm Đức/Quận Quảng Đức ở Xuancheng 宣城 [Xuan1 cheng2], An Huy|ns
广招=mời chào|ns
广清池=Quảng Thanh Trì|ns
广源=Nghiễm Nguyên|ns
广漠=mênh mông/rộng lớn/bao la/bát ngát|ns
广田=Quảng Điền|ns
广纳=quảng nạp|ns
广西=Quảng Tây|ns
广角=góc rộng/viễn cảnh rộng|ns
广角镜头=thấu kính wide/ống kính wide|ns
广都=Nghiễm Đô|ns
广阳=Quảng Dương|ns
广陵=Quảng Lăng|ns
庆云=Khánh Vân|ns
庆典=khánh điển/lễ mừng/buổi lễ long trọng|ns
庆山=Khánh Sơn|ns
庆州=Khánh Châu|ns
庆海=Khánh Hải|ns
庆阳=Khánh Dương|ns
庐城=Lư thành|ns
庐山=Lư Sơn|ns
庐州=Lư châu|ns
庐江=Lư Giang|ns
庐舍=nhà cửa ruộng đất/nhà cửa đơn sơ/lư xá|ns
庐陵=Lư Lăng|ns
库藏=kho tàng/cất trong kho/trong kho/có trong kho|ns
库里南=Cullinan|ns
应典=làm theo lời hứa/thực hiện lời hứa|ns
应县=Ứng huyện|ns
应山=Ứng Sơn|ns
底朝天=úp sấp/lộn chổng vó lên trời|ns
底格里斯=Tigris|ns
底格里斯河=Sông Tigris/sông Cách Lý Tư|ns
底比斯=Thebes|ns
庙前=trước miếu|ns
庙祝=người coi miếu/ông từ|ns
庙街=miếu nhai|ns
庙里=trong miếu|ns
府城=phủ thành|ns
府州=Phủ Châu|ns
府都=phủ đô|ns
康国=Khang quốc|ns
廊坊=lang phường|ns
廊庙=triều đình/hoàng cung/cung điện|ns
廊桥=lang kiều|ns
延东=Duyên Đông|ns
延台县=huyện Duyên Đài|ns
延吉市=Duyên cát thị|ns
延安=Duyên An|ns
延州=Diên Châu|ns
延庆=Diên Khánh|ns
延时=trì hoãn/chậm trễ|ns
延朗=Duyên Lãng|ns
延津=Diên Tân|ns
延浦=Duyên Phổ|ns
建兰=Kiến Lan|ns
建县=xây huyện|ns
建国=kiến quốc/thành lập đất nước/lập quốc/thành lập quốc gia/dựng nước/xây dựng đất nước|ns
建昌=Kiến Xương|ns
建阳=Kiến Dương/thành phố cấp quận Jianyang ở Nam Bình 南平 [Nan2 ping2] Phúc Kiến|ns
开原=Khai Nguyên|ns
开园=bắt đầu chín/bắt đầu thu hoạch/thu hoạch được/trái đã chín|ns
开国=khai quốc/lập quốc/dựng nước|ns
开封府=Khai Phong phủ|ns
开山=khai sơn/phá núi/khai phá đồi núi/sư tổ khai sơn/khai sơn tổ sư/ông tổ|ns
开山鼻祖=khai sơn thủy tổ|ns
开州=Khai Châu|ns
开春=đầu xuân/sang xuân/vào xuân/đầu mùa xuân|ns
开朗=sáng sủa/rộng rãi/thoáng mát/vui tươi/thoải mái/cởi mở/mở rộng|ns
开河=dòng sông tan băng/khai thông dòng sông/dòng sông tan băng (Khai Hà)/Khai Hà|ns
开洋=tôm khô/tôm nõn|ns
开犁=cày xông đất/khai rãnh cày/cày vỡ|ns
开阳=Khai Dương/khai dương|ns
弗吉尼亚=Virginia|ns
弗吉尼亚州=bang Virginia/Virginia, tiểu bang Hoa Kỳ|ns
弗里敦=Freetown|ns
弗鲁米嫩塞=Fluminense|ns
张掖=Trương Dịch|ns
张本=sắp xếp trước/sắp đặt trước/điều nói trước/điều cài trước|ns
张治国=Trương Trị Quốc|ns
归原=quy nguyên|ns
归国=về nước/trở về tổ quốc/hồi hương|ns
归省=về nhà thăm bố mẹ/về quê thăm bà con|ns
归西=quy thiên/về trời/về cõi Phật/về tây|ns
彰德=chương đức|ns
徐州=Từ Châu|ns
徐州市=Từ châu thị|ns
徐市=Từ Thị|ns
徐海=Từ Hải|ns
得克萨斯=Texas|ns
得意洋洋=dương dương đắc ý/dương dương tự đắc|ns
御阪=Misaka|ns
循环赛=thi đấu vòng tròn|ns
德亚=Dea|ns
德伦=Durham|ns
德克=Đức Khắc/Derk|ns
德克萨斯=Texas/Đức Khắc Tát Tư|ns
德克萨斯州=bang Texas/Texas/tiểu bang Texas|ns
德兰=Đức Lan/Derain|ns
德兴=Đức Hưng|ns
德利=Đức Lợi|ns
德化=đức trị/nhân trị|ns
德国=nước Đức|ns
德塞利=Desailly|ns
德富=Đức Phú|ns
德尔=Del|ns
德尔萨=Đức Nhĩ Tát|ns
德尼斯=Deniz|ns
德尼罗=De Niro|ns
德川=Tokugawa|ns
德州=Đức Châu|ns
德布=Deb|ns
德康=Đức Khang|ns
德意志=nước Đức|ns
德拉科=Draco|ns
德斯=Sanders|ns
德林=Đức Lâm/Durling|ns
德甲=Bundesliga|ns
德科=Deco|ns
德米凯利斯=Demichelis|ns
德累斯顿=Dresden|ns
德罗巴=Drogba|ns
德胜门=Đức Thắng môn|ns
德色=kiêu căng/kiêu kỳ|ns
德萨=German/Desa|ns
德谟克利特=Democritus|ns
德赛=ân huệ thành kính|ns
德里=Đức Lý|ns
德阳=Đức Dương|ns
德隆=Đức Long/Deron|ns
德鲁=Đức Lỗ/Drew|ns
德黑兰=Tehran/Đức Hắc Lan|ns
徽州=Huy Châu|ns
志山=Chí Sơn|ns
忠君爱国=trung quân ái quốc|ns
忻州=Hãn Châu/thành phố cấp tỉnh Tân Châu ở Sơn Tây 山西|ns
怀古=hoài cổ/nhớ cảnh vật xưa|ns
怀安县=Hoài An huyện|ns
怀庆=Hoài Khánh|ns
怀沙=Hoài Sa|ns
怀璧=hoài bích|ns
怒江=nộ giang/Nộ Giang|ns
怒海=nộ hải|ns
怒马=nộ mã|ns
恒山=Hằng Sơn|ns
恒川=Hằng Xuyên|ns
恒河沙=hằng hà sa|ns
恩京=Enking|ns
恩典=ân điển/ân huệ/ơn đức/ban ơn/ban ân|ns
恭州=Cung Châu|ns
恰拉=Chawla|ns
恰西=Kháp Tây|ns
悉尼=Sydney|ns
悉达=Shieda|ns
惠及=ban ơn cho|ns
惠州=Huệ Châu|ns
意中=trúng ý/trong ý|ns
意兴=hứng thú/hào hứng|ns
意大利=Italy|ns
意安=yên/Ý Yên|ns
慕灵珊=Mộ Linh San|ns
成都=Thành Đô/thành đô|ns
成阳=Thành Dương|ns
戛纳=Cannes|ns
房州=Phòng Châu|ns
所罗门=Solomon|ns
所罗门群岛=quần đảo Solomon|ns
扎古=Zaku|ns
扎堆=tụ tập/tập hợp/trát đôi|ns
扎寨=cắm trại|ns
扎木伦=Trát Mộc Luân|ns
扎根=cắm rễ/ăn sâu/bắt rễ/thâm nhập/trát căn|ns
扎甲=giáp bó|ns
扎耳朵=chói tai|ns
扎花=thêu/thêu hoa|ns
扎马=đứng trung bình tấn|ns
扬善=dương thiện|ns
扬威=giương oai/dương oai|ns
扬州=Dương Châu|ns
扬旗=treo cờ/cột tín hiệu đường sắt|ns
扬林=Dương Lâm|ns
扬水=bơm nước|ns
扬洲=Dương Châu|ns
扬眉=nhướng mày|ns
扶掖=giúp đỡ/trợ giúp/phù trợ/dìu dắt/nâng đỡ|ns
扶苏=Phù Tô|ns
承安=Thừa An|ns
抚宁=Phủ Trữ|ns
抚安=vỗ về/động viên/dẹp yên|ns
抚州=phủ châu|ns
抚平=vuốt lên|ns
抚摩=vuốt ve/xoa/vỗ về/vuốt|ns
抚琴=đánh đàn/gảy đàn/chơi đàn/khảy đàn|ns
抚顺=Phủ Thuận|ns
拉丁美洲=Châu Mỹ La Tinh|ns
拉下马=kéo xuống ngựa|ns
拉多加湖=hồ Ladoga/Hồ Ladoga|ns
拉宾=Labin|ns
拉山头=kết bè/kết đảng/kéo bè kéo lũ/kết bầy/kết bè kết đảng|ns
拉犁=kéo cày|ns
拉脱维亚=Latvia/Lạp Thoát Duy Á|ns
拉西=lạp tây|ns
拉西亚=Gracia|ns
拙作=chuyết tác/tác phẩm kém cỏi của tôi/bài làm của kẻ vụng về này|ns
拙夫=chuyết phu|ns
拜寿=mừng thọ/chúc thọ|ns
拜拜=bái bai/bái bái/bye bye/cúi chào/tổ chức đám rước thần, mở tiệc mời bạn bè thân quyến/tạm biệt/bye-bye|ns
拜隆国=Bái Long quốc|ns
拣佛烧香=chọn Phật thắp hương|ns
择吉=chọn ngày lành tháng tốt/chọn ngày|ns
拱北=củng bắc|ns
拱坝=đập hình cung|ns
拱桥=cầu hình vòm/cầu có vòm tròn/cầu vòm|ns
挪亚=Noah|ns
挪威=Na Uy|ns
捂捂盖盖=che che đậy đậy|ns
捞本=kéo lại vốn/vớt vát/lấy lại vốn|ns
捷克=Tiệp Khắc/Czech|ns
捷克斯洛伐克=Cze choslovak|ns
捷足=nhanh chân|ns
掖县=huyện Dịch|ns
提坦=Titan|ns
揭阳=Yết Dương/thành phố cấp tỉnh Jieyang ở Quảng Đông|ns
摩兹=Mozu|ns
摩加迪沙=Mogadishu/Ma Gia Địch Sa|ns
摩崖=Ma Nhai|ns
摩拉维亚=Moravia|ns
摩拿=Ma Nã|ns
摩洛哥=Morocco/Ma Lạc Ca|ns
摩纳哥=Monaco|ns
摩西=Moses|ns
撒丁岛=đảo Sardinia|ns
撒哈拉沙漠=Sa mạc Sahara|ns
播州=Bá Châu|ns
播撒=gieo rắc/gieo trồng/gieo/rắc|ns
攀岩=leo núi/leo vách núi|ns
攀沿=men bám vào|ns
攀登上=leo lên/trèo lên|ns
攀花=Phàn Hoa|ns
攸关=du quan|ns
故国=cố quốc/quốc gia cổ/tổ quốc/đất nước/quê hương/cố hương|ns
故城=thành cổ|ns
故步自封=giậm chân tại chỗ/bảo thủ/thủ cựu/chồn chân bó gối|ns
敦伦=đôn luân|ns
敦劝=khuyên chân thành|ns
敦本=coi trọng căn bản|ns
敦煌=Đôn Hoàng|ns
敦煌石窟=hang đá Đôn Hoàng|ns
斐尔=Phil/Phỉ Nhĩ|ns
斐济=đảo Phi-gi/Fiji/đảo Phigi|ns
斐盟=Phỉ Minh|ns
斗嘴=đấu võ mồm/tranh cãi/cãi nhau/cãi cọ/trêu nhau/đùa nhau/trêu chọc/cãi vả|ns
斗蓬=đấu bồng|ns
斯堪尼亚=Scania|ns
斯堪的纳维亚=Scandinavia|ns
斯威士兰=Swaziland/Tư Uy Sĩ Lan|ns
斯洛伐克=Slovak/Slovakia|ns
斯里巴加湾=Tư Lý Gia Loan|ns
新义州=Tân Nghĩa châu|ns
新乡=Tân Hương/thành phố cấp tỉnh Tân Hương ở Hà Nam|ns
新亚=Tân Á|ns
新加坡=Singapore|ns
新北市=Tân Bắc thị|ns
新区=khu mới/vùng mới giải phóng|ns
新国=tân quốc|ns
新城=thành mới/Shinjō|ns
新城区=khu vực mới|ns
新墨西哥=New Mexico|ns
新安县=huyện Tân An/huyện Tân Yên|ns
新家园=gia viên mới|ns
新川=Tân Xuyên|ns
新州=Tân Châu|ns
新平=Tân Bình|ns
新店=tiệm mới|ns
新建=mới xây/xây mới|ns
新旧=cũ mới|ns
新春=tân xuân/xuân mới|ns
新村=khu nhà mới/thôn mới|ns
新江=Tân Giang|ns
新泽西=New Jersey|ns
新洋=Tân Dương|ns
新津=Tân Tân|ns
新浦=Tân Phổ|ns
新海=Tân Hải|ns
新港=tân cảng|ns
新牙=răng mới|ns
新王都=tân vương đô|ns
新番=anime mới/phiên bản mới|ns
新疆=Tân Cương|ns
新约=Tân Ước|ns
新艺城=Tân Nghệ Thành|ns
新街=phố mới/tân nhai|ns
新西兰=New Zealand/Tân Tây Lan|ns
新都=tân đô|ns
新雅=tân nhã|ns
新鲜=mới mẻ/tươi mới/mới lạ/tươi sốt/tươi/trong lành/mới xuất hiện|ns
新鲜度=độ tươi mới/độ tươi|ns
方桃譬李=môi son má đào|ns
旁及=đề cập đến/xét đến/bàn đến|ns
旁路=đường vòng|ns
旁门=bàng môn/cửa bên/cửa ngách/cửa hông|ns
旁门左道=bàng môn tả đạo/tà thuyết/dị đoan/tà đạo/bàng môn tà đạo|ns
旅顺口=Lữ Thuận Khẩu|ns
旌阳=Tinh Dương|ns
无丹=vô đan|ns
无人区=khu không người|ns
无人岛=đảo không người|ns
无宁=thà bằng/chi bằng|ns
无定河=Vô Định hà|ns
无底洞=hang không đáy/không đáy/vô cùng tận/động không đáy|ns
无极=vô cực|ns
无极县=Vô Cực huyện|ns
无疆=vô cương/không giới hạn/vô cùng tận/vô biên|ns
无花果树=cây không hoa không trái|ns
无虞=không ngại/không lo|ns
无锡=Vô Tích|ns
日中=trong ngày/buổi trưa/ban trưa/giữa trưa|ns
日丽=nhật lệ|ns
日内瓦=Geneva|ns
日华=nhật hoa/Nhật Bản|ns
日增=ngày càng tăng lên|ns
日安=chúc một ngày tốt lành/nhật an|ns
日尔曼=German|ns
日岛=Nhật Đảo|ns
日德=Nhật Đức|ns
日志=nhật ký/sổ ghi chép hàng ngày|ns
日托=gửi ban ngày/chăm sóc ban ngày|ns
日本=Nhật Bản/Nhật Bổn/Nhật bản|ns
日本化=Nhật Bản hoá|ns
日本国=nước Nhật/Nhật/Nhật Bản/Nhật Bổn/Japan|ns
日比谷=Hibiya|ns
日班=ca ngày/ca học ban ngày|ns
日美=Nhật Mỹ|ns
日耳曼=Germanic/Tổ tiên của người Đức và Anh|ns
日落西山=mặt trời lặn phía tây|ns
日里=trong ngày|ns
日阳=nhật dương|ns
旧国=cố đô/kinh đô cũ|ns
旧大陆=cựu đại lục/lục địa cũ|ns
旧都=cố đô/kinh đô cũ|ns
旧金山=San Francisco|ns
昆仑=Côn Luân|ns
昆仑山=Côn Luân sơn/Côn Lôn sơn|ns
昆仑山脉=dãy núi Côn Lôn/dãy núi Côn Luân|ns
昆克=Quink|ns
昆卡=Côn Tạp|ns
昆古=Côn Cổ|ns
昆吾=Côn Ngô|ns
昆吾山=Côn Ngô Sơn|ns
昆和=Côn Hòa|ns
昆山=Côn Sơn|ns
昆布=Côn Bố|ns
昆廷=Côn Đình/Quintin|ns
昆德=Kund|ns
昆德拉=Kundera|ns
昆明=Côn Minh|ns
昆曲=Côn Khúc|ns
昆桑=Côn Tang|ns
昆汀=Kentin/Quentin|ns
昆特=Gwent|ns
昆罗=Côn La|ns
昆西=Quincy|ns
昊哥=Hạo ca|ns
昌国=Xương Quốc|ns
昌州=Xương Châu|ns
昌河=Changhe|ns
昌海=xương hải|ns
昌西=Xương Tây|ns
昌黎=Xương Lê|ns
明尼苏达=Minnesota/Minh Ni Tô Đạt|ns
明日帝国=Minh Nhật Đế Quốc|ns
易县=Dịch huyện|ns
星海=tinh hải/biển sao/|ns
昭阳=Chiêu Dương|ns
晋中=Tấn Trung/thành phố cấp tỉnh Jinzhong ở Sơn Tây 山西|ns
晋京=Tấn Kinh|ns
晋原=Tấn Nguyên|ns
晋国=Tấn quốc/nước Tấn/nước Tấn|ns
晋城=Tấn Thành|ns
晋封=tấn phong/tiến phong|ns
晋州=Tấn Châu|ns
晋江=Tấn Giang|ns
晋阳=Tấn Dương|ns
普亚=Pouillat|ns
普京=Vladimir Putin|ns
普及=phổ cập/thông dụng/phổ biến/phổ biến rộng khắp|ns
普及本=loại sách phổ cập|ns
普国=nước Phổ|ns
普拉亚=Praia/Phổ Lạp Á|ns
普洱=phổ nhị|ns
普罗旺斯=Provence|ns
普陀山=Phổ Đà sơn|ns
景东=Cảnh Đông|ns
景山=cảnh sơn|ns
景阳=Cảnh Dương/cảnh dương|ns
智利=Chi Lê/Chile/Chí Lợi|ns
智牙=răng khôn/Răng khôn|ns
暹罗=Xiêm La|ns
曲东=Khúc Đông|ns
曲州=Khúc châu|ns
曲江=Khúc Giang|ns
曲洋=Khúc Dương|ns
曲阜=Khúc Phụ|ns
曲阳=Khúc Dương|ns
曼利=Manly|ns
曼哈顿=Manhattan|ns
曼哈顿区=khu Manhattan/Quận Manhattan/Quận Manhattan của Thành phố New York|ns
曼哈顿岛=Manhattan|ns
曼多=mạn đa|ns
曼斯=mạn tư|ns
曼珠沙华=mạn châu sa hoa|ns
曼联=Manchester United|ns
曼谷=Băng Cốc|ns
曼陀罗=Mạn Đà La|ns
曼陀罗花=mạn đà la hoa/hoa Mandala|ns
曾南茵=Tăng Nam Nhân|ns
曾经沧海=từng trải/đã từng vượt qua biển cả, không sợ gì sông nước/đã từng nếm trải nhiều biến cố, không thèm để mắt tới những chuyện nhỏ nhặt|ns
曾黎=Tăng Lê|ns
月中姮娥=nguyệt trung Hằng Nga|ns
月牙湖=Nguyệt Nha hồ/Nguyệt nha hồ|ns
朔州=Sóc Châu/thành phố cấp tỉnh Shuozhou ở Sơn Tây 山西|ns
朗拿度=Ronaldo|ns
望乡台=vọng hương đài|ns
望京=xem kinh thành|ns
望城=vọng thành|ns
望洋=nhìn trời/để nhìn vào không trung|ns
望海=Vọng Hải|ns
朝南=hướng nam/hướng về phía nam/Hướng nam|ns
朝发夕至=sáng đi chiều đến|ns
朝圣=triều thánh/hành hương|ns
朝外=hướng ra ngoài/ngoài triều : hướng ra ngoài|ns
朝天宫=Triêu Thiên cung|ns
朝天门=triều thiên môn|ns
朝山=lên núi/lên núi lễ Phật|ns
朝廷=triều đình/cung điện/quần thần|ns
朝拜=triều bái/lạy chầu/làm lễ/hành hương/thờ phụng|ns
朝比奈=Ashahina|ns
朝贡=triều cống/cống nạp|ns
朝贺=chầu mừng|ns
朝里=trong triều/hướng bên trong|ns
朝野=triều chính/vua và dân/triều đình và dân gian/chính phủ và dân chúng/triều dã/cả triều|ns
朝阳=triêu dương/mặt trời mới mọc/ánh sáng mặt trời/hướng dương/hướng về phía mặt trời/triều dương|ns
朝阳区=triều dương khu|ns
朝阳市=thành phố Triêu Dương|ns
朝阳花=hoa hướng dương|ns
朝阳镇=Triều Dương trấn|ns
朝阳门=Triêu Dương môn|ns
朝霞=ánh bình minh/ánh ban mai/vầng hồng|ns
朝韩=triều hàn|ns
朝鲜=Triều Tiên|ns
朝鲜半岛=bán đảo Triều Tiên/Bán đảo Triều Tiên|ns
木州=Mộc Châu|ns
木牛流马=bò gỗ ngựa gỗ/xe gỗ|ns
本州岛=đảo Honshu|ns
札尼别汗=Jani Beg hãn|ns
札幌=Sapporo|ns
札幌市=Sapporo-shi|ns
朱亥=Chu Hợi|ns
朱棣=Chu Lệ|ns
杏林=hạnh lâm|ns
杏花村=Hạnh Hoa thôn/ngôi làng của những cây mơ nở hoa, nơi người ta có thể tìm thấy một tiệm rượu|ns
杜王町=Moriō-chō|ns
杞国=nước Kỷ|ns
杞柳=cây khởi liễu|ns
条条大路通罗马=mọi con đường đều dẫn đến thành Rome/tận những con đường lớn đi qua Rome/mọi con đường đều dẫn tới Rome|ns
杭城=Hàng Châu|ns
杭州=Hàng Châu|ns
松井=tùng tỉnh|ns
松口=nhả ra/nhè ra/không kiên trì/nhả|ns
松嘴=há mồm|ns
松本=Matsumoto|ns
松林=rừng tùng/tùng lâm|ns
松江=Tùng Giang|ns
松浦=Matsuura/Matsūra|ns
松海=Tùng Hải|ns
松脂=nhựa thông|ns
松花江=Tùng Hoa giang|ns
松鸡=chim tùng kê|ns
极北=cực bắc|ns
林翠珊=Lâm Thúy San|ns
枝叶茂盛=cành lá tươi tốt|ns
枣庄=tảo trang|ns
枫丹白露=Fontainebleau|ns
枫城=Phong Thành|ns
枫山=ngọn Phong sơn|ns
枫岭=đường núi|ns
枫林=rừng phong/rừng lá phong|ns
枫桥=Phong Kiều|ns
枫桥镇=Phong Kiều Trấn|ns
柏原=Bách Nguyên|ns
柘木=gỗ chá|ns
查店=kiểm tra quán trọ|ns
柬埔寨=Cam-pu-chia/Cam-bốt/Cambodia|ns
柳国=Liễu Quốc|ns
柳城=Liễu Thành|ns
柳州=Liễu Châu|ns
柳河=Liễu Hà|ns
栖霞=Tê Hà|ns
栖霞山=Tê Hà sơn|ns
株洲=Chu Châu|ns
株连=liên luỵ/dây dưa/dính dáng/dính líu|ns
格兰德河=sông Rio Grande|ns
格奈森瑙=Gneisenau|ns
格拉斯哥=Glasgow/Glasgow, Scotland|ns
格林纳丁斯=Grenadines|ns
格西=Cách Tây|ns
格陵兰岛=đảo Greenland/Greenland|ns
格鲁吉亚=Georgia/Cách Lỗ Cát Á|ns
桂兰=Quế Lan|ns
桂南=Quế Nam|ns
桂山=Quế Sơn|ns
桂州=Quế Châu|ns
桂庆=Quế Khánh|ns
桂省=Quế tỉnh/Quảng Tây|ns
桂西=Quế Tây|ns
桂阳=Quế Dương|ns
桃园=đào viên|ns
桃林=rừng đào|ns
桃根仙=Đào Căn Tiên|ns
桃江=Đào Giang|ns
桃源洞=Đào Nguyên động|ns
桃花岛=Đào Hoa đảo|ns
桃花开=hoa đào nở|ns
桃谷六仙=Đào Cốc lục tiên|ns
桐人君=Kirito-kun|ns
桐木=đồng mộc/cây trẩu|ns
桑干河=Tang Kiền Hà|ns
桑拿房=phòng tắm hơi|ns
桥头堡=lô cốt đầu cầu/kiến trúc ở đầu cầu/cứ điểm tiến công|ns
桦城=Hoa Thành|ns
梁国=Lương quốc|ns
梁州=Lương Châu|ns
梁洲=Lương Châu|ns
梅克伦堡=Mecklenburg|ns
梅州=Mai Châu|ns
梅拉伦湖=Mälaren|ns
梅花三弄=mai hoa tam lộng|ns
梅西亚=Messias|ns
梅鲁扎嘎鲁多=Melzargard|ns
梧州=Ngô Châu/thành phố cấp quận Ngô Châu ở Quảng Tây|ns
梵卓=Venture|ns
梵宫=chùa/chùa Phật|ns
梵帝冈=Vatican|ns
梵意=Phạn Ý|ns
梵蒂冈=Vatican|ns
棉兰老岛=đảo Mindanao/Mindanao|ns
棋圣=Kỳ Thánh|ns
棕黑=nâu đậm/màu nâu đậm|ns
棠棣=cây đường lê|ns
楚南=Sở Nam|ns
楚国=Sở quốc/nước Sở|ns
楚州=Sở Châu/Quận Chu Châu của thành phố Hoài An 淮安 市 [Huai2 an1 shi4], Giang Tô|ns
楚河=Sở Hà|ns
楚河汉界=Sở hà Hán giới/một đường phân chia lãnh thổ đối thủ|ns
楼兰=Lâu Lan|ns
榆木=du mộc|ns
榆林=Du Lâm|ns
榆树=cây du|ns
榎本梓=Enomoto Azusa|ns
榕城=Dong Thành|ns
樊城=Phàn Thành/Quận Fangcheng của thành phố Xiangfan 襄樊 市 [Xiang1 fan2 shi4], Hồ Bắc|ns
樊川=sông Phàn|ns
樊篱=hàng rào/sự trói buộc|ns
樊约=Phàn Ước|ns
横冲=xông ngang/xông mạnh|ns
横山=Hoành Sơn|ns
横岛=Yokoshima|ns
横岭=Hoành Lĩnh|ns
横峰=đỉnh cao|ns
横店=Hoành Điếm|ns
横拉=kéo ngang|ns
横断山脉=Hoành Đoạn sơn mạch|ns
横木=then/thanh ngang/hoành mộc|ns
横梁=xà ngang/xà nhà/rầm/kèo/gióng ngang/sườn ngang của sàn tàu/thanh giằng ngang/thanh ngang|ns
横水=Hoành Thủy|ns
横江=hoành giang/qua sông|ns
横波=sóng ngang/mắt long lanh|ns
横滨=Yokohama|ns
横眉=trừng mắt/quắc mắt/lông mày dựng ngược|ns
横街=phố nhỏ/phố lẻ|ns
樱兰=anh lan|ns
樱木花道=Hanamichi/Anh Mộc Hoa Đạo|ns
欢庆=chúc mừng/chào mừng/đón mừng/vui mừng|ns
欧中=Âu Trung|ns
欧也尼=Eugenie|ns
欧亚=Âu Á|ns
欧兹=Oz|ns
欧内=Âu Nội|ns
欧内斯特=Ernest|ns
欧几里得=Euclid|ns
欧噶桑=okaa-san|ns
欧塞尔=Auxerre|ns
欧多=Âu Đa|ns
欧尼尔=Eunir|ns
欧州=Âu châu|ns
欧德=Âu Đức|ns
欧拉=Euler|ns
欧斯卡=Âu Tư Tạp|ns
欧根=Eugen|ns
欧泊=đá opal/âu bạc/Âu Bạc/opal|ns
欧洲=Châu Âu|ns
欧洲各国=các nước Âu châu|ns
欧罗=Euro|ns
欧罗巴=Europa|ns
欧罗巴洲=châu Âu/Europa/Châu Âu|ns
欧美=Âu Mỹ|ns
欧联=Âu Liên|ns
欧西=Tây Âu|ns
欧诺弥亚=Eunomia|ns
欧赛=Ose|ns
欧足联=UEFA|ns
欧都桑=otoo-san|ns
欧阳=Âu Dương|ns
欧阳克=Âu Dương Khắc|ns
欧阳大哥=Âu Dương đại ca|ns
欧阳天=Âu Dương Thiên|ns
欧阳山=Âu Dương Sơn|ns
欧阳峰=Âu Dương Phong|ns
欧陆=Âu lục/bentley|ns
欧雅=Âu Nhã/Octavia|ns
歇斯底里=cuồng loạn/bệnh tâm thần/chứng ictêri/hysteric/mắc chứng cuồng loạn/hiết tư để lý/ cuồng loạn/bệnh tâm thần|ns
歇歇脚=nghỉ chân một chút|ns
正东=chính đông/chính đông|ns
正北=chính bắc|ns
正南=chính nam/chính nam|ns
正州=Chính Châu|ns
正昌=đang hưng/chính xương|ns
正朔=chính sóc|ns
正西=chính tây/chính tây|ns
正阳=Chính Dương/chính dương|ns
武乡=Vũ Hương|ns
武关=Vũ Quan|ns
武国=võ quốc|ns
武圣=Võ Thánh|ns
武城=võ thành|ns
武夷=Vũ Di|ns
武夷山=Vũ Di sơn/Vũ Di Sơn|ns
武安=Vũ An|ns
武川=Vũ Xuyên|ns
武庙=miếu Quan Công/miếu thờ Quan Công và Nhạc Phi|ns
武当山=núi Võ Đang|ns
武旦=vai đào võ|ns
武昌=Võ Xương|ns
武昌县=huyện Vũ Xương|ns
武汉=Vũ Hán|ns
武藏=võ tàng|ns
武藏野=Musashino|ns
武都=võ đô|ns
武阳=Vũ Dương|ns
武陵=Vũ Lăng|ns
武陵山=Vũ Lăng Sơn|ns
殿町=Tonomachi|ns
比丘=tì khưu/tỉ khưu/sư|ns
比利亚=Liberia/Villa|ns
比利时=Bỉ|ns
比利牛斯=Pyrénees/Dãy núi Pyrenees|ns
比勒陀利亚=Pretoria/Bỉ Lặc Đà Lợi Á|ns
比华利山=Beverly Hills|ns
比美=sánh bằng/sánh kịp/sánh tày|ns
毕达哥拉斯=Pitago|ns
毛里塔尼亚=Mauritania/Mao Tháp Ni Á|ns
毛里求斯=Mauritius/Mao Lí Cầu Tư|ns
永乐=Vĩnh Lạc|ns
永吉=Vĩnh Cát|ns
永固=vĩnh cố|ns
永宁=Vĩnh Ninh|ns
永安=Vĩnh Yên|ns
永川=Vĩnh Xuyên/Quận ngoại ô Vĩnh Xuyên của đô thị Trùng Khánh, trước đây thuộc Tứ Xuyên|ns
永州=Vĩnh Châu|ns
永平=Vĩnh Bình|ns
永庆=Vĩnh Khánh|ns
永康=vĩnh khang|ns
永徽=Vĩnh Huy|ns
永志=Vĩnh Chí|ns
永昌=vĩnh xương/Vĩnh hưng/Vĩnh Xương|ns
永春=Vĩnh Xuân|ns
永林=Vĩnh Lâm|ns
永海=Vĩnh Hải|ns
永眠=giấc ngủ ngàn thu/yên giấc ngàn thu|ns
永联=vĩnh liên|ns
永隆=Vĩnh Long/tỉnh Vĩnh Long|ns
汀上=trên bãi bồi|ns
汀兰=Đinh Lan|ns
汉中=Hán Trung|ns
汉口=Hán Khẩu|ns
汉园=Hán Viên|ns
汉城=Seoul/Hán Thành/Xê-un|ns
汉堡=Hamburger|ns
汉川=Hán Xuyên|ns
汉江=Hán Giang/Sông han|ns
汉阳=Hán Dương|ns
汉阳县=Hán dương huyện|ns
汕头=Sán Đầu|ns
汕头市=thành phố Sán Đầu|ns
汝南=Nhữ Nam|ns
汝门=các ngươi|ns
江东=Giang Đông|ns
江中=trong sông/trong nước/nước|ns
江乐=giang nhạc|ns
江云=Giang Vân|ns
江亚=Giang Á|ns
江充=Giang Sung|ns
江北=Giang Bắc|ns
江南=Giang Nam|ns
江原=Giang Nguyên|ns
江口=Giang Khẩu|ns
江名=Giang Danh|ns
江坤=Giang Khôn|ns
江城=Giang Thành/giang thành|ns
江堤=đê sông|ns
江夏=Giang Hạ|ns
江天=giang thiên/bầu trời rộng mở trên mặt sông|ns
江宁=Giang Ninh|ns
江山=giang sơn/đất nước/nước non|ns
江川=Giang Xuyên|ns
江州=Giang Châu|ns
江左=Giang Tả|ns
江干=bờ sông|ns
江底=đáy sông|ns
江户=Edo|ns
江户城=thành Edo|ns
江昂=Giang Ngang|ns
江水=nước sông|ns
江汉=Giang Hán|ns
江沙=Giang Sa|ns
江河=giang hà/sông lớn/Giang Hà/Trường Giang và Hoàng Hà|ns
江河日下=nước sông ngày một rút xuống/tình hình ngày một xấu đi/ngày càng lụn bại|ns
江河行地=không thể thay đổi/sông đi bộ|ns
江波=sóng sông|ns
江洲=Giang Châu|ns
江流=Giang Lưu|ns
江浦=Giang Phổ|ns
江浩廷=Giang Hạo Đình|ns
江海=giang hải|ns
江清海=Giang Thanh Hải|ns
江渚=bãi sông|ns
江湖=giang hồ/sông hồ|ns
江湖术士=giang hồ thuật sĩ/thầy bà/ông lên bà xuống|ns
江湾=vịnh sông|ns
江源=Giang Nguyên|ns
江滨=Giang Tân|ns
江畔=bờ sông|ns
江省=Giang tỉnh|ns
江纳兰=Giang Nạp Lan|ns
江苏=Giang Tô|ns
江街=phố Giang|ns
江西=Giang Tây|ns
江西省=tỉnh Giang Tây|ns
江都=Giang Đô|ns
江都县=huyện Giang Đô|ns
江门=Giang Môn|ns
江陵=Giang Lăng|ns
江齐=Giang Tề|ns
池塘=hồ nước/ao/đầm/bể tắm/bể nước/hồ bơi/cái ao|ns
汨汨=rò rỉ|ns
汴京=Biện Kinh|ns
汴口=Biện Khẩu|ns
汴州=Biện Châu|ns
汴梁=Biện Lương|ns
汴水=Biện thủy|ns
汶川=Vấn Xuyên|ns
汶河=Vấn Hà|ns
汾州=Phần Châu|ns
汾阳=Phần Dương|ns
沁园春=thấm viên xuân/Thấm Viên Xuân|ns
沁水=Thấm Thủy|ns
沂山=Nghi sơn|ns
沂州=Nghi Châu|ns
沂水=Nghi Thủy|ns
沂蒙山=núi Nghi Mông|ns
沂阳=Nghi Dương|ns
沅水=nguyên thuỷ/nước/Sông Yuan|ns
沅江=Nguyên Giang|ns
沈京=Thẩm Kinh|ns
沈园=Thẩm viên|ns
沈城=Thẩm Thành|ns
沈家=Thẩm gia|ns
沈洋=Thẩm Dương|ns
沈煌=Thẩm Hoàng|ns
沈甸甸=nặng trình trịch|ns
沈苏=Thẩm Tô|ns
沈阳=Thẩm Dương|ns
沔县=Miến huyện|ns
沙东=Sa Đông|ns
沙俄=Sa Hoàng|ns
沙内=trong cát|ns
沙加=Shaka|ns
沙区=Cát khu|ns
沙县=Sa huyện|ns
沙国=sa quốc|ns
沙土地=đất cát|ns
沙城=Sa thành|ns
沙堡=lâu đài cát|ns
沙山=núi cát|ns
沙州=Sa Châu|ns
沙沙=sàn sạt/xào xạc/sột soạt/soẹt soẹt rè rè|ns
沙沙沙=sa sa sa/sẹt sẹt sẹt|ns
沙河=Sa Hà|ns
沙洲=Sa Châu/Sa châu|ns
沙海=biển cát|ns
沙特阿拉伯=Saudi Arabia|ns
沙里=Charix|ns
沙陀=Sa Đà|ns
沛县=huyện Bái/Hạt Pei ở Từ Châu 徐州 [Xu2 zhou1], Giang Tô|ns
沧凉=thê lương|ns
沧州=Thương Châu|ns
沧桑=tang thương/bể dâu|ns
沧桑感=cảm giác tang thương|ns
沧江=Thương Giang|ns
沧沧=lạnh/lạnh lẽo|ns
沧浪=Thương Lãng|ns
沧海=biển cả/biển biếc/biển xanh/biển thẳm/thương hải|ns
沧海桑田=thương hải tang điền/cuộc bể dâu/thế sự xoay vần/bãi bể nương dâu/biến đổi lớn lao trong cuộc đời/biển xanh thành nương dâu|ns
沧源=Thương Nguyên|ns
沪东=Hỗ Đông|ns
沱水=Đà Thủy|ns
河东=Hà Đông|ns
河东狮=sư tử Hà Đông|ns
河东狮子=sư tử Hà Đông|ns
河伯=Hà Bá|ns
河前=Hà Tiền|ns
河北=Hà Bắc/tỉnh Hà bắc|ns
河北省=tỉnh Hà Bắc|ns
河南=Hà Nam/NAM/tỉnh Hà Nam/hà nam|ns
河南省=tỉnh Hà Nam/Tỉnh hà nam|ns
河口=cửa sông|ns
河图=Hà Đồ/hà đồ|ns
河坝=đê sông/đập sông|ns
河塘=Hà Đường|ns
河天=hà thiên|ns
河山=non sông/đất nước/nước sông|ns
河岳=non sông|ns
河川=sông ngòi|ns
河干=bến sông/hà can|ns
河底=đáy sông/lòng sông|ns
河曲=eo sông/khuỷu sông/khúc ngoặc của sông|ns
河水=nước sông|ns
河汉=sông ngân/ngân hà/lời nói khoác/khoác lác/lời nói suông|ns
河汊子=nhánh sông/sông nhánh/sông con|ns
河江=Hà Giang/tỉnh Hà Giang|ns
河池=Hà Trì/thành phố cấp tỉnh Hechi ở Quảng Tây|ns
河沙=cát sông|ns
河沟=lạch ngòi/sông suối/sông ngòi|ns
河洛=hà lạc|ns
河渠=sông/sông ngòi|ns
河港=cảng sông|ns
河湾=khúc sông/ngoặt sông|ns
河滨=sông nhỏ|ns
河滩=bãi sông|ns
河畔=bờ sông|ns
河肥=bùn sông/phù sa|ns
河西=Hà Tây|ns
河西走廊=hành lang Hà Tây|ns
河谷=lũng sông/lòng chảo sông/lòng chảo|ns
河里=trong sông|ns
河阳=Hà Dương|ns
河马=hà mã|ns
河鲜=tôm cá tươi|ns
治国=trị quốc|ns
治安=trị an/an ninh trật tự|ns
治安科=trị an khoa/khoa trị an|ns
治本=trị tận gốc/giải quyết tận gốc/trị gốc|ns
沾边=dính dáng/tiếp xúc/sát thực tế/sát sự thật|ns
沿河=dọc theo sông|ns
沿海地区=vùng duyên hải|ns
泉县=Tuyền huyện|ns
泉州=Tuyền Châu|ns
泉水=nước suối/suối nước|ns
泉池=hồ suối/suối nước|ns
泉美=Izumi|ns
法兰=Flange/Pháp Lan|ns
法兰克=Frank|ns
法兰西=Pháp/Pháp quốc/Pháp/Pháp Lan Tây/France|ns
法兰西共和国=Cộng hoà Pháp|ns
法兰西岛=Île-de-France|ns
法兰西斯=Francis/Françoise/|ns
法典=pháp điển/bộ luật/sách luật/luật điển|ns
法利亚=Faria|ns
法利斯=Faris|ns
法华寺=Pháp Hoa Tự|ns
法古=noi theo người xưa/học tập người xưa|ns
法国=nước Pháp/Pháp quốc/Pháp/France|ns
法圣=pháp thánh|ns
法尔=Fares/Farl|ns
法尔克=Falke|ns
法尔斯=Fars|ns
法尔科=Falco|ns
法尔考=Falcao|ns
法属圭亚那=French Guiana|ns
法属波利尼西亚=Polynesia thuộc Pháp|ns
法布尔=Fabre|ns
法布提=Fárbauti|ns
法度=chuẩn mực/pháp luật/chế độ pháp lệnh/chuẩn mực hành vi/quy củ/phép tắc/pháp độ|ns
法德=Pháp Đức|ns
法戈=Fargo/Pháp Qua|ns
法拉=Farad|ns
法拉利=Ferrari|ns
法斯=Pháp Tư|ns
法比安=Fabian/Fabien|ns
法洛斯=Fallows/Pháp Lạc Tư|ns
法海=Pháp Hải|ns
法特=Pháp Đặc|ns
法甲=Ligue 1|ns
法米利昂=Vermillion|ns
法耳=pháp nhĩ|ns
法西斯=phát xít/chủ nghĩa phát xít/Phát xít|ns
法里内利=Farinelli|ns
法门=pháp môn/cửa Phật/Phật môn/phương pháp/cách thức|ns
法门寺=Pháp Môn tự|ns
法隆=Faron|ns
法鲁克=Farooq|ns
泗水=Tứ Thuỷ|ns
泛海=vượt biển/biển|ns
波东=Ba Đông|ns
波什=Ba Thập|ns
波兰=Ba Lan|ns
波兹南=Poznań/Poznan|ns
波兹坦=Potsdam/Potsdam, Đức|ns
波利=Bori|ns
波利亚=Polliat|ns
波利尼西亚=Polynesia|ns
波利斯=Police|ns
波利特=Polit|ns
波及=tác động đến/lan đến/ảnh hưởng đến/liên lụy|ns
波哥大=Bogota/Ba Ca Đại|ns
波塞=ba tắc|ns
波多黎各=Puerto Rico/Puerto Rico, lãnh thổ chưa hợp nhất tự quản của Hoa Kỳ|ns
波尔=Pol/Bhor|ns
波尔卡=điệu polka|ns
波尔多=Bordeaux|ns
波峰=đỉnh sóng|ns
波布=Bob|ns
波希米亚=Bohème|ns
波德=Pod|ns
波拉=Paula|ns
波拉克=Pollock|ns
波拿巴=Bonaparte|ns
波斯=Ba Tư|ns
波斯尼亚=Bosna|ns
波斯湾=vịnh Ba Tư|ns
波比=Bobbin|ns
波洛克=Pollock|ns
波特=Potter|ns
波特兰=Portland|ns
波累=liên lụy/dính dáng/dính líu/liên luỵ|ns
波罗=Paolo/Ba La|ns
波罗的海=biển Baltic/Biển Baltic|ns
波谷=bụng sóng|ns
波顿=Ba Đốn|ns
波鲁萨利诺=Borsalino|ns
泥犁=Nê Lê|ns
泰伦=Thái Luân|ns
泰兰=Thái Lan/Tellin|ns
泰兴=thái hưng|ns
泰利=Terry|ns
泰国=Thái Lan/Thái/Xiêm/Xiêm La/Thailand/Thái quốc|ns
泰坦=Titan|ns
泰坦尼克=Titanic|ns
泰城=Thái thành|ns
泰宁=Thái Ninh/Hạt ở Sanming 三明 [San1 ming2], Phúc Kiến|ns
泰安=Thái An|ns
泰山=Thái Sơn|ns
泰州=Thái Châu/thành phố cấp tỉnh Taizhou ở Giang Tô|ns
泰斯=Thái Tư|ns
泰昌=Thái Xương|ns
泰晤士河=sông Thames|ns
泰朗=Tyrone|ns
泰来=thái lai|ns
泰水=nhạc mẫu/mẹ vợ|ns
泰江=Thái Giang|ns
泰王国=vương quốc Thái|ns
泰西=phương Tây|ns
泰迪罗宾=Teddy Robin|ns
泰阿=Thái A|ns
泰雅=Thái Nhã|ns
泸州=Lô Châu|ns
泸州大曲=rượu trắng Lô Châu|ns
泸水=Lô thủy|ns
泽国=trạch quốc/bưng biền/ao hồ đầm lầy/vùng ngập lụt/vùng lụt/vùng ngập nước|ns
泾河=Kinh Hà/Kính Hà|ns
泾渭=Kinh Vị|ns
泾王=Kính Vương|ns
洋洋=dào dạt/mênh mông/phong phú/dương dương tự đắc/vênh vang/dương dương|ns
洛亚=Roa|ns
洛京=Lạc Kinh|ns
洛伦=Loron|ns
洛伦兹=Lorenz|ns
洛伦索=Lorenzo|ns
洛伯=Lạc bá|ns
洛克=Locke|ns
洛兰=Lạc Lan|ns
洛加=Loga/Lạc Gia|ns
洛北=Lạc Bắc|ns
洛哈=Lockhart|ns
洛哥=Lạc ca|ns
洛城=Lạc Thành|ns
洛尔=Lạc Nhĩ|ns
洛山达=Lathander|ns
洛川=Lạc Xuyên/Quận Luochuan ở Yan'an 延安 [Yan2 an1], Thiểm Tây|ns
洛斯=Lạc Tư|ns
洛普斯=Lạc Phổ Tư|ns
洛朗=Laurent|ns
洛杉矶=Los Angeles|ns
洛林=Rorein|ns
洛比=Lạc Bỉ|ns
洛水=Lạc Thủy|ns
洛水北=Lạc Thủy Bắc|ns
洛沙=Lạc Sa|ns
洛河=Lạc Hà|ns
洛波=Lopo|ns
洛萨=Lothar|ns
洛西=Lạc Tây|ns
洛邑=Lạc Ấp|ns
洛都=Lạc Đô|ns
洛阳=Lạc Dương|ns
洛阳城=thành Lạc Dương|ns
洛马=Lockheed Martin|ns
洛高=Logau|ns
洞庭湖=Động Đình hồ|ns
洞里=trong động|ns
津城=Tân thành|ns
津巴布韦=Zimbabwe/Dimbabue|ns
津梁=bến đò và cầu|ns
津津=say sưa/hứng thú/chảy|ns
津港=Tân cảng|ns
津门=tân môn|ns
洪荒=Hồng Hoang|ns
洪都=Hồng Đô|ns
洪都拉斯=Honduras/Hondurat|ns
洪门=Hồng môn|ns
派翠西亚=Patricia|ns
流沙河=sông Lưu Sa|ns
浅海=biển cạn|ns
济北=Tế Bắc|ns
济南=Tế Nam|ns
济宁=Tế Ninh|ns
济州=Tế Châu|ns
济州岛=đảo Jeju/Tỉnh tự trị đặc biệt đảo Jeju, Hàn Quốc, một Di sản Thế giới|ns
济度=tế độ/cứu giúp chúng sinh ra khỏi bể khổ/giúp đỡ/cứu trợ|ns
济水=Tế Thuỷ/Sông Ji, con sông cũ của đông bắc Trung Quốc đã biến mất sau khi sông Hoàng Hà bị ngập lụt vào năm 1852|ns
济济=nhiều/đông đúc/sẵn có|ns
济科=Tể Khoa|ns
浏河=Lưu Hà|ns
浏海=tóc mái/Biển Luhai/Tóc mái/mái|ns
浑古=thật thà chất phác|ns
浑敦=hồn đôn|ns
浔阳=Tầm Dương|ns
浙北=Chiết Bắc|ns
浙南=Chiết Nam|ns
浙大=Chiết Đại|ns
浙州=Chiết châu|ns
浙江=Chiết Giang|ns
浙海=Chiết Hải|ns
浙省=Chiết Giang|ns
浙西=Chiết Tây|ns
浦东=Phổ Đông|ns
浦原=Urahara|ns
浦和=phổ hòa|ns
浦西=Bãi Biển Phía Tây|ns
浩博=phong phú/nhiều/rất nhiều/dồi dào/số lượng lớn|ns
浩江=Hạo Giang|ns
浩海=biển lớn/hạo hải|ns
浩翰=mênh mông|ns
浮山=Phù Sơn|ns
海东=Hải Đông|ns
海关=hải quan/quan thuế|ns
海利=Hải Lợi|ns
海加尔山=núi Hyjal|ns
海南=Hải Nam|ns
海南岛=đảo Hải Nam|ns
海国=hải quốc|ns
海埂=bờ biển/bến cảng|ns
海城=hải thành/Hải Thành|ns
海塘=đê biển/đê ngăn biển/đê chắn biển|ns
海宁=Hải Ninh|ns
海山=Hải Sơn|ns
海岛=hải đảo/đảo/hòn đảo|ns
海岭=núi dưới biển/dãy núi dưới đáy biển|ns
海峡=eo biển|ns
海州=Hải Châu|ns
海市=hải thị|ns
海归=du học về/hải quy (*du học về)|ns
海得拉巴=Hyderabad|ns
海拉尔河=sông Argun|ns
海晏河清=trời yên biển lặng/thiên hạ thái bình|ns
海江=Hải Giang|ns
海沙=hải sa|ns
海沟=rãnh biển/lòng chảo/hõm sâu đáy biển/hải câu|ns
海河=Hải Hà|ns
海洋=hải dương/biển/biển cả/đại dương|ns
海淀区=Hải Điến Khu|ns
海港=hải cảng/cảng biển|ns
海湾=vịnh biển/vịnh|ns
海滨=ven biển/miền biển/bờ biển/vùng biển/sát mé biển/hải tân|ns
海滩=bãi biển|ns
海牙=Hague/Den Haag|ns
海疆=hải cương/hải phận/vùng biển/biên giới vùng biển/lãnh hải|ns
海纳=hải nạp|ns
海西=hải tây|ns
海阳=Hải Dương/tỉnh Hải Dương|ns
海陵=Hải Lăng|ns
海顿=Haydn/Hải Đốn/Haydon|ns
海马=hải mã|ns
海鲜=hải sản/đồ tươi/hải vị/hải sản tươi|ns
涅槃=Niết Bàn/niết bàn/Niết bàn|ns
涅瓦河=sông Neva/Nyeva hoặc sông Neva|ns
涅白=trắng đục/màu trắng đục|ns
涅盘=Niết Bàn|ns
涑水=Thúc Thủy|ns
润丽=trơn bóng mỹ lệ/trơn đẹp|ns
涧溪=khe suối|ns
涿县=Trác huyện|ns
涿州=Trác Châu/thành phố cấp quận Zhuozhou ở Bảo Định 保定 [Bao3 ding4], Hà Bắc|ns
涿郡=Trác quận|ns
涿鹿=Trác Lộc|ns
淄重=vật tư quân dụng|ns
淅江=Tích Giang|ns
淌口水=chảy nước miếng/để nước bọt chảy ra từ miệng|ns
淌水=nước chảy|ns
淡泊名利=không màng danh lợi|ns
淡泊明志=không màng lợi danh, định rõ chí hướng|ns
淮北=Hoài Bắc|ns
淮南=Hoài Nam|ns
淮南子=Hoài Nam Tử|ns
淮安=Hoài An|ns
淮山=hoài sơn|ns
淮扬=Hoài Dương|ns
淮江=Hoài Giang|ns
淮河=sông Hoài|ns
淮海=Hoài Hải|ns
淮源=Hoài Nguyên|ns
淮阳=Hoài Dương|ns
淮阴=Hoài Âm|ns
深井=giếng sâu|ns
深南=Thâm Nam|ns
深圳=Thâm Quyến|ns
深坑=hố sâu|ns
深宫=thâm cung|ns
深山=thâm sơn/núi sâu/núi thẳm|ns
深山中=trong núi sâu/trong núi thẳm|ns
深山大泽=thâm sơn đại trạch/núi sâu đầm lớn|ns
深山老林=rừng sâu núi thẳm|ns
深川=Thâm Xuyên|ns
深州=Thâm Châu|ns
深巷=ngõ sâu|ns
深度=chiều sâu/độ sâu/mức độ/bề sâu|ns
深恩=ân sâu|ns
深文周纳=cố ý buộc tội|ns
深春=cuối xuân|ns
深水=nước sâu|ns
深水港=Thâm thủy cảng|ns
深沟=rãnh sâu|ns
深海=biển sâu/thâm hải|ns
深涧=khe sâu|ns
深渊=vực sâu/vực thẳm/Thâm Uyên|ns
深湖=hồ sâu thăm thẳm|ns
深潭=đầm sâu/hồ sâu|ns
深省=tỉnh ngộ|ns
深藏=thâm tàng/ẩn sâu|ns
深谷=thâm cốc|ns
深麦色=màu vàng sậm|ns
深黑=thâm đen/sâu và đen/thâm hắc|ns
清凉山=Thanh Lương sơn|ns
清宁=thanh tĩnh|ns
清州=Thanh châu|ns
清水湾=thanh thủy vịnh/Vịnh Thanh Thủy|ns
清江=Thanh giang|ns
清沙=Thanh Sa|ns
清河=Thanh Hà|ns
清源山=Thanh Nguyên Sơn|ns
清溪=thanh khê/khe suối trong vắt/khe suối trong veo|ns
清潭=thanh đàm|ns
清阳=Thanh Dương|ns
渑池=thành trì|ns
渝水=Du thủy|ns
渡桥=cầu tạm|ns
渡江=vượt sông|ns
渡河=qua sông|ns
渡海=vượt biển|ns
渤海=Bột Hải|ns
渥太华=Ottawa/Ác Thái Hoa|ns
渥金=Ác Kim|ns
温县=Ôn Huyện|ns
温州=Ôn châu|ns
温得和克=Windhoek/Ôn Đắc Hòa Khắc|ns
温海=Ôn Hải|ns
温阳=Ôn Dương|ns
渭川=Vị Xuyên|ns
渭水=Vị Thủy|ns
渭湖=Vị Hồ|ns
港湾=cảng/bến cảng/bến tàu/cảng loan|ns
湄公河=sông Mekong/Sông MeKong|ns
湄南河=sông Mi Nam|ns
湖北=Hồ Bắc|ns
湖北省=tỉnh Hồ Bắc|ns
湖南=Hồ Nam|ns
湖南省=tỉnh Hồ Nam|ns
湖口=Hồ Khẩu|ns
湖州=Hồ Châu|ns
湖底=đáy hồ|ns
湖心亭=đình giữa hồ|ns
湖心岛=đảo giữa hồ|ns
湖水=nước hồ/hồ nước|ns
湖泊=hồ nước/ao hồ/hồ|ns
湖泽=đầm/hồ/hồ trạch|ns
湖海=biển hồ/hồ hải|ns
湖滨=quanh hồ|ns
湖滩=bãi/bãi ven hồ|ns
湖田=ruộng trũng/ruộng gần hồ|ns
湖畔=ven hồ|ns
湖荡=hồ|ns
湖西村=hồ tây thôn|ns
湖阳=Hồ Dương|ns
湘云=Tương Vân|ns
湘兰=Tương Lan|ns
湘北=Tương Bắc|ns
湘南=Tương Nam|ns
湘庐=Tương Lư|ns
湘江=Tương Giang|ns
湘省=Tương tỉnh|ns
湘竹=Tương Trúc|ns
湘西=Tương Tây|ns
湛卢=Trạm Lư|ns
湾区=bến tàu/Vùng Vịnh|ns
湾湾=Đài Loan|ns
溧水=Lật Thủy|ns
溪国=Khê Quốc|ns
溪沟=khê câu|ns
滇池=Điền Trì/hồ Côn Minh|ns
滑利=nhẵn/phẳng/bôi trơn/làm trơn|ns
滑坡=đất lở/sạt núi/lở núi/giảm/hạ/xuống dốc/tuột dốc/đất lở|ns
满口=miệng đầy|ns
满口答应=đầy miệng đáp ứng/sẵn sàng đồng ý|ns
满嘴=miệng đầy|ns
满园=cả vườn|ns
满园春色=mãn viên xuân sắc/đầy vườn mùa xuân/mọi thứ trong vườn đều đáng yêu|ns
满城=toàn thành/cả thành/khắp thành|ns
满大街=đi đầy đường/đầy đường|ns
满头大汗=đầu đầy mồ hôi|ns
满屋=đầy phòng/đầy nhà|ns
满山=khắp núi|ns
满州=Mãn Châu|ns
满意度=độ hài lòng|ns
满汉=Mãn Hán|ns
满洞=khắp động|ns
满洲=Mãn Châu|ns
满街=đầy đường|ns
满门=cả nhà/toàn gia|ns
滦平=Loan Bình|ns
滨崎步=Ayumi Hamasaki|ns
滨州市=Tân Châu thị|ns
滨江=Tân Giang/bờ sông|ns
滨海=Tân Hải|ns
漓儿=Li nhi|ns
漓江=Ly Giang|ns
漕河=đường sông vận chuyển lương thực|ns
漠北=Mạc Bắc|ns
漠南=Mạc Nam/Nội Mông|ns
漠河=Mạc Hà|ns
漠漠=mạc mạc/mây mù/dày đặc/vắng vẻ/tĩnh mịch|ns
漫山=khắp núi|ns
漳州=Chương Châu/thành phố cấp tỉnh Chương Châu ở Phúc Kiến|ns
漳水=Chương Thủy|ns
潇湘=Tiêu Tương|ns
潇湘子=Tiêu Tương Tử|ns
潭柘寺=Đàm Chá Tự/Đền Tanzhe|ns
潭里=trong đầm/trong đàm|ns
潮州=Triều Châu|ns
潮汕=Triều Sán|ns
潮汕地区=địa khu Triều Sán/khu vực Triều Sán|ns
潮白=đường hoa mai|ns
潼关=Đồng Quan|ns
澄城=Trừng Thành|ns
澄沙=bột đậu lọc|ns
澄波=trừng ba|ns
澎拜=bành bái|ns
澜儿=Lan nhi|ns
澜姐=Lan tỷ|ns
澜州=Lan Châu|ns
澜月=lan nguyệt|ns
澜沧=Lan Thương|ns
澜风=Lan Phong|ns
澳大利=Úc Đại Lợi|ns
澳大利亚=Australia|ns
澳洲=Châu Úc|ns
澳门=Macao|ns
濑户内海=biển nội địa Seto/biển nội địa|ns
濮阳=Bộc Dương|ns
瀛州=Doanh Châu|ns
瀛洲=Doanh Châu|ns
瀛海=đại hải/biển lớn|ns
灌南=quán nam|ns
灌木林=cây cối/bụi cây/lùm cây|ns
灞桥=bá cầu/Cầu Thước/Baqiao District of Xi’an 西安市 [Xi1 an1 Shi4], Thiểm Tây|ns
火地岛=Tierra del Fuego|ns
火奴鲁鲁=Honolulu/Honnolulu|ns
火山岛=Hỏa Sơn đảo|ns
火海=biển lửa/hỏa hải/hoả hải|ns
火海刀山=rừng dao biển lửa/nơi vô cùng nguy hiểm|ns
火罗=Hỏa La|ns
灵丘=Linh Khâu/Quận Lingqiu ở Datong 大同 [Da4 tong2], Shanxi|ns
灵丹=linh đan|ns
灵圣=linh thánh/Linh thánh|ns
灵山=Linh Sơn/linh sơn|ns
灵川=linh xuyên/Linh Xuyên/Quận Lĩnh Xuyên ở Quế Lâm 桂林 [Gui4 lin2], Quảng Tây|ns
灵州=linh châu|ns
灵牙=Linh Nha|ns
灵狮=linh sư|ns
灵雾山=Linh Vụ Sơn|ns
炎州=Viêm Châu|ns
炎洲=Viêm Châu|ns
炭黑=than đen|ns
烟岚=Yên Lam|ns
烟海=biển khói/mặt biển mù sương/yên hải|ns
烟瑶=Yên Dao|ns
烟蒙=khói mù|ns
热河=Nhiệt Hà/Rehe, tỉnh của triều đại nhà Thanh bị bãi bỏ vào năm 1955 và chia cho Hà Bắc, Liêu Ninh và Nội Mông|ns
热海=nhiệt hải|ns
热那亚=Nhiệt Na Á|ns
焉儿=Yên nhi|ns
焉得=nào đáng|ns
焉知=làm sao biết/ai biết|ns
焉能=làm sao có thể|ns
焦山=Tiêu Sơn|ns
焦比=tỉ lệ than cốc|ns
焦黑=cháy đen/cháy sém/cháy khét/nám đen|ns
煌煌=huy hoàng/xán lạn/sáng/sáng sủa/sáng rực|ns
燕京=Yên Kinh|ns
燕园=Yến Viên|ns
燕国=Yến quốc|ns
燕尾=đuôi én|ns
燕山=Yên sơn|ns
燕州=Yến Châu|ns
燕市=Yến thị|ns
燕江=Yến giang|ns
燕海=Yến Hải|ns
燕省=Yến tỉnh|ns
燕西=Yến Tây|ns
燕都=Yến đô|ns
燕非=Yến Phi|ns
爪哇=Java|ns
爪牙=nanh vuốt/tay sai/tay chân/chó săn|ns
爱丁堡=Ái Đinh Bảo [Edinburgh]|ns
爱国=ái quốc/yêu nước|ns
爱屋及乌=yêu ai yêu cả đường đi/thương thì củ ấu cũng tròn/vì yêu người mà yêu luôn cả ngôi nhà cả con quạ đậu trên nóc nhà của người mình yêu/yêu chim yêu cả lồng/yêu cây yêu cả cành/ái ốc cập ô|ns
爱岗=ái cương/tình yêu cương/tình yêu cương vị|ns
爱川=Aikawa|ns
爱川罗武=Aikawa Rabu|ns
爱沙尼亚=Estonia|ns
爱河=bể tình/bể tình ái/biển tình/bể ái|ns
爱琴海=biển Aegean/Aegean Sea|ns
爱美=thích chưng diện/thích hào nhoáng/thích đẹp|ns
爱马=ái mã|ns
牙买加=Jamaica/Nha Mãi Gia|ns
牙关=hàm răng/khớp hàm|ns
牙根=hàm răng|ns
牙牙=bập bẹ/bi bô/ê a|ns
牛哇=ngưu oa|ns
牛高马大=ngưu cao mã đại/trâu cao ngựa lớn|ns
牡丹=mẫu đơn/cây mẫu đơn/hoa mẫu đơn/Mẫu Đơn|ns
牡丹亭=Mẫu Đơn đình|ns
特仑斯=Terence|ns
犍牛=trâu bò|ns
犹他=Utah|ns
犹他州=bang Utah/Utah|ns
独山=độc sơn|ns
独木桥=cầu độc mộc/cầu khỉ/con đường gian nan|ns
独立国=nước độc lập|ns
独立王国=vương quốc độc lập|ns
独角龙=Độc Giác Long|ns
狮子山=núi Sư Tử|ns
狼堡=Lang bảo/Wolfsburg|ns
狼山=Lang Sơn|ns
狼窟=hang sói|ns
狼耳=tai sói|ns
狼马=lang mã|ns
猛拉=kéo mạnh|ns
猛省=bừng tỉnh/sực tỉnh/chợt hiểu ra|ns
猛虎下山=mãnh hổ hạ sơn|ns
玄关=cửa trước/huyền quan|ns
玉京=Ngọc Kinh|ns
玉徽=Ngọc Huy|ns
玉河=Ngọc Hà|ns
玉海=Ngọc Hải|ns
玉溪市=Ngọc khê thị|ns
玉门关=Ngọc Môn quan|ns
玉阜=bờ môi|ns
玉龙雪山=Ngọc Long Tuyết Sơn|ns
王国=vương quốc/quốc gia|ns
玛利亚=Maria|ns
玛沙=Mã Sa|ns
环海=toàn biển|ns
玻利维亚=Bolivia/Pha Lợi Duy Á|ns
珍珠港=Trân Châu Cảng/Trân Châu cảng|ns
珍藏=trân tàng/cất kỹ/cất giấu kỹ/cất giấu vật quý giá/cất giấu|ns
珍阳=Trân Dương|ns
珠宝店=tiệm châu báu/cửa hàng châu báu|ns
珠峰=Everest/Châu Phong|ns
珠江=Châu Giang|ns
珠江口=cửa sông Châu Giang|ns
珠海=Châu Hải|ns
珠穆朗玛峰=Everest|ns
珠联璧合=châu liên bích hợp/quần anh tụ hội/trai gái xứng đôi vừa lứa|ns
珲春=Hồn Xuân|ns
琅嬛福地=Lang Hoàn phúc địa|ns
琉璃瓦=ngói lưu ly|ns
琛哥=Sâm ca|ns
琼云=Quỳnh Vân|ns
琼国=Quỳnh quốc|ns
琼宫=Quỳnh cung|ns
琼山=Quỳnh Sơn/Quận Qiongshan của thành phố Hải Khẩu 海口 市 [Hai3 kou3 shi4], Hải Nam|ns
琼崖=Quỳnh Nhai|ns
琼州=Quỳnh Châu|ns
琼楼=quỳnh lâu|ns
琼海=Quỳnh Hải|ns
琼脂=thạch trắng/A-ga/rau câu|ns
瑞云=Thụy Vân|ns
瑞亚=Rhea|ns
瑞克=Rick|ns
瑞兴=Thụy Hưng|ns
瑞典=Thụy Điển|ns
瑞利=Rayleigh|ns
瑞卡=Thụy Tạp|ns
瑞坦=Thụy Thản|ns
瑞士=Thụy Sĩ|ns
瑞安=Thụy An|ns
瑞斯=Just|ns
瑞林=Thụy Lâm|ns
瑞根=Reagan|ns
瑞金=Thụy Kim|ns
璧人=bích nhân|ns
璧合珠联=bích hợp châu liên/trai tài gái sắc|ns
璧月=bích nguyệt/trăng ngọc|ns
璧谢=xin gửi lại và đa tạ|ns
璧赵=hoàn trả nguyên vẹn|ns
瓜州=Qua Châu|ns
瓦伦西亚=Valencia|ns
瓮中=trong hũ/trong rổ|ns
瓮城=ủng thành|ns
瓮里=trong rổ|ns
甘丹=Cam Đan|ns
甘宁=Cam Ninh|ns
甘州=Cam Châu|ns
甘巴=Kampar|ns
甘拜下风=cam bái hạ phong/chịu thua/chịu lép vế/bái phục/bái phục chịu thua|ns
甘本=Gambon|ns
甘比诺=Gambino|ns
甘泉=cam tuyền/suối ngọt|ns
甘美=thơm ngọt/ngọt thơm|ns
甘肃=Cam Túc|ns
留得青山=lưu được núi xanh|ns
留洋=du học|ns
留马驿=Lưu Mã Dịch|ns
番休=thay phiên nhau nghỉ ngơi|ns
番国=phiên quốc|ns
番天=phiên thiên|ns
番瓜=bí rợ/bí ngô/bí đỏ|ns
番禺=Phiên Ngung/Quận Phiên Ngung ở tỉnh Quảng Đông|ns
番邦=phiên bang/nước ngoài/ngoại tộc|ns
畹凤=Uyển Phượng|ns
登山=leo núi/lên núi/du sơn|ns
登山越岭=trèo đèo lội suối|ns
登州=Đăng Châu|ns
登极=đăng cơ/đăng cực/lên ngôi|ns
登门=đến nhà/đăng môn/đến nhà/tới cửa|ns
白令海峡=eo biển Bering|ns
白俄罗斯=Belarus|ns
白兰度=Brando|ns
白城=Thành White/thành phố cấp tỉnh Baicheng ở tỉnh Cát Lâm 吉林省 ở đông bắc Trung Quốc|ns
白头山=Bạch Đầu Sơn/núi Bạc đầu|ns
白嫩=trắng nõn/trắng noãn/trắng mịn/nõn nà|ns
白山=Bạch Sơn|ns
白山黑水=bạch sơn hắc thuỷ/vùng Đông bắc Trung quốc|ns
白水县=huyện Bạch Thủy|ns
白沟=Bạch Câu/bạch câu|ns
白河=Bạch Hà|ns
白滨=Shirahama|ns
白牙=răng trắng/Bạch Nha|ns
白脉=Bạch mạch|ns
白苏=bạch tô|ns
白跑=đi không được gì/bạch bào|ns
白阳=Bạch Dương|ns
白陀=Bạch Đà|ns
白马=bạch mã/con ngựa trắng/ngựa trắng|ns
白马非马=ngựa trắng không phải ngựa|ns
百川=trăm sông/bách xuyên|ns
百川归海=trăm sông đổ về một biển/mọi sự vật quay về một mối/đồng lòng/cùng hướng về mục đích chung|ns
百米赛跑=thi chạy trăm mét|ns
百花山=Bách Hoa sơn|ns
百花洲=Bách Hoa Châu|ns
的黎波里=Tripoli|ns
皇国=hoàng quốc|ns
皇浦=Hoàng Phổ|ns
盂兰=Vu Lan|ns
盂兰盆会=lễ Vu Lan|ns
盈千累万=nhiều/vô số/nhiều vô số kể|ns
益州=Ích Châu|ns
益阳=Ích Dương/thành phố cấp tỉnh Yiyang ở Hồ Nam|ns
盐城=Diêm thành|ns
盐海=biển muối/Biển Muối|ns
盐湖=hồ nước mặn|ns
盐都=Diêm đô/muối|ns
监国=giám quốc/giam quốc|ns
盘古=Bàn Cổ|ns
盘尼西林=Penixilin|ns
盘山=vòng quanh núi/bàn sơn|ns
盘川=lộ phí/chi phí đi đường|ns
盘根=cuộn rễ|ns
盛京=Thịnh Kinh|ns
盱眙=Hu Dị|ns
盱衡=giương mày trợn mắt/quan sát phân tích|ns
直布罗陀=Gibraltar/Gilbratar|ns
直根=rễ cái/rễ chính|ns
直隶=trực tiếp phụ thuộc|ns
相国=tướng quốc|ns
眉山=mi sơn/Mi Sơn/thành phố cấp tỉnh Meishan ở Tứ Xuyên|ns
眠花宿柳=trêu hoa ghẹo liễu|ns
石丘=gò đá|ns
石匣=hộp đá|ns
石城=thành đá|ns
石堡=thạch bảo|ns
石头城=Thạch Đầu Thành|ns
石头山=đá núi/Thạch Đầu sơn/Thạch đầu sơn|ns
石山=núi đá|ns
石川=Thạch Xuyên|ns
石敦=thạch đôn|ns
石桥=cầu đá/cầu làm bằng đá|ns
石河=Thạch Hà|ns
石海=biển thiên thạch|ns
石矶=Thạch Cơ|ns
石门口=cửa đá|ns
石马=ngựa đá|ns
碧海=biển xanh/bích hải|ns
磅沱=bàng đà|ns
磐山=bàn sơn|ns
礼拜=lễ bái/tuần lễ/cúng lễ/tuần/thứ/ngày thứ/chủ nhật/ngày chủ nhật|ns
祁兰=Kỳ Lan|ns
祁山=Kỳ Sơn|ns
祁连山=Kỳ Liên sơn|ns
祁连山脉=dãy núi Kỳ Liên/Dãy núi Kỳ Liên/Dãy núi Qilian|ns
神丹=thần đan|ns
神圣=thần thánh/thiêng liêng|ns
神圣罗马=[Thần Thánh La Mã]|ns
神奈川县=tỉnh Kanagawa|ns
神山=Thần Sơn|ns
神崎=Kanzaki|ns
神州=Thần Châu|ns
神根岛=đảo Kamine|ns
神洲=Thần Châu|ns
祥东=Tường Đông|ns
祥云=tường vân|ns
祥哥=Tường ca|ns
祥源=Tường Nguyên|ns
福中=trong phúc|ns
福井=Fukui|ns
福伯=Phúc bá|ns
福克=Fock/Phúc Khắc|ns
福克兰=Falkland|ns
福克兰群岛=Quần đảo Falkland|ns
福兰=Frank|ns
福冈=Fukuoka/Fukuoka, thành phố ở Kyushu, Nhật Bản|ns
福利=phúc lợi/mang lại lợi ích/từ thiện|ns
福原=Phúc Nguyên|ns
福地=phúc địa/đất lành/cõi phúc|ns
福地洞天=phúc địa động thiên|ns
福城=Phúc Thành|ns
福大=phúc lớn|ns
福安=Phúc Yên|ns
福寿=phúc thọ|ns
福尔摩斯=Holmes|ns
福尔马林=Formalin|ns
福岛=Fukushima|ns
福州=Phúc Châu|ns
福布斯=Forbes|ns
福建=Phúc Kiến|ns
福建省=tỉnh Phúc kiến|ns
福朗=Forens|ns
福楼拜=Foluby|ns
福源=phúc nguyên|ns
福特=Ford|ns
福田=Phúc Điền|ns
福至=phúc chí|ns
福里=Phủ Lý|ns
福隆=Phước Long|ns
禹城=Vũ thành|ns
禹州=Vũ Châu|ns
离京=rời kinh|ns
离县=rời huyện|ns
离岛=rời đảo/đảo nhỏ|ns
离群索居=bỏ đàn sống riêng/bỏ đàn/xa rời quần chúng|ns
离耳=Ly Nhĩ|ns
离那=cách này|ns
秀城=Tú Thành|ns
秀山=tú sơn/núi cao|ns
秀川=Tử Xuyên|ns
秀茵=Tú Nhân|ns
科亚=Colla/Coyah|ns
科南=Conand|ns
科罗拉多州=bang Colorado/Colorado|ns
科西嘉岛=đảo Corsica|ns
秘奥=bí ảo|ns
秘藏=bí tàng|ns
秘鲁=Peru|ns
秦关=Tần Quan|ns
秦国=Tần quốc|ns
秦地=Tần địa|ns
秦城=tần thành|ns
秦山=Tần Sơn|ns
秦川=Tần Xuyên|ns
秦州=Tần Châu|ns
秦洋=Tần Dương|ns
秦淮河=sông Tần Hoài|ns
秦都=Tần Đô|ns
秦非=Tần Phi|ns
秦黎=Tần Lê|ns
秭归=Tỉ Quy|ns
积玉堆金=của cải chất núi|ns
稀古=hi cổ|ns
突尼斯=Tunisia/Tuynidi|ns
立国=lập quốc/xây dựng tổ quốc|ns
立马=lập tức/bật người/ngay tức khắc|ns
竟陵=Cánh Lăng|ns
端庄=đoan trang/lễ độ/đoan chính|ns
端阳=Đoan Dương/Đoan Ngọ|ns
竹山=Trúc Sơn|ns
竹海=biển trúc/trúc hải|ns
笔顺=bút thuận|ns
符拉迪沃斯托克=Vladivostok|ns
第三国=nước thứ ba|ns
第欧根尼=Diogenes|ns
第比利斯=Tbilisi/Đệ Bỉ Lợi Tư|ns
箭海=tiễn hải|ns
篙头=sào/cây sào|ns
篙子=sào/cây sào/sào phơi đồ/sào phơi quần áo|ns
米亚=Mia/Mễ Á|ns
米兰=Milan|ns
米内罗=Mineiro|ns
米南=Mễ Nam|ns
米店=tiệm gạo|ns
米欧=Mễ Âu|ns
米花町=Beika-chou|ns
米苏=Mễ Tô|ns
米达麦亚=Mittermeier|ns
粤东=Quảng Đông|ns
粤州=Việt Châu|ns
粤省=Việt tỉnh|ns
粤西=Quảng Tây|ns
素罗=Tố La|ns
素茵=Tố Nhân|ns
索亚=Sawyer|ns
索尼亚=Sonia|ns
索纳=Sona|ns
索罗门=Solomon|ns
紫兰=Tử Lan|ns
紫海=Tử Hải|ns
紫班=tử ban|ns
紫罗兰=Tử La Lan|ns
紫罗兰色=lan tử la sắc/màu tím/màu tím)|ns
紫苏=tía tô/cây tía tô|ns
紫阳=Tử Dương|ns
红口白牙=dứt khoát/một mực khẳng định|ns
红国=Trung Quốc|ns
红山=Hồng Sơn/Quận Hồng Sơn của thành phố Chifeng 赤峰 市, Nội Mông|ns
红河=Hồng Hà/sông Hồng/Red River|ns
红海=Hồng Hải|ns
红色高棉=Khmer Đỏ|ns
红阳=Hồng Dương|ns
红鬃马=Hồng Tông Mã|ns
约丹=Jordan|ns
约旦河=sông Jordan|ns
纳米比亚=Namibia (Na-mi-bi-a)|ns
纽伦堡=Nuremberg|ns
纽曼=Newman|ns
纽约=New York|ns
纽芬兰=Newfoundland/Đảo Newfoundland, Canada|ns
纽西兰=New Zealand|ns
纽顿=Nữu Đốn|ns
终南=Chung Nam|ns
终南山=Chung Nam sơn|ns
绍兴=Thiệu Hưng|ns
绍尔=Sauer|ns
绍特=Schott/Sauter|ns
结舌杜口=cứng lưỡi|ns
绕城=vượt thành|ns
绕指柔=ngón tay mềm/nhiễu chỉ nhu|ns
绛云丹=Giáng Vân Đan|ns
绥安=Tuy An|ns
绥远=Tuy Viễn/tên cũ của quận thành phố Hohhot 呼和浩特 [Hu1 he2 hao4 te4], Nội Mông|ns
绥靖=bình định|ns
维也纳=Vienna|ns
维亚=Vias/Duy Á|ns
维京=Viking|ns
维兰=Welen|ns
维加斯=Vegas|ns
维吉尼亚=Virginia|ns
维埃=Duy Ai|ns
维堡=Vyborg|ns
维多利亚=Victoria|ns
维多利亚海湾=vịnh Victoria/Vịnh Victoria|ns
维多利亚港=cảng Victoria|ns
维多利亚湖=hồ Victoria|ns
维尔京=Virgin|ns
维度=chiều không gian/vĩ độ/duy độ|ns
维江=Duy giang|ns
维西=Vici|ns
绵密=dầy đặc/chu đáo/tỉ mỉ/miên mật|ns
绵羊=cừu non/cừu/con cừu/miên dương|ns
绵联=liên miên/liên tục|ns
绵阳=miên dương/Miên Dương/thành phố cấp tỉnh Mianyang ở Tứ Xuyên|ns
缅人=người Miến|ns
缅因=Maine|ns
缅国=Miến quốc|ns
缅怀=nhớ lại/tưởng nhớ/miễn hoài|ns
缅甸=Miến Điện/Myanmar|ns
罗东=La Đông|ns
罗克珊=Roxanne|ns
罗兰=Roland|ns
罗列=bày ra/dàn ra/trưng bày/kể ra/liệt kê/kể lể/la liệt|ns
罗利=Raleigh/La Lợi|ns
罗南=Ronan|ns
罗口=tay áo/cổ tất có chun|ns
罗国=la quốc|ns
罗城=La Thành|ns
罗家=La gia|ns
罗宾=Robin/Lupin|ns
罗山=La Sơn|ns
罗州=la châu|ns
罗得岛=Rhode Island|ns
罗曼罗兰=Romain Rolland|ns
罗本=La Bản/Robben|ns
罗江=La Giang|ns
罗河=La Hà|ns
罗泊斯=La Bạc Tư|ns
罗洋=La Dương|ns
罗海=La Hải|ns
罗米欧=Romeo|ns
罗西=La Tây|ns
罗里=Rory|ns
罗马=La Mã/Rome/Rô-ma|ns
罗马尼亚=Romania/Rumani|ns
罗马帝国=La Mã đế quốc|ns
羊城=Dương Thành|ns
羊山=Dương sơn|ns
美不美=có đẹp hay không|ns
美丽=mỹ lệ/xinh đẹp/đẹp|ns
美亚=Mỹ Á|ns
美人图=mỹ nhân đồ|ns
美俄=Mỹ và Nga|ns
美兰=Mỹ Lan/Quận Meilan của thành phố Hải Khẩu 海口 市 [Hai3 kou3 shi4], Hải Nam|ns
美其名=mỹ kỳ danh|ns
美凤=Mỹ Phụng|ns
美利坚合众国=hợp chủng quốc Hoa Kỳ|ns
美化=mỹ hóa/điểm tô cho đẹp/làm cho đẹp|ns
美因茨=Mainz|ns
美国=nước Mỹ/Mỹ/Hoa Kỳ/Hiệp chủng quốc Hoa Kỳ/United States/Mỹ quốc|ns
美容店=tiệm thẩm mỹ|ns
美州=Mỹ châu|ns
美德=mỹ đức/ĐỨC/phẩm chất tốt/đạo đức tốt/Mỹ Đức|ns
美感=mỹ cảm/khả năng thưởng thức cái đẹp/vẻ đẹp|ns
美斯=Messi|ns
美杜沙=Medusa|ns
美树沙耶加=Miki Sayaka|ns
美欧=Mỹ Âu|ns
美沙=Mỹ Sa|ns
美洲=Châu Mỹ|ns
美洲狮=sử tử châu Mỹ|ns
美特斯=Meters|ns
美狄亚=Medea|ns
美甲=sơn móng tay|ns
美眉=mỹ mi/pretty girl/Mỹ Mi|ns
美第奇=Medici|ns
美索不达米亚=Mesopotamia|ns
美纳斯=Milotic|ns
美美=mỹ mỹ|ns
美至=đẹp đến mức|ns
美苏=Mỹ và Liên Xô|ns
美院=đại học mỹ thuật/Viện Thẩm mỹ|ns
美隶=mỹ lệ|ns
美露沙=Mỹ Lộ Sa|ns
美食城=mỹ thực thành|ns
美龙=mỹ long|ns
羽根=cộng lông chim|ns
翁布里亚=Umbria|ns
翼哥=Dực ca|ns
翼城=Dực Thành|ns
翼州=Dực Châu|ns
老城区=lão thành khu|ns
老挝=Lào/Laos/Lào (Lão Qua)|ns
耶利内克=Jellinek|ns
耶路撒冷=Jerusalem|ns
联邦德国=Liên bang Đức/Bundesrepublik Deutschland|ns
肃州=Túc Châu|ns
肇庆=Triệu Khánh|ns
肥前国=Hizen|ns
肥城=phì thành|ns
肯尼亚=Kenya/Keynia|ns
肯尼斯=Kayneth/Kenneth|ns
肯德鸡=KFC|ns
肯斯=Ken/Khẳng Tư|ns
胶东=Giao Đông|ns
胶原=collagen|ns
胶州=Giao Châu|ns
胶州湾=vịnh Giao Châu|ns
胶柱鼓瑟=siết chặt cái khoá đàn/cố chấp/câu nệ/không linh hoạt/khư khư theo cái cũ/bo bo cố chấp|ns
腓特烈=Frederick/Phì Đặc Liệt|ns
腾云=đằng vân|ns
腾哥=Đằng ca|ns
腾山=Đằng Sơn|ns
腾达=lên cao/tiến chức/thăng chức|ns
腾隆=Đằng Long|ns
腾龙=Đằng Long|ns
腾龙洞=Đằng Long Động|ns
自治县=huyện tự trị|ns
自治州=châu tự trị|ns
舞瑶=Vũ Dao|ns
舟中=trong thuyền/trong đò|ns
舟山=Chu Sơn/thành phố cấp tỉnh Zhoushan ở Chiết Giang|ns
舟桥=Chu Kiều|ns
舟群=đoàn thuyền|ns
舟车劳顿=đi đường mệt mỏi/tàu xe mệt mỏi|ns
舟里=trong đò|ns
良牙=Ryouga|ns
色楞格河=sông Sắc Lăng Cách|ns
艾陀尔=Ngải Đà Nhĩ|ns
芙蓉姐姐=Phù Dung tỷ tỷ|ns
芙蓉镇=Phù dung trấn|ns
芙蕖=hoa sen/bông sen|ns
芜城=vu thành|ns
芜州=Vu Châu|ns
芜湖=Vu Hồ|ns
芝兰=chi lan|ns
芝加哥=Chicago|ns
芝士=phô mai/phô mát/pho mát|ns
芝诺=Chi Nặc|ns
芝麻开门='vừng ơi mở ra'|ns
芦州=Lô Châu|ns
芦洲=Lô châu|ns
芬兰=Phần Lan/Finland|ns
芬利=Finley|ns
花冈岩=đá hoa cương|ns
花城=Hoa Thành|ns
花山=hoa sơn|ns
花海=biển hoa|ns
花都=hoa đều/hoa đô|ns
芷兰=Chỉ Lan|ns
苍古=thương cổ|ns
苍山=Thương Sơn|ns
苍崎=Aozaki|ns
苍海=thương hải|ns
苏东坡=Tô Đông Pha|ns
苏丹=Sudan/Tô Đan|ns
苏亚雷斯=Suarez|ns
苏伊士运河=kênh đào Xuy-ê/Suez Canal|ns
苏俄=Russia|ns
苏兰=Solane|ns
苏北=Tô Bắc|ns
苏区=khu Xô-Viết/khu XôViết|ns
苏南=Tô Nam|ns
苏哈=tô cáp|ns
苏国=Tô quốc|ns
苏城=Tô Thành|ns
苏宁=Tô Ninh|ns
苏富比=Tô Phú Bỉ|ns
苏尔=Tô Nhĩ|ns
苏州=Tô Châu|ns
苏州城=thành Tô Châu|ns
苏干=Tô Kiền|ns
苏平=Tô Bình|ns
苏府里=trong Tô phủ|ns
苏打=soda/sô-đa|ns
苏拉=Tô Lạp|ns
苏斯=Sous/Tô Tư|ns
苏星河=Tô Tinh Hà|ns
苏曼莎=Tô Mạn Toa|ns
苏木=tô mộc/cây gỗ vang|ns
苏杭=Tô Hàng|ns
苏格兰=Scotland|ns
苏格拉底=Socrate/Socrates|ns
苏水=Tô Thủy|ns
苏泊尔=Supor|ns
苏海=Tô Hải|ns
苏源=Tô Nguyên|ns
苏环=Tô Hoàn|ns
苏珊=Suzanne/Susan/Susanne|ns
苏瓦=Suva|ns
苏竹=Tô Trúc|ns
苏维埃=Comecon|ns
苏美=Tô Mỹ|ns
苏联=Liên Xô/Liên Bang Xô Viết|ns
苏苏=Tô Tô|ns
苏萨=Sousa|ns
苏西=Suzie|ns
苏里南=Suriname/Xurinam|ns
苏门=Tô Môn|ns
苏门答腊=Sumatra/Sumatra, một trong những hòn đảo của Indonesia|ns
苏门答腊岛=đảo Sumatra/Sumatra|ns
苏阳=Tô Dương|ns
苏黎=Tô Lê|ns
苏黎士=Zürich|ns
苦哈哈=khổ cáp cáp|ns
英东=Anh Đông|ns
英乐=Anh Nhạc|ns
英伦=England|ns
英伦三岛=ba đảo Anh|ns
英兰=Anh Lan|ns
英吉利=Anh Cát Lợi/Anh quốc|ns
英吉利海峡=eo biển Manche|ns
英吉沙=Anh Cát Sa|ns
英国=nước Anh/Anh quốc/Anh/Anh Cát Lợi/Anh Quốc/United Kingdom|ns
英布=Anh Bố|ns
英度=Ấn Độ|ns
英德=Anh Đức/Anh-Đức|ns
英格兰=Anh/England|ns
英格利=England/Engle|ns
英格尔=Ingle|ns
英武=oai hùng/anh tuấn uy vũ/anh vũ|ns
英汉字典=từ điển Anh Hán|ns
英灵=anh linh/hồn thiêng|ns
英特尔=Intel|ns
英白拉多=Imperator|ns
英白罗=Anh Bạch La|ns
英眉=anh mi/Anh Mi|ns
英石=anh thạch|ns
英美=anh mỹ|ns
英里=dặm Anh/lý|ns
英雄=anh hùng/hero|ns
英雄末路=anh hùng mạt lộ|ns
英雄本色=bản sắc anh hùng|ns
茂哥=Mậu ca|ns
茂林=rừng rậm|ns
茅塞顿开=hiểu ra/nghĩ ra/mao tắc đốn khai/tự nhiên hiểu ra|ns
茅山=Mao Sơn|ns
茶圣=trà thánh/Trà Thánh|ns
茶壶盖=nắp ấm trà|ns
荆北=Kinh Bắc|ns
荆南=Kinh Nam|ns
荆国=Kinh quốc|ns
荆州=Kinh Châu|ns
荆府=Kinh phủ|ns
荆扬=Kinh Dương|ns
荆洲=Kinh Châu|ns
荆溪=Kinh Khê|ns
荆门=kinh môn|ns
荒山野岭=hoang sơn dã lĩnh|ns
荥阳=Huỳnh Dương|ns
荷兰=Hà Lan|ns
荷塘=hồ sen/ao sen|ns
荷斯=Hà Tư|ns
荷池=ao sen/hồ sen|ns
荷甲=Eredivisie|ns
荷花池=ao hoa sen|ns
荷马=Homer|ns
荷鲁斯=Horus|ns
莎士比亚=Shakespeare|ns
莎曼珊=Samantha|ns
莫利=Mạc Lợi|ns
莫及=không kịp|ns
莫大=lớn lao/cực to/vô cùng/hết sức/không có cái nào lớn hơn|ns
莫山=Mạc Sơn|ns
莫干=Mạc Can|ns
莫干山=Mạc Can Sơn|ns
莫惹=đừng chọc|ns
莫桑比克=Mozambique/Mạc Tang Bỉ Khắc|ns
莫水=Mạc Thủy|ns
莫西=Mosey|ns
莫里亚=Moria|ns
莫非=hẳn là/chẳng lẽ/hay là|ns
莫顿=Morton|ns
莫高窟=mạc cao quật/Hang Mạc Cao/Mạc Cao Quật/Hang động Mogao ở Đôn Hoàng 敦煌, Cam Túc|ns
莱亚=Rye|ns
莱利=Riley|ns
莱国=Lai quốc|ns
莱州=Lai Châu/tỉnh Lai Châu|ns
莱欧=Lai Âu|ns
莱比锡=Leipzig|ns
莱法利=Rafaeli|ns
莱芜=lai vu/Lai Vu/thành phố cấp tỉnh Laiwu ở Sơn Đông|ns
莱茵=Rhine/Lion|ns
莱茵河=sông Rhine/sông Ranh|ns
莱西=Lai Tây|ns
莲卡=Lienka|ns
莲柔=Liên Nhu|ns
莲花山=Liên Hoa Sơn|ns
莲花峰=Liên Hoa phong|ns
莲花池=hồ sen|ns
莲蓬=đài sen|ns
莽原=rậm rạp/um tùm|ns
莽汉=mãng hán/tên lỗ mãng/con người lỗ mãng/anh chàng lỗ mãng/kẻ lỗ mãng|ns
菊冈=Kikuoka|ns
菊花岛=Cúc Hoa đảo|ns
菱湖=Lăng Hồ|ns
菲亚=Phỉ Á|ns
菲利=Ferri|ns
菲利斯=Feris|ns
菲利波=Filippo|ns
菲利浦=Philip|ns
菲律宾=Philippines|ns
菲林=Fillin|ns
菲花=Pfeiffer|ns
萧关=Tiêu Quan|ns
萨拉热窝=Tát Lạp Nhiệt Oa|ns
萨苏=Sasu|ns
落凰岭=Lạc Hoàng Lĩnh|ns
落山=xuống núi|ns
落沧=lạc thương|ns
葛南=Cát Nam|ns
葛城美里=Katsuragi Misato|ns
葛海=Cát Hải|ns
葛罗瑞亚=Gloria|ns
葡京=Bồ Kinh|ns
葡萄园=vườn nho|ns
葡萄干=nho khô|ns
葡萄树=cây nho|ns
葡萄牙=Bồ Đào Nha|ns
葫芦山=Hồ Lô Sơn|ns
葫芦岛=Hồ Lô Đảo|ns
葵花宝典=Quỳ Hoa Bảo Điển|ns
蒂华纳=Tijuana|ns
蒙兰=Montlin|ns
蒙其=Monkey|ns
蒙古=Mông Cổ|ns
蒙古国=Mông Cổ quốc|ns
蒙古马=ngựa Mông Cổ/Ngựa Mông Cổ|ns
蒙哥=Mông ca|ns
蒙哥马利=Montgomery/Mông Ca Mã Lợi|ns
蒙城=Mông Thành|ns
蒙塞=Montcet|ns
蒙头=mê đầu/trùm đầu|ns
蒙山=Mông Sơn|ns
蒙巴萨=Mombasa|ns
蒙巴顿=Mountbatten|ns
蒙彼利埃=Montpelier/Mông Bỉ Lợi|ns
蒙斯=Mons|ns
蒙特=Mundt|ns
蒙特利尔=Montréal/thành phố Montreal ở Quebec, Canada|ns
蒙田=Mông Điền|ns
蒙索=Montceaux|ns
蒙馆=trường tư thục|ns
蓉城=thành đô|ns
蓉江=Dung Giang|ns
蓉蓉=Dung Dung|ns
蓝京=Lam kinh|ns
蓝海=Lam Hải|ns
蓝牙=Bluetooth/lam nha|ns
蓟京=Kế Kinh|ns
蓟县=Kế huyện|ns
蓟都=Kế đô|ns
蓟马=con bọ lông|ns
蓦然回首=bỗng nhiên thu tay|ns
蓬头=đầu bù|ns
蓬山=Bồng Sơn|ns
蓬蒙=Bồng Mông|ns
蓬蓬=bồng bồng/rậm rạp rối bù/um tùm/từng đám|ns
蓬门=bồng môn|ns
蔚起=phát triển tươi tốt|ns
蕲州=Kỳ châu|ns
蕲春=Kỳ Xuân|ns
蕲艾=cây ngải|ns
藏掖=che đậy/bưng bít/lấp liếm/che giấu/tệ che đậy/nạn bưng bít/giấu giếm|ns
藏藏掖掖=che che đậy đậy/để che giấu|ns
藩国=phiên quốc/thuộc địa/nước thuộc địa/nước chư hầu/nước lệ thuộc/nước nhỏ|ns
藩篱=rào/hàng rào/rào giậu|ns
藩镇=phiên trấn|ns
虎关=hổ quan|ns
虎口=hổ khẩu/miệng hổ/miệng hùm/hang sói/nơi nguy hiểm/eo bàn tay/gan bàn tay|ns
虎城=Hổ thành|ns
虎威=hổ uy/oai vũ/uy vũ/uy phong|ns
虎尾=đuôi hổ/đuôi cọp|ns
虎烈=Hổ Liệt|ns
虎牙=răng nanh/nanh/hổ nha|ns
虎牢关=Hổ Lao quan|ns
虎狮=Hổ Sư|ns
虎狼=hổ lang/hổ sói/lũ hung bạo/hung ác tàn bạo|ns
虎穴龙潭=đầm rồng hang hổ/ao rồng hang cọp/địa thế hiểm trở|ns
虎落平川=như cá mắc cạn/hổ xuống đồng bằng|ns
虎落平阳=hổ lạc đồng bằng|ns
虎跳峡=hổ khiêu hiệp|ns
虎门=Hổ Môn|ns
虞国=Ngu quốc|ns
虹口=hồng khẩu|ns
虹桥=cầu vồng/hồng kiều|ns
虹龙=Hồng Long*|ns
蛇山=xà sơn|ns
蛟马=giao mã|ns
蛟龙=giao long/thuồng luồng|ns
蛟龙得水=giao long gặp nước/rồng gặp mây|ns
蜀东=thục đông|ns
蜀中=Thục Trung/trong đất thục/tứ xuyên|ns
蜀国=Thục quốc|ns
蜀地=đất Thục|ns
蜀山=Thục Sơn|ns
蜀州=Thục Châu|ns
蜀汉=Thục Hán|ns
蜀道=Thục đạo|ns
蜀郡=Thục quận|ns
蜀都=Thục Đô|ns
蜀锦=gấm Tứ Xuyên|ns
蝴蝶兰=lan hồ điệp/hoa lan hồ điệp/Lan hồ điệp/Hoa lan hồ điệp|ns
蟠龙镇=trấn Bàn Long/Bàn Long trấn|ns
衙前=trước nha môn|ns
衡山=Hành Sơn|ns
衡山路=Hành sơn lộ|ns
衡水=Hành Thuỷ/thành phố cấp tỉnh Hành Thủy ở Hà Bắc|ns
衡阳=Hành Dương|ns
衢州=Cù Châu|ns
衢巷=ngõ hẻm|ns
裕如=ung dung/khoan thai/đầy đủ/sung túc|ns
裕陵=dụ lăng|ns
褒城=Bao thành|ns
襄城=Tương thành|ns
襄州=Tương Châu|ns
襄平=Tương Bình|ns
襄樊=Tương Phàn|ns
襄江=Tương giang|ns
襄理=trợ lý giám đốc|ns
襄荆=Tương Kinh|ns
襄阳=Tương Dương|ns
西临=tây lâm|ns
西乐=tân nhạc/nhạc Tây|ns
西乡=Tây Hương|ns
西亚=Tây Á|ns
西京=Tây Kinh|ns
西伯=Tây Bá|ns
西伯利亚=Siberia|ns
西兰=Zeeland|ns
西兹=Cize|ns
西内苑=Tây Nội uyển|ns
西北=Tây Bắc/tây bắc|ns
西区=Tây khu|ns
西南=Tây Nam/tây nam|ns
西卡=Sika|ns
西原=Tây Nguyên|ns
西双版纳=Tây Song Bản Nạp/Xishuangbanna|ns
西台=Tây Đài|ns
西园=tây viên|ns
西园寺=Tây Viên Tự/Saionji|ns
西地那非=Sildenafil/sildenafil|ns
西城=thành Tây/tây thành|ns
西城区=khu Tây Thành/khu tây thành|ns
西域=Tây Vực|ns
西塞山=Tây Tắc sơn|ns
西夏=Tây Hạ|ns
西夏国=Tây Hạ quốc|ns
西大街=đại lộ phía tây/West Street|ns
西夷=Tây Di|ns
西子湖畔=bên hồ Tây Tử|ns
西宁=Tây Ninh/tỉnh Tây Ninh|ns
西安=Tây An|ns
西宫=Tây Cung|ns
西尔=Cyr/Ciel|ns
西尔维亚=Silvia/Tây Nhĩ Duy Á|ns
西尼=Tây Ni|ns
西山=tây sơn/Tây Sơn|ns
西岭=Tây Lĩnh|ns
西峰=tây phong|ns
西州=Tây Châu|ns
西市=chợ Tây/Tây thị|ns
西弗吉尼亚=West Virginia/Tây Phất Cát Á|ns
西拉=Tây Lạp|ns
西拉斯=Cylas|ns
西摩=Samo|ns
西斯=Sith|ns
西斯廷=Sistine|ns
西方极乐=Tây Phương Cực Lạc|ns
西昆仑=Tây Côn Luân|ns
西村=tây thôn/Nishimura|ns
西林=tây lâm|ns
西格蒙德=Sigmond|ns
西欧=Tây Âu/miền tây Châu Âu|ns
西水=Tây Thủy|ns
西汉=Tây Hán|ns
西江=tây giang/Tây Giang/Sông Tây Giang|ns
西沙=Hoàng sa|ns
西沙群岛=Tây Sa quần đảo|ns
西河=Tây Hà|ns
西洋=Tây Dương|ns
西洲=Tây châu|ns
西海=Tây Hải|ns
西湖=Tây Hồ|ns
西班牙=Tây Ban Nha|ns
西班牙港=Po-ốp-xpên/Port of Spain|ns
西瓜=dưa hấu/tây qua/dưa đỏ/quả dưa hấu/trái dưa hấu|ns
西瓯=Tây Âu|ns
西甲=giải vô địch Tây Ban Nha|ns
西番=Tây phiên|ns
西疆=Tây Cương|ns
西盟=Tây Minh|ns
西直门=Tây Trực môn|ns
西米捞=chè xoài chân trâu|ns
西罗=Ciro|ns
西至=tây chí|ns
西苑=Tây Uyển|ns
西蒙斯=Simmons|ns
西藏=Tây Tạng/khu tự trị Tây Tạng|ns
西街=Tây nhai/phố Tây|ns
西西里=Sicilian|ns
西西里岛=đảo Sicilian|ns
西贡=Sài Gòn/Sài gòn/sài goòng|ns
西路=tây lộ/West Road|ns
西辽=Tây Liêu|ns
西都=Tây đô|ns
西里斯=Sirius|ns
西里西亚=Silesia|ns
西门=Tây Môn/cửa Tây|ns
西门庆=Tây Môn Khánh|ns
西门町=Tây Môn Đinh|ns
西阳=Tây Dương|ns
西陵=Tây Lăng|ns
西非=Tây Phi/miền Tây Châu Phi|ns
西顿=Tây Đốn|ns
观海=ngắm biển|ns
许坤=Hứa Khôn|ns
许都=Hứa đô|ns
语珊=Ngữ San|ns
诸国=chư quốc/các nước|ns
诺丁城=Nặc Đinh Thành|ns
谅山=Lạng Sơn/tỉnh Lạng Sơn|ns
谯国=Tiêu quốc|ns
谷城=Cốc Thành/Quận Gucheng ở Xiangfan 襄樊 [Xiang1 fan2], Hồ Bắc|ns
谷都=bĩu môi/trề môi|ns
象山=Tượng Sơn|ns
象牙=ngà voi/răng ngà/ngà voi|ns
象牙塔=tháp ngà|ns
象牙海岸=Bờ biển Ngà/Bờ Biển Ngà|ns
豫南=Dự Nam|ns
豫园=Dự Viên|ns
豫山=Dự Sơn|ns
豫州=Dự Châu|ns
豫省=Dự tỉnh|ns
豫西=Dự Tây|ns
贝利亚=Beria|ns
贝加尔湖=hồ Baikal|ns
贵国=quý quốc|ns
贵城=quý thành|ns
贵多=đắt hơn|ns
贵安=quý an|ns
贵宾=quý khách|ns
贵宾卡=thẻ khách quý|ns
贵寨=quý trại/Quý Trại|ns
贵寺=quý tự|ns
贵州=Quý Châu|ns
贵州省=tỉnh Quý Châu|ns
贵干=phải làm sao/quý kiền|ns
贵溪=Quý Khê|ns
贵福=Quý Phúc|ns
贵达=đắt tới|ns
贵阳=Quý Dương|ns
费城=Philadelphia|ns
费尔南=Fernán|ns
费尔南多=Fernando|ns
费尔干纳=Fergana/thung lũng Ferghana|ns
贺洲=Hạ Châu|ns
赛欧=Sail|ns
赞林=Tán Lâm|ns
赞比亚=Zambia/Dambia|ns
赞美=ca ngợi/ca tụng/khen ngợi|ns
赣南=Cống Nam|ns
赣州=Cán Châu|ns
赣江=Cán Giang|ns
赤乌=Xích Ô|ns
赤兰=Xích Lan|ns
赤县=huyện Xích|ns
赤县神州=Huyện Xích Thần Châu|ns
赤坂=Akasaka|ns
赤城=Xích Thành|ns
赤峰=Xích Phong|ns
赤州=Xích Châu|ns
赤月城=Xích Nguyệt thành|ns
赤木律子=Akagi Ritsuko|ns
赤海=Xích Hải|ns
赤眉=Xích Mi|ns
赤道几内亚=Guinea Xích Đạo|ns
赤龙旗=Xích Long kỳ|ns
赫利俄斯=Helios|ns
赫本=Hepburn|ns
越乐=càng vui|ns
越北=Khu tự trị Việt Bắc|ns
越南=Việt Nam/Việt/Vietnam|ns
越县=vượt huyện|ns
越和=càng cùng|ns
越国=Việt quốc|ns
越城岭=Việt Thành Lĩnh|ns
越壁=vượt tường|ns
越山=xuyên núi/qua núi|ns
越岗=vượt đèo|ns
越岭=vượt đèo|ns
越州=vượt châu/Việt Châu|ns
越治=càng chậm|ns
越熟=càng quen|ns
越野=việt dã/vượt đồng|ns
越野赛跑=thi chạy việt dã|ns
越野跑=chạy việt dã|ns
跃龙=dược long|ns
跃龙门=vượt Long Môn|ns
跋扈飞扬=ngang tàng hống hách/ngang ngược|ns
跑江湖=khách giang hồ/đi giang hồ|ns
路易斯安那州=Louisiana/Louisiana, tiểu bang Hoa Kỳ|ns
路西=Lucy|ns
踏海=vượt biển|ns
轘辕=Hoàn Viên|ns
车里雅宾斯克=Chelyabinsk/thị trấn Chelyabinsk ở sườn phía đông của Ural, trên tuyến đường sắt xuyên Siberia|ns
轻松自如=nhẹ nhàng như thường|ns
辰东=Thần Đông|ns
辰京=Thần Kinh|ns
辰南=Thần Nam|ns
辽东=Liêu Đông|ns
辽人=người Liêu|ns
辽国=Liêu quốc|ns
辽宁=Liêu Ninh|ns
辽州=Liêu Châu|ns
辽广=xa rộng|ns
辽沈=Liêu Thẩm|ns
辽河=Liêu Hà|ns
辽西=Liêu Tây|ns
辽远=xa xôi/xa xăm|ns
辽镇=Liêu trấn|ns
辽阳=Liêu Dương|ns
达拉斯市=thành phố Dallas|ns
达斡尔=Daoatle|ns
迈古=viễn cổ|ns
远东=viễn đông/Viễn Đông/vùng Viễn Đông|ns
远伯=viễn bá|ns
远古=viễn cổ/thời xa xưa/thời cổ xưa|ns
远山=núi xa|ns
远河=Viễn Hà|ns
远洋=viễn dương/biển xa/xa khơi|ns
远海=viễn hải/vùng biển xa/biển khơi|ns
远超过=vượt xa quá|ns
远阪=Tohsaka|ns
远非=xa không phải/vượt qua xa|ns
连城=liên thành|ns
连山=liền với núi|ns
迦兰=Già Lan|ns
迦南=Canaan|ns
迦纳=Ghana|ns
迪利=Dealey|ns
迪化=Demiurge hóa|ns
迪厅=sàn nhảy/địch thính|ns
迪安=Diane|ns
迪拜=Dubai|ns
迪斯尼乐园=công viên Disneyland|ns
迪欧=Địch Âu|ns
迪比=Địch Bỉ|ns
迪比亚=Dibya|ns
迪瓦=Địch Ngõa|ns
迪门=Demon|ns
迪马=Dimar|ns
逍遥镇=Tiêu Dao trấn|ns
通州=Thông Châu|ns
通江=Thông Giang|ns
通海=Thông Hải/Quận Tonghai ở Yuxi 玉溪 [Yu4 xi1], Vân Nam|ns
通都大邑=thành phố lớn/thủ phủ/đô thị/đô hội|ns
遂志=thích chí|ns
道州=Đạo Châu|ns
遮阳=che nắng|ns
遮阳蓬=già dương bồng|ns
避风港=cảng tránh gió|ns
邙姓=họ Mang|ns
邙山=Mang Sơn|ns
那不勒斯=Napoli/Naples|ns
那头陀=kia đầu đà|ns
邦国=Bang quốc|ns
邦联=liên bang/khối liên hiệp|ns
邯郸=Hàm Đan|ns
郑东=trịnh đông|ns
郑克=Trịnh Khắc|ns
郑原=Trịnh Nguyên|ns
郑国=Trịnh quốc/nước Trịnh|ns
郑州=Trịnh Châu|ns
郑海=Trịnh Hải|ns
郑芝龙=Trịnh Chi Long|ns
郡县=quận huyện|ns
郡城=quận thành|ns
郡马=quận mã/chồng quận chúa/Quận mã|ns
郢州=Dĩnh châu|ns
郢都=Dĩnh đô|ns
都城=đô thành/thủ đô/thủ phủ|ns
都市=đô thị/thành phố/thành phố lớn|ns
都江堰=Đô Giang Yển/thành phố cấp quận Dujiangyan ở Thành Đô 成都 [Cheng2 du1], Tứ Xuyên|ns
鄂尔多=Ordo|ns
鄂省=Hồ Bắc|ns
鄂西=Ngạc Tây|ns
鄂都=Ngạc Đô|ns
鄱阳=Bà Dương|ns
鄱阳湖=Bà Dương hồ|ns
酉鸡=Dậu Kê|ns
酒兴=tửu hứng|ns
酒圣=tửu thánh|ns
醴泉=Lễ Tuyền|ns
里嫩=trong mềm|ns
里巷=ngõ phố/ngõ xóm|ns
里弄=ngõ/xóm/việc phường/bên trong làm|ns
里斯本=Lisbon/Lixbon|ns
里根=lý căn/Reagan|ns
里番=lý phiên|ns
里约热内卢=Rio de Janeiro/ Rio de Janeiro|ns
重典=trọng điển|ns
重凯=trọng khải|ns
重列仙班=lại đứng vào tiên ban|ns
重大意义=ý nghĩa trọng đại|ns
重山=trọng sơn|ns
重庆=Trùng Khánh|ns
重拜=sùng bái|ns
重林=rừng dày/trọng lâm|ns
重洋=trùng dương/biển cả và đại dương/biển cả nghìn trùng/trọng dương|ns
重洲=trọng châu|ns
重镇=trọng trấn/thị trấn quan trọng|ns
重阳=Trùng Dương|ns
金国=Kim quốc|ns
金城=Kim Thành/kim thành/thành phố vàng/thành kiên cố|ns
金城汤池=thành trì vững chắc/thành trì kiên cố/thành luỹ bền vững|ns
金州=Kim Châu|ns
金本敦=Kanamoto Atsushi|ns
金沙江=Kim Sa giang|ns
金河=Kim Hà|ns
金海=kim hải|ns
金煌煌=vàng óng ánh/vàng lóng lánh/vàng rực|ns
金牙=răng vàng|ns
金色池塘=hồ nước màu vàng óng|ns
金角湾=vịnh Sừng Vàng/Zolotoy Rog hay Vịnh Golden Horn ở Vladivostok|ns
金阳=Kim Dương|ns
金鸡纳树=cây canh-ki-na|ns
釜山=Busan|ns
钓台=chỗ câu cá/bệ câu cá|ns
钓大鱼=câu cá lớn|ns
钓鱼台=Điếu Ngư Đài|ns
钓鱼岛=Điếu Ngư đảo|ns
钦原=Khâm Nguyên|ns
钦州=Khâm Châu/thành phố cấp tỉnh Tần Châu ở Quảng Tây|ns
钱塘=Tiền Đường|ns
铁犁=cày sắt/thiết lê|ns
铅丹=diên đan/mi-ni-um|ns
铅封=tem dám|ns
铜城=đồng thành|ns
铜山=đồng sơn/Núi Đồng/Quận Đồng Sơn ở Từ Châu 徐州 [Xu2 zhou1], Giang Tô|ns
铜牙=răng bằng đồng/đồng nha|ns
铜锣湾=Causeway Bay|ns
铜龙=Đồng Long|ns
银州=Ngân Châu|ns
银海=Ngân Hải|ns
银牙=răng ngà/ngân nha/răng bạc|ns
银联=Ngân Liên/TÁCH|ns
铺展开来=trải rộng ra|ns
铺平=trải bằng/phô bình|ns
锁国=đóng cửa biên giới/bế quan toả cảng/tỏa quốc|ns
锡伯=Tích Bá|ns
锡兰=Ceylon|ns
锡安=Zion/Tích An|ns
锡尔河=sông Syr/Syr Darya, sông Trung Á, chảy từ Cộng hòa Kyrgiz qua Kazakhstan đến biển Aral|ns
锡州=Tích Châu|ns
锡德=Sid|ns
锡拉=Sila|ns
锡林郭勒=Tích Lâm Quách Lặc|ns
锦城=Cẩm Thành|ns
锦州=Cẩm Châu|ns
锦旗=cờ thưởng/cờ thi đua|ns
锦江=Cẩm Giang|ns
锦河=Cẩm Hà|ns
锦洋=Cẩm Dương|ns
锦溪=Cẩm Khê|ns
锦绣山河=cẩm tú sơn hà/giang sơn cẩm tú/non sông tươi đẹp|ns
锦绣河山=sơn hà cẩm tú|ns
锦西=Cẩm Tây|ns
锦霞=Cẩm Hà|ns
锦鸡=gà cảnh|ns
镇中=trong trấn|ns
镇内=trong trấn|ns
镇南=Trấn Nam|ns
镇国=trấn quốc|ns
镇国寺=Trấn Quốc Tự|ns
镇寺=trấn tự|ns
镇山=trấn sơn|ns
镇岳宫=Trấn Nhạc Cung|ns
镇江=Trấn Giang|ns
镇海=trấn hải|ns
镇里=trong trấn/trấn lý|ns
镇龙=trấn long|ns
镜中=trong kính/trong gương|ns
镜州=Kính Châu|ns
镜湖=Kính Hồ|ns
镶牙=trồng răng giả|ns
镶边=viền rìa|ns
镶黄旗=Tương Hoàng Kỳ|ns
长七=dài bảy|ns
长三角=Trường Tam Giác|ns
长乐=Trường Lạc|ns
长乐宫=cung Trường Lạc/Cung Trường Lạc|ns
长亭=trường đình/đình nghỉ chân/trạm nghỉ chân|ns
长兴=Trường Hưng|ns
长坂坡=dốc Trường Bản|ns
长坑=cái rảnh dài|ns
长城=Trường Thành|ns
长多大=lớn bao nhiêu|ns
长大=lớn lên/cao lớn/to lớn|ns
长天=Trường Thiên|ns
长孙=trưởng tôn/cháu đích tôn/họ Trưởng Tôn|ns
长宁=Trường Ninh|ns
长安=Trường An/đô thành|ns
长安城=thành Trường An|ns
长安街=Trường An Phố|ns
长寿=trường thọ/sống lâu|ns
长尾=đuôi dài|ns
长屋=nhà dài|ns
长岛=trường đảo|ns
长崎=Nagasaki/Trường Kỳ|ns
长崎县=tỉnh Nagasaki|ns
长崎市=thành phố Nagasaki|ns
长川=Trường Xuyên|ns
长干=làm lâu|ns
长平=Trường Bình|ns
长度=chiều dài/trường độ/độ dài|ns
长得比=lớn lên so/dung mạo so với|ns
长明宫=cung Trường Minh|ns
长春=Trường Xuân|ns
长枕=gối dài|ns
长桥=trường kiều/cầu dài/cây cầu dài|ns
长江=Trường Giang/sông Trường Giang/Trường giang|ns
长江三峡=Trường Giang Tam Hiệp|ns
长江三角洲=vùng tam giác Trường Giang|ns
长江口=Trường Giang Khẩu|ns
长沙=Trường Sa/trường sa|ns
长河=trường hà/Trường Hà/sông dài/dòng/Sông Dài|ns
长波=sóng dài|ns
长流水=nước chảy dài|ns
长牙=răng dài|ns
长班=người hầu/tuỳ tùng|ns
长白=Trường Bạch|ns
长白山=Trường Bạch sơn/núi Trường Bạch/Trường bạch sơn|ns
长眠=an nghỉ/an giấc nghìn thu/an giấc ngàn thu|ns
长绳=dây thừng dài/dây dài|ns
长翼龙=Trường Dực Long|ns
长耳朵=lỗ tai dài|ns
长街=phố dài/trường nhai|ns
长跑=chạy cự li dài/trường bào|ns
长路=đường dài|ns
长里=độ dài/chiều dài|ns
长野=Nagano|ns
长门=đích tôn/chi trưởng/con cháu thuộc chi trưởng|ns
长随=người hầu/đầy tớ nhà quan|ns
长顺=Trường Thuận/Quận Changshun ở Qiannan Buyei và quận tự trị Miao 黔南州 [Qian2 nan2 zhou1], Guizhou|ns
长鼻=mũi dài/vòi dài|ns
长龙=trường long/hàng dài/hàng rồng rắn|ns
闸北区=Áp bắc khu|ns
闽北=Mân Bắc|ns
闽南=Mân Nam/Minnan|ns
闽越=Mân Việt|ns
阪泉=Phản Tuyền|ns
防沙林=rừng chắn cát/rừng phòng hộ|ns
阳关=dương quan|ns
阳城=Dương Thành|ns
阳安=Dương An|ns
阳山=Dương Sơn|ns
阳平关=Dương Bình quan|ns
阳极=dương cực/điện cực dương/cực dương|ns
阳江=Dương Giang|ns
阳沟=cống lộ thiên|ns
阳湖=Dương Hồ|ns
阳维脉=Dương Duy mạch|ns
阳脉=dương mạch|ns
阳阳=Dương Dương|ns
阴山=Âm Sơn|ns
阴沟=cống ngầm|ns
阴河=âm hà|ns
阴阜=âm phụ|ns
阴阳=âm dương|ns
阴阴=âm hiểm|ns
阿七=A Thất|ns
阿东=a Đông|ns
阿亚=A Á|ns
阿伯=a bá|ns
阿克苏=A Khắc Tô|ns
阿兰=Allan|ns
阿兹卡班=Azkaban|ns
阿兹尔=Azir|ns
阿利=Aly|ns
阿加莎=Agatha|ns
阿加西=Agassi|ns
阿南=A Nam|ns
阿古=A Cổ|ns
阿史那=A Sử Na|ns
阿哥=đại ca/anh/huynh/con trai/a ka/a ca|ns
阿国=a Quốc|ns
阿城=a Thành|ns
阿塞拜疆=Azerbaijan/A Tắc Bái Cương|ns
阿姆斯特丹=Amsterdam/A Mỗ Tư Đặc Đan|ns
阿尔卑斯=Alps/A Nhĩ Ti Tư|ns
阿尔卑斯山=núi Alps/dãy Alps|ns
阿尔卑斯山脉=Alps sơn mạch|ns
阿尔及利亚=Algeria/Angeri|ns
阿尔及尔=Algiers/Angie|ns
阿尔本=Alban|ns
阿尔泰山=A Nhĩ Thái Sơn|ns
阿尔马=Alma|ns
阿尼陀佛=A Di Đà Phật|ns
阿山=A Sơn|ns
阿弥陀佛=A Di Đà Phật|ns
阿彻=a Triệt|ns
阿拉伯海=biển Ả-rập/Arabian Sea|ns
阿拉伯联合酋长国=Các tiểu vương quốc A-rập thống nhất|ns
阿拉山口=A Lạp Sơn Khẩu|ns
阿拉巴马=Alabama/Alabama, tiểu bang Hoa Kỳ|ns
阿拉斯加州=Bang Alaska|ns
阿摩尼亚=khí amoniac|ns
阿撒兹勒=Azazel|ns
阿敦=a Đôn|ns
阿昌=A Xương|ns
阿普利亚=Apulia|ns
阿根=A Căn|ns
阿比西尼亚=Abyssinia/Ethiopian|ns
阿河=A Hà|ns
阿洲=A Châu|ns
阿海=A Hải|ns
阿福比=Afobe|ns
阿维尼翁=Avignon|ns
阿罗汉=La Hán|ns
阿罗约=Arroyo/A La Ước|ns
阿美=a Mỹ|ns
阿联酋=UAE/Các tiểu vương quốc Ả Rập thống nhất|ns
阿萨=Aesir|ns
阿里亚=Aria|ns
阿里山=A Lí Sơn|ns
阿门=Amen|ns
阿陵=A Lăng|ns
阿雷西博=Arecibo|ns
阿非利加=Africa|ns
阿骚=Asow|ns
陂陀=gồ ghề/gập ghềnh|ns
陆海=Lục Hải|ns
陇东=Lũng Đông|ns
陇云=Lũng Vân|ns
陇南=Lũng Nam|ns
陇川=Lũng Xuyên|ns
陇州=Lũng Châu|ns
陇西=Lũng Tây|ns
陕北=Thiểm Bắc|ns
陕南=Thiểm Nam/Sơn Nam, phía nam tỉnh Thiểm Tây|ns
陕西=Thiểm Tây|ns
陕西省=tỉnh Thiểm Tây|ns
陡坡=dốc đứng/đường dốc/sườn dốc|ns
陵安市=lăng an thị|ns
隆地东=long địa đông|ns
随州=Tùy Châu|ns
随顺=thuận theo/dựa theo|ns
雀阴=Tước Âm|ns
雀麦=tước mạch|ns
雁荡山=Nhạn Đãng Sơn/Nhạn Đãng sơn|ns
雁门=Nhạn Môn|ns
雁门关=Nhạn Môn Quan/Nhạn Môn quan|ns
雅乐=nhã nhạc/Nhã Nhạc/Gagaku Nhật Bản|ns
雅兰=Nhã Lan|ns
雅兴=nhã hứng/cao hứng|ns
雅典=Athens/A-ten/Nhã Điển/Aten|ns
雅利安=Aryan|ns
雅加达=Jakarta/Giakakta|ns
雅园=Nhã Viên|ns
雅士=nhã sĩ/yas/học giả thanh lịch|ns
雅集=Nhã Tập/hội đồng phân biệt|ns
雅鲁藏布=Nhã Lỗ Tàng Bố|ns
雅鲁藏布江=sông Nhã Lỗ Tàng Bố/Sông Yarlung Tsangpo, Tây Tạng|ns
雍城=Ung Thành|ns
雍州=Ung Châu/Ung châu|ns
雪州=Tuyết Châu|ns
雪海=tuyết hải|ns
雷州=Lôi Châu|ns
雷根斯堡=Regensburg|ns
雾城=vụ thành|ns
雾山=vụ sơn/chuyên môn|ns
雾沙=Vụ Sa|ns
雾海=vụ hải|ns
雾都=thành phố sương mù/sương mù/Trùng Khánh|ns
雾里=trong sương mù/trong sương|ns
雾隐山=Vụ Ẩn Sơn|ns
雾隐村=làng sương mù|ns
霍都=hoắc đô|ns
霸狮=bá sư|ns
霸王龙=khủng long bạo chúa/bá vương long|ns
青丘国=Thanh Khâu quốc|ns
青丹=Thanh Đan|ns
青丹门=Thanh Đan môn|ns
青云=mây xanh/quý tộc/quý phái/thanh vân|ns
青云山=Thanh Vân Sơn|ns
青亚=Thanh Á|ns
青京=Thanh Kinh|ns
青冈=cây sồi|ns
青原=thanh nguyên/Thanh Nguyên/Quận Qingyuan của thành phố Ji'an 吉安 市, Jiangxi|ns
青口=vẹm xanh/Miệng Xanh|ns
青城=Thanh Thành|ns
青城山=núi Thanh Thành|ns
青安=Thanh An|ns
青山=núi xanh/Thanh Sơn/Aoyama|ns
青山绿水=non xanh nước biếc/thanh sơn lục thủy|ns
青岛=Thanh Đảo|ns
青岩=Thanh Nham|ns
青峰=thanh phong|ns
青州=Thanh Châu|ns
青干班=ban thanh niên|ns
青扬=dương xanh/cây thuỷ dương|ns
青旗=thanh kỳ|ns
青春=thanh xuân/tuổi xanh/tuổi trẻ/tuổi xuân|ns
青木=thanh mộc/Thanh Mộc|ns
青林山=Thanh Lâm sơn|ns
青桑城=Thanh Tang Thành|ns
青梅竹马=thanh mai trúc mã|ns
青森县=tỉnh Aomori|ns
青河=Thanh Hà|ns
青海=Thanh Hải|ns
青溪=thanh khê|ns
青牙=thanh nha|ns
青瓦=ngói xanh|ns
青瓦台=Nhà Xanh|ns
青田=Thanh Điền|ns
青竹=thanh trúc|ns
青罗=Thanh La|ns
青羊=Thanh Dương|ns
青翔=Thanh Tường|ns
青藏=thanh tàng|ns
青藏高原=Thanh Tàng cao nguyên|ns
青连=Thanh Liên|ns
青阳=Thanh Dương|ns
青马=thanh mã|ns
青鬃马=Thanh Tông Mã|ns
青黑=xanh đen/thanh hắc|ns
青龙=Thanh Long|ns
青龙山=Thanh Long sơn|ns
青龙门=Thanh Long môn|ns
靖国=Yasukuni|ns
靖州=Tĩnh Châu|ns
靖海=Tịnh Hải|ns
靖边=Tịnh Biên|ns
靖阳=Tĩnh Dương|ns
静海=Tĩnh Hải|ns
非买=không mua|ns
非哥=Phi ca|ns
非州=Phi châu|ns
非洲=Châu Phi|ns
非石=không phải đá|ns
非酋=Phi tù|ns
鞍马=yên ngựa/Kurama/ngựa gỗ tay quay/môn ngựa gỗ tay quay/chinh chiến/yên và ngựa|ns
鞍马劳顿=hành trình mệt mỏi|ns
鞑靼人=người Thát đát|ns
韩国=Hàn Quốc|ns
韩城=Hàn Thành|ns
韩山=Hàn Sơn|ns
韩江=Hàn Giang|ns
韩海=Hàn Hải|ns
韩约=Hàn Ước|ns
韩非=Hàn Phi|ns
韶乐=thiều nhạc|ns
韶关=thiều quan|ns
顺嘴=thuận mồm/trôi chảy/lưu loát/buột miệng|ns
顺城=Thuận Thành|ns
顺州=Thuận Châu|ns
顺昌=Thuận Xương|ns
顺顺利利=thuận thuận lợi lợi|ns
顿开茅塞=bỗng hiểu ra/bỗng thấy sáng tỏ/vỡ lẽ|ns
顿歇=tạm ngừng/tạm nghỉ/tạm ngừng|ns
顿河=sông Đông|ns
顿脚=giẫm chân|ns
顿顿顿=ục ục ục|ns
颍川=Dĩnh Xuyên|ns
颐和园=Di Hoà viên|ns
颛臾=Chuyên Du|ns
馆内=trong quán/bên trong quán|ns
馆前=trước quán|ns
馆藏=sưu tập/sưu tầm/vật sưu tầm/vật sưu tập|ns
馆里=trong quán|ns
首阳山=Thủ Dương Sơn|ns
香克利=Shankly|ns
香兰=Hương Lan|ns
香台=hương thai|ns
香坂=Kousaka/Kōsaka|ns
香堂=hương đường|ns
香山=Hương Sơn|ns
香山寺=chùa Hương Sơn|ns
香巴拉=Hương Ba Lạp|ns
香干=đậu phụ khô|ns
香木=hương mộc|ns
香樟=nhãn thơm|ns
香水=nước hoa/dầu thơm|ns
香汗=đổ mồ hôi|ns
香江=Hương giang|ns
香泽=hương thơm/dầu chải tóc/mùi thơm, mùi hương|ns
香津=nước miếng ngọt ngào|ns
香港=Hồng Kông|ns
香港地区=địa khu Hồng Kông/Khu vực Hồng Kông|ns
香溪=Hương Khê|ns
香狄亚=Shandia|ns
香瓜=cây dưa hồng|ns
香茅=cây sả|ns
马丁内斯=Martínez|ns
马亚=Maillat|ns
马克思列宁主义=chủ nghĩa Mác-Lênin|ns
马克西米利安=Maximilian|ns
马克西马=Maxima|ns
马关条约=hiệp ước Mã Quan|ns
马尼亚=Mania|ns
马尼拉湾=vịnh Manila|ns
马市=chợ ngựa|ns
马店=nhà trọ/quán trọ|ns
马来亚=Mã Lai/Malaya|ns
马来西亚=Malaysia|ns
马格纳斯=Magnus|ns
马河=Hoàng Hà|ns
马绍尔群岛=Quần đảo Marshall|ns
马耳他=Malta|ns
马脚=chân ngựa/chân tướng/sơ sót/thiếu sót/sơ hở/chân ngựa / chân tướng|ns
马苏=Mã Tô|ns
马萨诸塞州=bang Massachusetts/Massachusetts, tiểu bang Hoa Kỳ|ns
马达加斯加=Madagasca/Mã Đạt Gia Tư|ns
马达维基亚=Mahdavikia|ns
马那瓜=Managua|ns
马里亚=Maria|ns
马里兰州=bang Maryland/Maryland, tiểu bang Hoa Kỳ|ns
马鞍山=Mã An sơn|ns
驻屯=đóng quân/đồn trú|ns
驻扎地=nơi đóng quân|ns
驻龙=Trú Long|ns
骊山=Ly Sơn|ns
骊歌=khúc hát cáo biệt|ns
骊龙=Ly Long|ns
高原=cao nguyên/rẻo cao/bình nguyên/đồng cao|ns
高古=cao cổ/cao thượng như thời xưa|ns
高句丽=Cao Câu Ly|ns
高头大马=ngựa cao to/con ngựa cao to/người cao lớn|ns
高山=núi cao/cao sơn|ns
高山流水=cao sơn lưu thủy/tri âm tri kỷ/cao sơn lưu thuỷ|ns
高庆=Cao Khánh|ns
高昌国=Cao Xương quốc|ns
高架桥=cầu vượt/cầu cạn/cái cầu cao|ns
高桥南=Cao Kiều Nam|ns
高洋=Cao Dương|ns
高邮=Cao Bưu|ns
高酋=Cao Tù|ns
高门大户=cao môn đại hộ|ns
高阳=Cao Dương|ns
高高兴兴=vô cùng cao hứng/vui vẻ/phấn khởi/thật cao hứng|ns
魁北克=Khôi Bắc Khắc|ns
魁地奇=Quidditch|ns
魁星阁=Khôi Tinh Các|ns
魁首=khôi thủ/người đứng đầu/đầu sỏ/thủ khoa/thủ lĩnh/người phụ trách/đội trưởng|ns
魏国=Ngụy quốc/nước Ngụy|ns
鱼鲜=thức ăn thuỷ sản|ns
鲁南=Lỗ Nam/Renan|ns
鲁国=Lỗ quốc|ns
鲁州=Lỗ Châu|ns
鲁本=Ruben|ns
鲁省=Sơn Đông|ns
鲁西西=Luxixi|ns
鳌拜=Ngao Bái|ns
鸡鸣寺=Kê Minh Tự|ns
鸣沙山=Minh Sa Sơn|ns
鸭绿江=sông Áp Lục/Sông Áp Lục/Áp Lục Giang/Sông Áp Lục, tạo thành một phần của biên giới Trung Quốc - Triều Tiên|ns
鹅考=Nga Khảo|ns
鹊桥=cầu ô thước/cầu hỉ thước/thước kiều|ns
鹊起=lên cao/thước khởi/dần lên cao|ns
鹏城=Bằng thành|ns
鹤哥=Hạc ca|ns
鹤嘴=mỏ hạc|ns
鹤山=Hạc Sơn|ns
鹤岗=Hạc Cương|ns
鹤望兰=thiên điểu/hạc vọng lan/Hạc Vọng Lan/Hoa thiên điểu|ns
鹫马=bằng mã/con ngựa|ns
鹰鼻=mũi ưng|ns
麒麟山=Kỳ Lân Sơn|ns
黄东=Hoàng Đông|ns
黄冈=Hoàng Cương/thành phố cấp tỉnh Hoàng Cương ở Hồ Bắc|ns
黄化=hoá vàng/úa/úa vàng|ns
黄南=Hoàng Nam|ns
黄口=lời trẻ con/hoàng khẩu|ns
黄土高原=cao nguyên hoàng thổ|ns
黄埃=bụi đất vàng/bụi màu vàng/bụi đất|ns
黄埔=Hoàng Phố/Cảng Quảng Đông|ns
黄安=Hoàng An|ns
黄山=Hoàng Sơn|ns
黄州=Hoàng Châu|ns
黄极=Hoàng Cực|ns
黄桥=hoàng kiều|ns
黄沙=cát vàng/hoàng sa|ns
黄河=Hoàng Hà|ns
黄泉路=Hoàng Tuyền Lộ|ns
黄浦=Hoàng Phổ|ns
黄浦江=sông Hoàng Phổ|ns
黄浦江畔=bờ sông Hoàng Phố|ns
黄海=Hoàng Hải|ns
黄渤=Hoàng Bột|ns
黄烽=Hoàng Phong|ns
黄熟=chín vàng|ns
黄牙=răng vàng/răng vàng khè|ns
黄瓦=ngói vàng|ns
黄连=thuốc đắng/hoàng liên|ns
黄镇=Hoàng trấn|ns
黄陵=hoàng lăng|ns
黄龙山=Hoàng Long Sơn|ns
黎山=Lê sơn|ns
黎牙=Legazpi|ns
黎阳=Lê Dương|ns
黎黎=Lê Lê|ns
黑加仑=lý chua đen/gallon đen/blackcurrant|ns
黑匣=hộp đen|ns
黑土地=hắc thổ địa|ns
黑客帝国=The Matrix|ns
黑山=hắc sơn|ns
黑山共和国=Montenegro|ns
黑崎=Kurosaki|ns
黑市=chợ đen/chợ đêm|ns
黑店=hắc điếm/quán trọ giết người cướp của|ns
黑水城=Hắc Thủy Thành|ns
黑沙=đống cát đen|ns
黑河=Hắc Hà|ns
黑洞=lỗ đen/hắc động/ngôi sao đã tắt/hố đen|ns
黑海=hắc hải/Biển Đen/Hắc Hải/Black Sea|ns
黑潭=hắc đàm|ns
黑牙=Hắc Nha|ns
黑瓦=ngói đen|ns
黑索=hắc tác|ns
黑陵=Hắc Lăng|ns
黑隐山=Hắc Ẩn Sơn|ns
黑非洲=châu Phi đen|ns
黑马=hắc mã/hắc mã!/ (*hạt giống ko lường được)|ns
黑麦=lúa mì đen|ns
黑龙国=Hắc Long quốc|ns
黑龙域=Hắc Long Vực|ns
黑龙岛=Hắc Long đảo|ns
黑龙江=Hắc Long Giang|ns
黑龙潭=Hắc Long đàm|ns
黑龙门=hắc long môn|ns
黔首=bá tính/dân chúng/bá tính|ns
鼎中=trong đỉnh|ns
鼎革=thay đổi triều đại/thay cũ đổi mới|ns
鼓山=Cổ Sơn/Gushan hoặc quận Kushan của thành phố Cao Hùng 高雄市 [Gao1 xiong2 shi4], miền nam Đài Loan|ns
齐国=Tề quốc|ns
齐家治国=tề gia trị quốc|ns
齐州=Tề Châu|ns
齐都=Tề đô|ns
龙丹=Long Đan|ns
龙井=Long Tỉnh/long tỉnh|ns
龙伯国=Long Bá quốc|ns
龙兴=long hưng/Long Hưng|ns
龙华寺=Long hoa tự|ns
龙哥=Long ca|ns
龙城=Long thành|ns
龙尾=đuôi rồng|ns
龙山=Long sơn|ns
龙岭=Long Lĩnh|ns
龙川=Long Xuyên|ns
龙庙=miếu rồng/Đền Rồng|ns
龙江=Long Giang|ns
龙池=long trì|ns
龙河=long hà|ns
龙海=Long Hải|ns
龙湖=Long hồ|ns
龙滩=đầm rồng|ns
龙潭=long đàm|ns
龙潭虎穴=đầm rồng hang hổ/long đàm hổ huyệt/địa thế hiểm nguy/nơi cực kỳ nguy hiểm|ns
龙煌=Long Hoàng|ns
龙牙=long nha/răng rồng|ns
龙脉=long mạch|ns
龙舌兰=Tequila|ns
龙门=Long Môn/long môn|ns
龙门山=Long Môn Sơn|ns
龙门石窟=Long Môn thạch quật|ns
龙阳=Long Dương|ns
龙马=long mã|ns
龟仙流=Quy Tiên Phái|ns
龟伯=Quy bá|ns
龟兹=Quy Tư|ns
龟哥=Quy ca|ns
龟岛=quy đảo|ns
龟甲=mai rùa/quy giáp|ns
龟脚=chân rùa|ns
