三合会=Tam Hợp hội|nt
上流社会=thượng lưu xã hội/xã hội thượng lưu|nt
上议院=thượng nghị viện|nt
上进心=lòng cầu tiến|nt
世界卫生组织=tổ chức y tế thế giới/Tổ chức Y tế Thế giới|nt
世界贸易组织=Tổ chức Thương mại Thế giới/Tổ chức thương mại thế giới, WTO|nt
世贸大楼=cao ốc WTC|nt
东京大学=đại học Tokyo|nt
东南大学=Đông Nam đại học|nt
东林党=đảng Đông Lâm|nt
中书省=Trung Thư tỉnh|nt
中医学院=Trung Y Học Viện|nt
中南部=trung nam bộ|nt
中国人民解放军=quân giải phóng nhân dân Trung Quốc|nt
中国同盟会=Trung Quốc đồng minh hội|nt
中国工农红军=hồng quân công nông Trung Quốc/hồng quân|nt
中国政府=chính phủ Trung Quốc|nt
中央书记处=trung ương thư ký xử|nt
中央公园=trung ương công viên|nt
中央区=khu trung ương|nt
中央政府=chính phủ trung ương/chính quyền trung ương|nt
中央政治局=cục chính trị trung ương/cục chính trị trung ương|nt
中央电视台=đài truyền hình trung ương|nt
中央银行=ngân hàng trung ương|nt
中学教师=giáo sư trung học|nt
中宣部=trung tuyên bộ|nt
中情局=CIA|nt
中控台=bảng điều khiển|nt
中文系=ngành Trung văn/hệ tiếng Trung|nt
中纪委=trung kỷ ủy|nt
中组部=Trung tổ bộ|nt
中草药=Trung thảo dược|nt
中西部=trung tây bộ|nt
临时政府=chính phủ tạm thời/chính phủ lâm thời|nt
丹书铁券=đan thư thiết khoán|nt
丽春院=Lệ Xuân viện|nt
丽红院=Lệ Hồng viện|nt
九国盟=Cửu Quốc Minh|nt
交战国=nước giao chiến/nước đánh nhau|nt
交易中心=trung tâm giao dịch|nt
交易会=giao dịch hội|nt
交易所=nơi giao dịch/phòng giao dịch/thị trường chứng khoán/sở giao dịch|nt
交汇处=chỗ giao hội|nt
交警队=đội cảnh sát giao thông|nt
交通厅=giao thông thính|nt
交通局=cục Giao Thông/cục giao thông|nt
交通部=giao thông bộ|nt
京剧院=kinh kịch viện|nt
京都大学=kinh đô đại học/Đại học Kyoto|nt
人力资源部=bộ tài nguyên nhân lực|nt
人口学=dân số học/nhân khẩu học|nt
人文学院=học viện nhân văn/Trường Nhân văn/Học viện nhân văn|nt
人文科学=khoa học xã hội|nt
人民代表大会=đại hội đại biểu nhân dân|nt
人民党=đảng Nhân dân/Đảng nhân dân|nt
人民公社=công xã nhân dân|nt
人民大学=Nhân Dân đại học|nt
人民政府=chính phủ nhân dân/chính quyền nhân dân/chính phủ nhân dân|nt
人民检察院=viện kiểm sát nhân dân|nt
人民法院=toà án nhân dân|nt
人民解放军=quân giải phóng nhân dân|nt
人民银行=ngân hàng nhân dân|nt
人生哲学=nhân sinh triết học|nt
人皇印=Nhân Hoàng Ấn|nt
伦理学=luân lý học|nt
住院医师=bác sĩ nội trú|nt
住院部=khu nội trú|nt
供电局=cục cung cấp điện/cục điện lực|nt
俄联邦=Liên bang Nga/Liên bang Nga, RSFSR|nt
信息中心=tín tức trung tâm|nt
儿童医院=bệnh viện nhi/bệnh viện nhi đồng/Bệnh viện Nhi đồng/Bệnh viện nhi đồng|nt
儿童团=đội nhi đồng/đoàn nhi đồng|nt
儿童文学=văn học thiếu nhi|nt
光学玻璃=thuỷ tinh quang học|nt
党代会=đảng đại hội|nt
党卫队=đảng vệ đội/Schutzstaffel/đảng SS/đảng vệ quân|nt
党委会=đảng ủy hội|nt
党政办=đảng chính bạn/Đảng chính trị|nt
全班同学=toàn bộ đồng học/bạn học cả lớp|nt
八国联军=liên quân tám nước|nt
公交公司=công ty giao thông công cộng/công ty xe buýt/Công ty giao thông công cộng|nt
公共交通=giao thông công cộng/phương tiện giao thông công cộng|nt
公共场所=nơi công cộng/khu vực công cộng|nt
公共汽车=xe công cộng/xe ta-xi/xe buýt công cộng|nt
公安局=cục công an|nt
公安院校=Học viện Cảnh sát/học viện công an|nt
公立医院=bệnh viện công|nt
共产党=đảng Cộng Sản|nt
共产国际=Quốc tế Cộng sản|nt
共和党=Đảng Cộng Hòa|nt
共青团=đoàn thanh niên cộng sản|nt
内务府=phủ Nội Vụ/Bộ Hộ Hoàng gia|nt
内务部=bộ nội vụ|nt
内政部=Bộ nội vụ|nt
军事学院=học viện quân sự|nt
军事科学=khoa học quân sự|nt
军事院校=Học viện Quân sự|nt
军人家庭=gia đình quân nhân|nt
军国大事=quân quốc đại sự|nt
农业大学=đại học Nông Nghiệp/đại học nông nghiệp|nt
农业局=Cục Nông nghiệp|nt
农业部=Bộ Nông nghiệp|nt
农委会=ủy ban nông nghiệp|nt
冰银=băng ngân|nt
剑中=trong kiếm/kiếm trung|nt
剑书=kiếm thư|nt
剑二=Kiếm Nhị|nt
剑合=kiếm hợp|nt
剑君白=Kiếm Quân Bạch|nt
剑皇=Kiếm Hoàng/kiếm hoàng|nt
加工厂=nhà máy chế biến|nt
加油打气=cổ vũ động viên|nt
加油站=trạm xăng dầu|nt
北京电影学院=Học viện điện ảnh Bắc Kinh/Học viện Điện ảnh Bắc Kinh|nt
北大西洋公约组织=NATO|nt
北洋大学=Đại học Bắc Dương|nt
北洋水师=Hạm đội Bắc Dương/hải quân miền bắc Trung Quốc|nt
协和医院=bệnh viện Hiệp Hòa|nt
卫星电视=truyền hình vệ tinh/Truyền hình vệ tinh|nt
卫生厅=phòng vệ sinh|nt
卫生室=phòng vệ sinh|nt
卫生局=Cục vệ sinh/bộ vệ sinh|nt
卫生所=phòng y tế/trạm y tế|nt
卫生部=Bộ vệ sinh|nt
古典文学=văn học cổ/văn học cổ điển|nt
司法局=Cục Tư pháp|nt
司法部=Bộ tư pháp|nt
同班同学=bạn học cùng lớp|nt
同盟会=Đồng Minh hội|nt
同盟军=quân đồng minh|nt
哈佛商学院=trường Kinh doanh Harvard/Trường Kinh doanh Harvard|nt
哈佛大学=đại học Harvard/Đại học Harvard|nt
哈合台=Cáp Hợp Thai|nt
哈工大=Cáp Công Đại|nt
商业中心=trung tâm thương nghiệp|nt
商业学校=trường thương mại/trường thương nghiệp/Trường thương nghiệp|nt
商业局=Bộ Thương Nghiệp/cục thương nghiệp|nt
商业广场=quảng trường thương mại|nt
商业部=Bộ thương mại|nt
商业银行=ngân hàng thương nghiệp|nt
商务局=cục thương vụ|nt
商务车=xe thương vụ|nt
商务部=Bộ công thương|nt
商学院=thương học viện|nt
四代同堂=tứ đại đồng đường/bốn thế hệ đồng đường|nt
四合院=Tứ Hợp Viện|nt
团市委=đoàn thị ủy|nt
团省委=đoàn tỉnh ủy|nt
国与国=quốc cùng quốc|nt
国务院=bộ ngoại giao/quốc vụ viện/Quốc Vụ Viện/nội các chính phủ/bộ ngoại giao Hoa Kỳ|nt
国土局=quốc thổ cục|nt
国大党=đảng Quốc Đại/Đảng Quốc hội Ấn Độ|nt
国安局=Quốc An cục/quốc an cục/Cục Quốc An|nt
国家博物馆=nhà bảo tàng quốc gia|nt
国家机关=cơ quan nhà nước/cơ quan nhà nước cao nhất/cơ quan quốc gia|nt
国家银行=ngân hàng quốc gia|nt
国家队=đội tuyển quốc gia/quốc gia đội|nt
国宾馆=Quốc Tân quán|nt
国富民强=dân giàu nước mạnh|nt
国库券=tín phiếu nhà nước/công trái|nt
国民党=Quốc Dân đảng|nt
国民政府=chính phủ quốc dân|nt
国税局=chi cục thuế|nt
国统区=quốc thống khu|nt
国防军=quân đội chính quy|nt
国防大学=đại học quốc phòng|nt
国防部=Bộ quốc phòng|nt
国际刑警组织=tổ chức cảnh sát quốc tế/interpol/Interpol|nt
国际化=quốc tế hóa|nt
国际妇女节=ngày quốc tế phụ nữ|nt
国际纵队=đội quân tình nguyện quốc tế|nt
国际联盟=liên minh quốc tế/hội quốc liên|nt
国际货币基金组织=Quỹ Tiền tệ Quốc tế/Quỹ tiền tệ quốc tế|nt
国际足联=Liên đoàn bóng đá quốc tế (FIFA)|nt
国青队=Quốc Thanh Đội|nt
地方法院=địa phương pháp viện|nt
地方舰队=hạm đội địa phương|nt
城建局=cục xây dựng/thành kiến cục|nt
城管局=cục quản lý đô thị/cục thành quản|nt
复印室=phòng photocopy|nt
复合物=hợp chất/chất phức hợp/hỗn hợp|nt
复旦大学=đại học Phúc Đán|nt
外交团=đoàn ngoại giao|nt
外交学=ngoại giao/Ngoại giao|nt
外交部=bộ ngoại giao/Bộ ngoại giao|nt
外人田=ruộng người ngoài|nt
外务省=Bộ Ngoại giao|nt
外务部=bộ ngoại vụ|nt
外联部=ngoại liên bộ|nt
外贸公司=công ty ngoại mậu/Công ty Thương mại Nước ngoài/Công ty ngoại thương|nt
外邦人=người ngoại bang|nt
大众汽车=Volkswagen|nt
大播特播=đại bá đặc bá|nt
大操大办=tổ chức lớn|nt
大财团=đại tập đoàn/tập đoàn tài chính lớn|nt
天文学=thiên văn học|nt
奔驰车=Mercedes|nt
宁国府=Ninh Quốc phủ|nt
安全局=cục An Toàn/cục an ninh|nt
安全玻璃=kính an toàn|nt
安理会=Hội đồng bảo an/UNSC|nt
巴黎公社=công xã Paris|nt
平平展展=bằng bằng phẳng phẳng|nt
广工=Quảng Công|nt
广播室=phòng radio/phòng phát sóng/phòng phát thanh|nt
广播电台=đài phát thanh|nt
广播电视局=đài phát thanh truyền hình|nt
广播站=trạm radio|nt
广电局=quảng điện cục/cục phát thanh|nt
广电部=quảng điện bộ|nt
延世大学=Đại học Yonsei|nt
建设厅=kiến thiết thính|nt
建设局=kiến thiết cục|nt
建设部=Bộ xây dựng|nt
开发部=bộ khai thác|nt
微软公司=công ty phần mềm|nt
德育处=khoa giáo dục đạo đức/văn phòng giáo dục đạo đức|nt
怡红院=Di Hồng viện/Di hồng viện|nt
意志坚强=ý chí kiên cường|nt
招商会=chiêu thương hội/tuyển thương hội|nt
招商局=Chiêu thương cục|nt
拜师学艺=bái sư học nghệ|nt
政治协商会议=hội nghị hiệp thương chính trị|nt
文体局=cục văn hóa và thể dục thể thao|nt
文学社=câu lạc bộ văn học|nt
文学部=CLB Văn học|nt
文学院=văn học viện|nt
文工团=đoàn văn công|nt
文理学院=Văn Lý học viện|nt
文艺社=CLB Văn học|nt
新华书店=nhà sách Tân Hoa/Hiệu sách Xinhua/Nhà sách Tân Hoa Xã, chuỗi cửa hàng sách lớn nhất Trung Quốc|nt
新华社=Tân Hoa xã|nt
新四军=Tân Tứ quân|nt
新政府=chính phủ mới/chính phủ mới|nt
新文学=văn học mới|nt
新旗舰=soái hạm mới|nt
新闻学=báo chí|nt
新闻局=Bộ Thông Tin|nt
新闻社=thông tấn xã|nt
新闻部=Bộ thông tin|nt
新鲜空气=không khí mới mẻ|nt
施工队=thi công đội|nt
日本政府=chính phủ Nhật Bản|nt
早稻田=Waseda|nt
普通家庭=gia đình bình thường|nt
最大化=tối đại hóa/sử dụng tốt nhất|nt
最高法院=tối cao pháp viện|nt
最高潮=cao triều nhất/cao trào nhất|nt
杜工部=Đỗ công bộ|nt
株式会社=công ty TNHH|nt
欧洲足联=Liên đoàn bóng đá châu Âu (UEFA)|nt
正规军队=quân đội chính quy|nt
武工队=đội công tác vũ trang/đội tuyên truyền vũ trang|nt
武术馆=quán võ thuật/võ viện|nt
武林大会=võ lâm đại hội|nt
武装部=võ trang bộ|nt
武警总部=Vũ Cảnh tổng bộ/tổng bộ cảnh sát vũ trang|nt
民主党=Đảng Dân Chủ|nt
民主联盟=liên minh dân chủ|nt
民兵组织=tổ chức dân binh/dân quân|nt
民富国强=dân giàu nước mạnh/dân giàu quốc cường|nt
民政局=cục dân chính/dân chính cục/cục dân chính|nt
民政部=bộ dân chính|nt
民族党=đảng Dân tộc|nt
民族学=dân tộc học/nhân học|nt
沧溟=Thương Minh|nt
河外星系=quần thể sao ngoài hệ Ngân hà|nt
法务部=Bộ Pháp vụ|nt
法医学=pháp y học|nt
法国政府=chính phủ nước Pháp|nt
法国队=đội Pháp|nt
法学院=học viện luật|nt
泰晤士报=The Times/Times|nt
洪堡大学=đại học Humboldt|nt
海事局=cục hàng hải|nt
海关总署=tổng cục hải quan/Tổng cục Hải quan/Tổng cục hải quan|nt
海军医院=hải quân y viện/bệnh viện hải quân/Bệnh viện hải quân|nt
海军陆战队=lính thủy đánh bộ/thủy quân lục chiến/Lính thủy đánh bộ|nt
海洋学=hải dương học|nt
海洋生物=sinh vật biển/sinh vật hải dương|nt
海空军=hải không quân|nt
深有体会=thấm sâu trong người/thấu hiểu rất rõ|nt
深青=xanh đậm|nt
清华北大=Thanh Hoa Bắc Đại|nt
清华大学=Thanh Hoa Đại Học|nt
渣男=tra nam/cặn bã nam/Đàn ông cặn bã/đàn ông tồi|nt
澳大利亚联邦=Australia|nt
燕京大学=Yến Kinh đại học|nt
爱国心=lòng yêu nước|nt
牙科医院=bệnh viện nha khoa/Bệnh viện nha khoa|nt
牛排馆=quán bít tết|nt
牛津大学=đại học Oxford|nt
环球旅行=du lịch vòng quanh thế giới/đi du lịch vòng quanh thế giới/Du lịch vòng quanh thế giới|nt
理工大学=đại học Khoa Học Tự Nhiên|nt
理工学院=Viện Công nghệ|nt
瑞士政府=chính phủ Thụy Sĩ/chính phủ Thụy Sĩ|nt
百货商店=cửa hàng bách hoá/cửa hàng tổng hợp|nt
硬邦邦=cứng rắn/rắn chắc/chắc chắn/nghạnh bang bang|nt
社会党=đảng xã hội/Đảng Xã hội/Đảng xã hội chủ nghĩa|nt
社会科学=khoa học xã hội|nt
社科院=xã khoa viện|nt
神学院=Thần học viện|nt
福利社=nhóm phúc lợi|nt
福利院=viện mồ côi|nt
科技展=triển lãm khoa học và công nghệ|nt
科研所=khoa nghiên sở|nt
科研部=khoa nghiên bộ|nt
秘密组织=tổ chức bí mật|nt
税务局=cục thuế vụ/thuế vụ cục|nt
第五纵队=đội quân thứ năm|nt
筑坛=trúc đàn|nt
红旗车=xe con Hồng Kỳ/hồng kỳ xa|nt
红通通=đỏ rừng rực/đỏ ngầu/hồng thông thông|nt
纽约时报=New York Times|nt
经贸委=kinh mậu ủy|nt
经贸局=cục mậu dịch kinh tế|nt
统战部=thống chiến bộ|nt
统治集团=tập đoàn thống trị|nt
统计学=môn thống kê/ngành thống kê/thống kê học|nt
统计局=thống kê cục|nt
综合大学=đại học tổng hợp|nt
美发师=thợ làm tóc|nt
美国有线电视新闻网=Cable News Network|nt
美年达=Mirinda|nt
美术学=mỹ thuật học/mỹ thuật/nghệ thuật/Mỹ thuật học|nt
美术学院=mỹ thuật học viện|nt
美术馆=viện bảo tàng mỹ thuật|nt
联合会=liên hiệp hội|nt
联合体=liên hợp thể|nt
联合公报=công bố chung/tuyên bố chung|nt
联合国=Liên hiệp quốc|nt
联合国教科文组织=UNESCO|nt
联合政府=chính phủ liên hiệp/chính phủ liên hiệp|nt
联席会=liên tịch hội|nt
联络站=trạm liên lạc|nt
联络网=mạng lưới liên lạc|nt
联谊会=Liên Nghị Hội|nt
联邦军=quân liên bang|nt
联邦政府=chính phủ liên bang/chính phủ liên bang|nt
联邦调查局=FBI/Cục Điều Tra Liên Bang - FBI|nt
联防队=liên phòng đội|nt
自民党=đảng Tự Dân/LDP/Đảng Dân chủ Tự do|nt
自由王国=vương quốc tự do|nt
自由贸易区=khu tự do mua bán|nt
自警团=tự cảnh đoàn|nt
致命处=chỗ trí mạng|nt
航空局=hàng không cục/cục hàng không|nt
花京院=Kakyoin/Kakyōin|nt
花信年华=thời kỳ trổ hoa|nt
苏联红军=hồng quân Liên Xô|nt
英国政府=chính phủ nước Anh|nt
英格兰队=đội Anh|nt
英法联军=liên quân Anh Pháp|nt
英联邦=liên bang Anh|nt
英足总=FA|nt
药学院=dược học viện|nt
药监局=Dược Giám cục|nt
荷兰东印度公司=công ty Đông Ấn Hà Lan|nt
莫生气=không nên tức giận|nt
解放军=quân giải phóng/giải phóng quân|nt
解放区=khu giải phóng/vùng giải phóng|nt
财务室=phòng tài vụ|nt
财务部=bộ tài vụ/tài vụ bộ/phòng tài vụ|nt
财政厅=phòng tài chính/phòng tài chính|nt
财政司=ty tài chính/ty tài chính|nt
财政局=cục tài chính/cục tài chính/cục tài chính|nt
财政部=Bộ tài chính/Bộ tài chính|nt
财经大学=đại học Kinh tế Tài Chính|nt
质检局=cục kiểm tra chất lượng|nt
贵宾厅=phòng khách quý|nt
超级大国=siêu cường quốc|nt
越野车=xe việt dã/việt dã xa/xe Jeep|nt
辉格党=đảng Whig/Đảng Whig|nt
进林府=vào Lâm phủ|nt
通信站=trạm thông tin|nt
通政司=Thông Chính ti|nt
通讯社=thông tấn xã/hãng thông tấn/hãng tin|nt
邮政局=cục bưu chính/sở bưu chính|nt
邮政总局=tổng cục bưu chính/bưu điện/tổng cục bưu điện/Tổng cục bưu chính|nt
邮电局=bưu cục/sở bưu điện|nt
里通外国=thông đồng với nước ngoài/cấu kết với nước ngoài để phản bội tổ quốc|nt
重大进展=tiến triển to lớn|nt
钢铁集团=Tập đoàn Sắt thép|nt
铁道部=Bộ Đường sắt|nt
镇党委=trấn đảng ủy|nt
镇抚司=trấn phủ ti|nt
镇政府=trấn chính phủ/trấn chính phủ|nt
陆军医院=bệnh viện lục quân/Bệnh viện lục quân|nt
陆战队=lục chiến đội|nt
陆航团=trung đoàn quân/Trung đoàn Hàng không Lục quân|nt
青年团=đoàn thanh niên/Đoàn Thanh niên|nt
青年队=đội thanh niên|nt
青红会=Thanh Hồng Hội|nt
韩国政府=chính phủ Hàn quốc/chính phủ Hàn quốc|nt
音乐会=âm nhạc hội|nt
音乐厅=nhà hát/phòng hòa nhạc/khán phòng|nt
音乐学院=Học viện Âm nhạc|nt
香港大学=Đại học Hồng Kông|nt
香港政府=Chính phủ Hương cảng/chính phủ Hương cảng|nt
马戏团=gánh xiếc thú|nt
驻京办=trú kinh bạn|nt
高级中学=trung học phổ thông|nt
麻省理工=MIT|nt
麻省理工学院=MIT|nt
黑社会=xã hội đen/giới giang hồ/giới xã hội đen/băng đảng|nt
