一氧化二氮=thán khí|nz
一氧化氮=thán khí|nz
一氧化碳=ô-xít-các-bon|nz
一片丹心=một lòng trung can|nz
一神教=thờ một thần/nhất thần giáo/đạo một thần|nz
一米阳光=Nhất Mễ Dương Quang|nz
一线希望=một tia hi vọng|nz
七七事变=sự kiện cầu Lư Câu|nz
七仔=Thất tử|nz
七十二变=bảy mươi hai biến|nz
七命=Thất Mệnh|nz
七宝=thất bảo|nz
七彩=thất thải/7 màu/bảy màu|nz
七战=bảy trận chiến|nz
七族=bảy tộc|nz
七星=thất tinh/bảy ngôi sao/bắc đẩu tinh|nz
七曜=Thất Diệu|nz
七月份=cả tháng bảy/tháng bảy|nz
七珠=Thất Châu|nz
七级浮屠=thất cấp phù đồ/chùa bảy tầng|nz
七罪=thất tội|nz
七芒星=thất mang tinh|nz
七虹=Thất Hồng|nz
七龙珠=Dragon Ball|nz
万事通=Vạn Sự Thông|nz
万历=Vạn Lịch|nz
万变=vạn biến|nz
万安=Vạn An|nz
万家生佛=vạn gia sinh Phật|nz
万教=vạn giáo|nz
万斯=Vạn Tư|nz
万族=vạn tộc|nz
万水千山=muôn sông nghìn núi/khó khăn gian khổ/vạn thủy thiên sơn|nz
万状=muôn dạng/muôn kiểu/đủ loại/vạn trạng|nz
万的=vạn|nz
万皇=Vạn Hoàng|nz
万真=vạn chân|nz
万福=vạn phúc|nz
万科=Vạn Khoa/Vanke, công ty bất động sản lớn của Trung Quốc, thành lập năm 1984|nz
万能=vạn năng/toàn năng/có nhiều công dụng|nz
万通=vạn thông|nz
万邦=vạn bang/Wanbon/tất cả các quốc gia|nz
万金油=dầu cù là/dầu cao Vạn Kim/người vạn năng/vạn kim du/dầu cao Vạn Kim (*cái gì cũng làm được nhưng không chuyên cao về một cái gì cả)|nz
三一学院=học viện Trinity|nz
三丰=Tam Phong|nz
三人成虎=ba người nói có hổ/ba người thành hổ/ba người đàn ông nói chuyện làm nên một con hổ/tin đồn lặp đi lặp lại trở thành sự thật|nz
三仔=Tam tử|nz
三元及第=tam nguyên cập đệ|nz
三光=tam quang|nz
三克油=thanh diu|nz
三农=Tam Nông|nz
三卫=tam vệ|nz
三叉=tam xoa|nz
三味书屋=phòng sách Tam Vị|nz
三味线=shamisen/ba dòng hương vị/shamisen, nhạc cụ ba dây của Nhật Bản|nz
三国演义=Tam Quốc Diễn Nghĩa|nz
三国鼎立=tam quốc đỉnh lập|nz
三大教=tam đại giáo|nz
三宝=tam bảo/ba vật quý|nz
三强=tam cường|nz
三战三和=ba chiến ba hòa|nz
三教=tam giáo|nz
三文=ba văn/tam văn|nz
三文治=sandwich|nz
三文鱼=cá hồi|nz
三明治=sandwich|nz
三星=tam tinh/ba sao/3 sao/Tam Tinh/Samsung|nz
三板斧=tam bản phủ|nz
三棱镜=tam lăng kính/lăng kính|nz
三民主义=chủ nghĩa Tam Dân|nz
三氧化二铁=sắt iii oxit/sắt trioxide|nz
三泉=Tam Tuyền|nz
三浦=Miura|nz
三潭印月=Tam Đàm Ấn Nguyệt|nz
三焦=tam tiêu|nz
三环=tam hoàn|nz
三皇=Tam Hoàng/tam hoàng|nz
三石弓=tam thạch cung|nz
三秀=tam tú|nz
三聚氰胺=Melamine C3H6N6|nz
三芒星=tam mang tinh|nz
三菱=tam lăng/Mitsubishi|nz
三观=tam quan|nz
三角帆=buồm tam giác|nz
三角状=hình tam giác|nz
三论宗=Tam Luận Tông|nz
三通=tam thông|nz
三阳开泰=tam dương khai thái|nz
上班族=dân đi làm|nz
不成文=bất thành văn/hiểu ngầm/hiểu ý/ngầm|nz
不结盟运动=phong trào không liên kết/phong trào phi liên kết|nz
不过尔尔=chỉ thường thôi|nz
不遑宁处=tận tâm tận lực|nz
不饱和=không bão hòa|nz
专美=giành riêng tên đẹp/giành riêng tên hay|nz
世代交替=sự giao thế thế hệ/gen kép/tính khác phát sinh|nz
世界主义=chủ nghĩa thế giới|nz
世界大战=thế chiến/chiến tranh thế giới|nz
世界杯=World Cup|nz
世界纪录=kỷ lục thế giới|nz
世界观=thế giới quan|nz
世界语=Quốc tế ngữ|nz
丙丁=Bính Đinh|nz
丙酮=a-xê-tôn/axêtôn|nz
东冲西突=tác chiến dũng mãnh/tấn công bốn phía|nz
东华=Đông Hoa|nz
东广=Đông Nghiễm|nz
东床=đông sàng/rể/con rể|nz
东正教=chính giáo|nz
东海龙王=Đông Hải Long Vương|nz
东盛=Đông Thịnh|nz
东芝=Toshiba|nz
丝兰=Ti Lan|nz
丝网=lưới tơ/tia lưới|nz
丝锥=cái ron/ta-rô/mũi ren|nz
两匹马=hai con ngựa|nz
中世纪=thời Trung cổ/thời trung cổ|nz
中丹田=trung đan điền/trong đan điền|nz
中乘=trung thừa|nz
中二指=hai chỉ giữa|nz
中信=trung tín|nz
中共党史=lịch sử Đảng Trung Quốc/Lịch sử Đảng Trung Quốc|nz
中农=trung nông|nz
中华=Trung Hoa|nz
中华民族=dân tộc Trung Hoa/dân tộc Kinh|nz
中华烟=thuốc lá Trung Hoa|nz
中和剂=chất trung hòa/thuốc trung hòa|nz
中国式=kiểu Trung Quốc/phong cách Trung Quốc|nz
中大奖=trúng giải thưởng lớn/trúng số độc đắc|nz
中奖=trúng thưởng/trúng giải/trúng số độc đắc|nz
中子星=sao Nơtron|nz
中山服=áo tôn trung sơn/trung sơn phục/CL:件[jian4]|nz
中山美穗=Miho Nakayama|nz
中山装=kiểu áo Tôn Trung Sơn|nz
中控室=phòng điều khiển trung tâm/phòng điều khiển|nz
中文=tiếng Trung/tiếng Trung/Trung văn/tiếng Hoa/tiếng Châu Á|nz
中文网=mạng tiếng Trung|nz
中日关系=quan hệ Trung Nhật|nz
中正=công chính/công bình/công bằng chính trực/trung chính|nz
中毒=trúng độc/ngộ độc|nz
中继=bộ kích sóng/bộ lặp|nz
中继器=bộ kích sóng|nz
中继站=trạm trung chuyển/trạm trung chuyển thông tin/trung kế trạm|nz
中耳炎=viêm tai giữa/viêm trung nhĩ|nz
中肯=đúng trọng tâm/trúng điểm yếu|nz
中英文=tiếng Trung tiếng Anh/tiếng Trung và tiếng Anh|nz
中裕=Trung Dụ|nz
中轴线=trục trung tâm/đường trung trực|nz
中银=ngân hàng Trung Quốc/Ngân hàng Trung Quốc|nz
中间环节=mắt xích trung gian|nz
中饱=trung gian kiếm lời/đứng giữa kiếm lợi|nz
丰乳=phong nhũ/ngực đầy đặn|nz
丰油=phong phú|nz
丰田=Toyota|nz
丰碑=tấm bia to/bia đá to lớn/phong bi|nz
丰神=phong thần/thần đẹp|nz
丰藏=phong phú cất giấu|nz
临时代办=đại diện lâm thời|nz
临晨=lúc hừng sáng|nz
丹毒=đan độc/bệnh lên đơn/bệnh nổi ban|nz
丽语=Lệ Ngữ/từ ngữ đẹp|nz
久美=Cửu Mỹ|nz
义乌=Nghĩa Ô|nz
义信=nghĩa tín|nz
义大利=Italy/Ý|nz
义战=chiến tranh chính nghĩa|nz
义真=Nghĩa Chân|nz
义结金兰=kết nghĩa kim lan|nz
乌发=tóc đen|nz
乌鸦嘴=miệng quạ đen/mỏ quạ đen/miệng xui xẻo|nz
乖乖女=cô gái ngoan ngoãn/con gái ngoan ngoãn|nz
乘二=nhân hai|nz
乘兴=thừa hứng/nhân khi cao hứng/nhân lúc vui vẻ|nz
乘龙=cưỡi rồng|nz
九剑=chín kiếm/Cửu Kiếm|nz
九华=Cửu Hoa|nz
九变=cửu biến|nz
九命猫=Cửu Mệnh Miêu|nz
九宝=Cửu Bảo|nz
九战=chín trận chiến|nz
九族=cửu tộc|nz
九月份=tháng chín/đầu tháng chín|nz
九污泉=Cửu Ô tuyền|nz
九泉=cửu tuyền/âm ty/chín suối/thế giới bên kia|nz
九流三教=tam giáo cửu lưu/đủ loại hạng người/các trường phái ngành nghề|nz
九源=cửu nguyên|nz
九火真龙=Cửu Hỏa Chân Long|nz
九炼=cửu luyện|nz
九爪金龙=Cửu Trảo Kim Long|nz
九牛一毛=chín trâu mất sợi lông/nhỏ nhặt/không đáng kể/hạt cát trong sa mạc/cửu ngưu nhất mao/như muối bỏ bể|nz
九牛二虎=chín trâu hai hổ|nz
九珠=Cửu Châu|nz
九皇=cửu hoàng|nz
九色鹿=Cửu Sắc Lộc|nz
九芒星=cửu mang tinh/sao chín cánh|nz
九重天=Cửu Trùng Thiên|nz
九鼎=cửu đỉnh|nz
九龙=Cửu Long|nz
乳胶手套=găng tay cao su|nz
乾坤=càn khôn|nz
乾杯=cạn ly/cạn chén|nz
乾柴=can sài/củi khô|nz
乾脆=rõ ràng/dứt khoát|nz
二八年华=mười sáu tuổi/16 tuổi|nz
二十世纪=thế kỷ 20/thế kỷ hai mươi|nz
二十五史=nhị thập ngũ sử/hai mươi lăm bộ sử của Trung Quốc|nz
二十四史=nhị thập tứ sử/Chính sử/hai mươi bốn bộ sử của Trung Quốc|nz
二战=thế chiến thứ hai/nhị chiến [World War II]/nhị chiến World War II|nz
二战时期=đệ nhị thế chiến/chiến tranh thế giới thứ hai|nz
二手书=hai bức thư|nz
二手烟=khói thuốc của người khác/khói thuốc thụ động/Hút thuốc thụ động|nz
二手电脑=máy tính second-hand|nz
二教=hai giáo/nhị giáo|nz
二星=nhị tinh/hai sao/Nhị Tinh/Hai Sao|nz
二桃杀三士=mượn đao giết người/nhị đào giết tam sĩ|nz
二次方程=phương trình bậc hai|nz
二氧化氮=nitơ điôxít/nitơ dioxide/nito đioxit|nz
二氧化硅=si-líc/si-líc đi-ô-xít|nz
二氧化硫=lưu huỳnh đioxit|nz
二氧化碳=CO2/carbon dioxide/cacbon dioxit|nz
二等奖=giải nhì|nz
二龙戏珠=nhị long hí châu|nz
云容月貌=vân dung nguyệt mạo|nz
云山雾罩=nói nhăng nói cuội/ăn nói lan man/mây mù dày đặc/nói năng lung tung|nz
云梦=Vân Mộng|nz
云泰=Vân Thái|nz
云片糕=bánh quy xốp/bánh hạt đào|nz
五世同堂=ngũ đại đồng đường/ngũ thế đồng đường/năm thế hệ cùng nhà|nz
五仙教=Ngũ Tiên giáo|nz
五代十国=Ngũ Đại Thập Quốc|nz
五光族=Ngũ Quang tộc|nz
五加=cây ngũ gia bì|nz
五十铃=Isuzu|nz
五华=ngũ hoa|nz
五变=ngũ biến|nz
五四式=B54|nz
五四运动=phong trào Ngũ Tứ|nz
五彩=ngũ thải/năm màu/ngũ sắc/nhiều màu sắc|nz
五战=năm trận chiến|nz
五指峰=Ngũ Chỉ Phong|nz
五教=ngũ giáo|nz
五文=ngũ văn|nz
五星=ngũ tinh/năm sao/Ngũ Tinh/5 Sao|nz
五月份=vào tháng năm|nz
五毒=ngũ độc/Ngũ Độc|nz
五毒教=Ngũ Độc giáo|nz
五湖四海=ngũ hồ tứ hải/năm sông bốn biển/năm sông bốn biển|nz
五环=ngũ hoàn|nz
五皇=ngũ hoàng|nz
五短=ngũ đoản|nz
五福=Ngũ Phúc|nz
五芒星=ngũ mang tinh|nz
五虎=ngũ hổ|nz
五角星=ngôi sao năm cánh|nz
五谷丰登=Ngũ Cốc Phong Đăng|nz
五金店=Ngũ Kim điếm|nz
五霸=ngũ bá|nz
五香粉=bột ngũ vị hương|nz
五龙=ngũ long|nz
井喷=giếng phun|nz
亚洲杯=cúp Châu Á|nz
交泰=giao thái|nz
京兆=Kinh Triệu|nz
京兆尹=Kinh triệu doãn|nz
京华=Kinh Hoa|nz
京族=dân tộc Kinh|nz
京杭大运河=Kinh Hàng Đại Vận Hà/Grand Canal, 1800 km từ Bắc Kinh đến Hàng Châu, được xây dựng bắt đầu từ năm 486 trước Công nguyên|nz
京极真=Kyogoku Makoto|nz
京畿=kinh kỳ/kinh đô và vùng lân cận/kinh đô và vùng ngoại ô|nz
京韵大鼓=kịch Bắc Kinh|nz
人大代表=đại biểu nhân dân toàn quốc|nz
人民战争=chiến tranh nhân dân|nz
人瑞=nhân thuỵ/Nhân Thụy|nz
人间蒸发=bốc hơi khỏi nhân gian/biến mất khỏi thế gian|nz
人高马大=nhân cao mã đại|nz
亿万斯年=hàng triệu triệu năm|nz
仙二=Tiên nhị|nz
仙人指路=tiên nhân chỉ lộ/tiên nhân chỉ đường|nz
仙凰状=hình Tiên hoàng|nz
仙姿佚貌=tiên tư dật mạo|nz
仙山琼阁=tiên sơn quỳnh các/cảnh đẹp hư ảo|nz
仙真=tiên chân|nz
以命搏命=lấy mạng đổi mạng|nz
以太=aether/ether/dĩ thái|nz
以己度人=suy bụng ta ra bụng người/lấy mình đo người|nz
以德报德=dùng đức báo đức|nz
以战养战=lấy chiến dưỡng chiến/lấy chiến tranh nuôi chiến tranh/dĩ chiến dưỡng chiến/lấy chiến nuôi chiến|nz
伊兰特=Elantra|nz
伊利=Elie|nz
伊力=Y Lực|nz
伊始=bắt đầu/vừa mới/y thủy|nz
伊文=Ywen/Yvan/Ywenn|nz
伊斯兰教=đạo Hồi/đạo Islam|nz
伊斯法罕=Isfahan/Isfahan hoặc Eşfahān, tỉnh và thành phố ở miền trung Iran|nz
伊曼纽尔=Emmanuelle/Emmanuel/Emanuel|nz
伊林=Y Lâm|nz
伊萨克=Isaac|nz
伊萨贝尔=Isabell|nz
伊达=Ida|nz
伊霜=Y Sương|nz
伏罪=nhận tội/nhận lỗi|nz
休内=trong cơ thể|nz
休屠=Hưu Chư/tên hiệu vua nước Hung-nô|nz
休屠王=Hưu Chư Vương|nz
休息室=phòng nghỉ/chỗ nghỉ ngơi/phòng nghỉ ngơi|nz
众泰=Zotye|nz
伟大事业=sự nghiệp vĩ đại|nz
伟大胜利=thắng lợi vĩ đại|nz
传真电报=fax/điện báo ảnh/phô-tô tê-lê-gram|nz
伺服器=server|nz
低语=nói nhỏ/thầm thì/thì thầm/nói thầm|nz
佛光=Phật quang/ánh sáng Phật giáo/hào quang Đức Phật/hào quang/ánh hào quang|nz
佛光寺=Phật Quang tự/Phật Quang Tự|nz
佛力=phật lực|nz
佛南达=Fernando|nz
佛号=phật hiệu/a-di-đà phật|nz
佛土=phật thổ|nz
佛堂=phật đường/Điện thờ cúng tượng Phật.|nz
佛塔=Phật tháp/bảo tháp/phật tháp|nz
佛宗=Phật tông|nz
佛宝=phật bảo|nz
佛寺=phật tự/chùa chiền/chùa|nz
佛教=Phật giáo/phật giáo/vậy|nz
佛朗哥=Franco|nz
佛朗基=Franky|nz
佛根=phật căn|nz
佛桥=phật kiều|nz
佛殿=Phật điện|nz
佛法=Phật pháp/phật hiệu/giáo lý Phật giáo/phép Phật/phép thuật của Phật/phật pháp|nz
佛洛依德=Freud|nz
佛灯=phật đăng|nz
佛珠=phật châu/lần tràng hạt|nz
佛线=phật tuyến|nz
佛经=phật kinh|nz
佛萨=Fossa|nz
佛语=phật ngữ|nz
佛跳墙=phật nhảy tường/phật nhảy tường/Đức Phật nhảy tường/Tượng Phật nhảy qua tường, tên món ăn Trung Quốc sử dụng nhiều nguyên liệu không ăn chay|nz
佛轮=phật luân|nz
佛铃=phật linh|nz
佛阻杀佛=phật trở giết phật|nz
佛陀=Phật Đà/phật đà/Phật Thích Ca/Phật Thích Ca Mâu Ni/Phật đà|nz
佤族=Ngõa tộc|nz
佳人薄命=hồng nhan bạc mệnh|nz
佳佳=Giai Giai|nz
佳偶天成=trời sinh một đôi/con rối tốt thiên thành|nz
佳士得=giai sĩ đắc|nz
佳惠=Giai Huệ|nz
佳敏=Giai Mẫn|nz
佳玉=Giai Ngọc|nz
佳美=ngon/tốt/đẹp|nz
佳贞=giai trinh|nz
佳雯=Giai Văn|nz
侗族=dân tộc Động|nz
侧根=rễ con/rễ nhánh|nz
侵晨=hừng đông/tảng sáng/tờ mờ sáng/rạng sáng/xâm thần/sáng tan sương rồi|nz
俄国人=người Nga/người nước Nga|nz
俄式=Nga thức|nz
俄文=Nga văn|nz
俄罗斯族=dân tộc Nga/người Liên Xô/người Nga|nz
俄罗斯语=tiếng Nga|nz
俄耳甫斯=Orpheus|nz
俄语=tiếng Nga|nz
俊马=tuấn mã|nz
保卫科=bảo vệ khoa|nz
保安=bảo an/an ninh/bảo vệ trị an/bảo hộ/bảo hộ lao động/giữ an toàn lao động|nz
保温杯=cốc giữ nhiệt|nz
保真=bảo đảm thật|nz
保鲜膜=màng bọc thực phẩm/màng bảo quản/màng dính|nz
信教=tin giáo|nz
偏安=an phận/yên phận/thiên an|nz
偏颇=bất công/thiên vị/thiên lệch/không công bằng|nz
健健康康=kiện kiện khang khang/khoẻ mạnh|nz
健力宝=Kiện Lực Bảo|nz
傣族=dân tộc Thái/thái tộc|nz
傣禄=lộc vua|nz
儒勒=Jules|nz
儒教=nho giáo/đạo Nho/Nho giáo/để phân biệt với|nz
儒林外史=môn sinh/học giả|nz
儒雅=nho nhã|nz
元丰=Nguyên Phong|nz
元华=Nguyên Hoa|nz
元始=Nguyên Thủy/nguyên thủy|nz
元安=Nguyên An|nz
元通=Nguyên Thông|nz
充满希望=tràn ngập hi vọng|nz
光华=quang hoa/ánh sáng/vầng sáng/ánh quang/ánh sáng rực rỡ/ánh sáng chói chang|nz
光华四射=quang hoa bắn ra tứ phía|nz
光天化日=ban ngày ban mặt/rõ như ban ngày/giữa ban ngày ban mặt|nz
光狐=quang hồ|nz
克星=khắc tinh|nz
克浪=Krum|nz
克虏伯=Krupp|nz
免战牌=miễn chiến bài|nz
兔脱=chạy trốn|nz
党争=đảng tranh|nz
党同伐异=bè cánh đấu đá/bênh che bè cánh/đả kích người không ăn cánh|nz
党和国家=đảng cùng quốc gia|nz
全国运动会=đại hội thể dục thể thao toàn quốc/Đại hội Thể thao Quốc gia/Đại hội thể dục thể thao toàn quốc|nz
全日空=ANA/All Nippon Airways|nz
全盛=toàn thịnh/hưng thịnh/hưng vượng/khỏe hẳn|nz
全盛时期=thời kỳ toàn thịnh/toàn thịnh thời kỳ/thời điểm toàn thịnh|nz
全真教=Toàn Chân giáo|nz
全能运动=vận động toàn năng|nz
全运会=Toàn Vận Hội|nz
全面战争=chiến tranh toàn diện|nz
八仙过海=Bát Tiên quá hải|nz
八宝=Bát Bảo|nz
八战=tám trận chiến|nz
八月份=tháng tám|nz
八股文=Bát Cổ văn|nz
八阵图=bát trận đồ/mê cung/không biết đâu mà lần|nz
六四式=64 thức|nz
六月份=tháng sáu/tháng Sáu|nz
六芒星=Lục Mang Tinh/lục mang tinh|nz
兰花指=tay hoa|nz
共乘=cùng cưỡi|nz
共和=cộng hòa/cộng hoà/chế độ cộng hoà|nz
兴唐=Hưng Đường|nz
兴盛=hưng thịnh/thịnh vượng/thịnh vượng hơn lên|nz
其乐融融=vui vẻ hòa thuận|nz
兽中之王=Thú trung chi vương|nz
兽人一族=Thú nhân nhất tộc|nz
兽人族=Thú nhân tộc|nz
冈田=Cương Điền|nz
冈部=Okabe|nz
农民战争=chiến tranh nông dân|nz
农田水利=thuỷ lợi nông nghiệp|nz
冠希哥=Quán Hi ca|nz
冠英=Quan Anh|nz
冬虫夏草=đông trùng hạ thảo/trùng thảo|nz
冰山美人=băng sơn mỹ nhân|nz
冰拿铁=latte đá/latte băng|nz
冲浪=lướt sóng/trùng lãng|nz
冷语=lãnh ngữ/lạnh lùng/mỉa mai|nz
减速运动=chuyển động giảm tốc/chuyển động chậm dần|nz
凝华=ngưng tụ/sự ngưng tụ/từ thể khí chuyển thành thể rắn|nz
凝霜=ngưng sương/đông lại sương|nz
凤凰血=máu phượng hoàng|nz
凤凰衣=màng trắng/màng mỏng|nz
凯文=Kevin/Khải Văn|nz
凰牙=Hoàng Nha|nz
凹凸镜=Kính Lúp|nz
凹槽=lỗ khảm/vũng/rãnh|nz
凹透镜=thấu kính lõm|nz
凹镜=gương lõm/Gương lõm|nz
凹面镜=gương lõm|nz
出尔反尔=lật lọng/phủ nhận chính mình/mâu thuẫn/nói mà không làm/nói một đằng làm một nẻo/xuất nhĩ phản nhĩ|nz
刑侦处=phòng hình sự trinh sát|nz
刑侦队=đội hình sự|nz
刑讯=tra tấn/tra hỏi/hình tấn|nz
创世神=Sáng Thế Thần|nz
创世纪=Sáng Thế Kỷ/Genesis|nz
刨根=truy vấn/bào căn|nz
别教=giáo khác/đừng dạy|nz
刷卡器=đầu đọc thẻ/máy quẹt thẻ|nz
剑兰花=hoa lay-ơn|nz
剑婷=Kiếm Đình|nz
剑宗=kiếm tông|nz
剑斗罗=Kiếm Đấu La|nz
剑晨=Kiếm Thần|nz
剪草除根=nhổ cỏ nhổ tận gốc/trừ tận gốc|nz
力争=cố gắng/tranh thủ/tranh luận/tranh biện/đấu lý|nz
力保=ra sức bảo vệ|nz
力战=lực chiến/dốc sức chiến đấu/cố đánh|nz
力文=lực văn|nz
劝农=khuyến nông/thúc đẩy nông nghiệp|nz
加拿大人=người Canada|nz
加速运动=chuyển động gia tốc|nz
劳教=giáo dục lao động|nz
勃兰特=Brandt|nz
勃兴=phát triển rầm rộ/dấy lên mạnh mẽ/bừng bừng trỗi dậy|nz
勃勃=bừng bừng/hừng hực/tràn trề/dào dạt/đầy rẫy|nz
勃发=bừng bừng phấn chấn/rạng rỡ/dồi dào/tràn trề/bộc phát/bùng nổ/bừng lên/bừng bừng/phấn chấn|nz
勃艮第=Burgundy|nz
匈牙利语=tiếng Hungary|nz
北伐战争=chiến tranh Bắc phạt|nz
北大学生=sinh viên Bách Khoa|nz
北大清华=Bắc Đại Thanh Hoa|nz
北斗七星=Bắc Đẩu Thất Tinh|nz
北斗星=Bắc Đẩu tinh|nz
北斗神拳=Bắc Đẩu thần quyền|nz
北极狐=cáo Bắc cực/cáo trắng Bắc cực/cáo trắng|nz
十一月份=tháng mười một/tháng Mười Một|nz
十七世纪=thế kỷ mười bảy|nz
十万大山=Thập Vạn Đại Sơn|nz
十九世纪=thế kỷ mười chín|nz
十九人=mười chín người|nz
十二宫=mười hai cung/thập nhị cung|nz
十二楼=mười hai lầu|nz
十传百=mười truyền trăm|nz
十光=thập quang|nz
十全=thập toàn/vẹn toàn/trọn vẹn/hoàn hảo|nz
十全十美=thập toàn thập mỹ/mười phân vẹn mười|nz
十八世纪=thế kỷ mười tám|nz
十八罗汉=mười tám vị La Hán|nz
十六世纪=thế kỷ XVI|nz
十冬腊月=mùa đông giá lạnh/ngày đông tháng giá|nz
十分迅速=hết sức nhanh chóng|nz
十块钱=mười đồng tiền|nz
十字=Thập tự/thập tự/chữ thập/thập tự : chữ thập|nz
十字星=Thập Tự Tinh|nz
十字花科=họ cây mù tạc|nz
十月十日=ngày mười tháng mười/ngày 10 tháng 10|nz
十月革命=Cách mạng Tháng Mười|nz
十滴水=thuốc nước bạc hà|nz
升华=thăng hoa/bốc hơi/bay hơi|nz
升汞=thuỷ ngân clo-rua/thuỷ ngân clorua|nz
升班马=thăng ban mã|nz
升龙=thăng long|nz
华严经=Hoa Nghiêm kinh|nz
华丰=Hoa Phong|nz
华光=hào quang|nz
华发=tóc bạc/tóc hoa râm|nz
华商=Hoa Thương|nz
华天=Hoa Thiên|nz
华实业=Hoa thực nghiệp|nz
华山论剑=Hoa Sơn Luận Kiếm|nz
华工=công nhân người Hoa|nz
华彩=hoa thải/hoa hoè/màu mè|nz
华文=tiếng Hoa|nz
华族=Hoa tộc|nz
华星=Hoa Tinh|nz
华服=hoa phục/đồ bông|nz
华林=Hoa Lâm|nz
华润=hoa nhuận/Hoa Nhuận/China Resources|nz
华灯=đèn hoa/đèn rực rỡ|nz
华王=Hoa vương|nz
华盛顿邮报=Washington Post|nz
华真=Hoa Chân|nz
华福=Hoa Phúc|nz
华禹=Hoa Vũ|nz
华美=hoa mỹ/hoa lệ/lộng lẫy|nz
华语=Hoa ngữ|nz
华谊=Hoa Nghị|nz
华辰=Hoa Thần|nz
华通=Hoa Thông|nz
协和=dung hợp|nz
单手剑=kiếm một tay/thanh kiếm một tay|nz
南华=Nam Hoa|nz
南征北战=nam chinh bắc chiến|nz
南昌起义=khởi nghĩa Nam Xương|nz
南柯一梦=giấc mộng Nam Kha|nz
南艮=Nam Cấn|nz
博士论文=luận văn tiến sĩ/luận án tiến sĩ/Luận văn tiến sĩ|nz
卡丁车=Kart|nz
卡农=Canon|nz
卡号=số thẻ|nz
卡壳=tạm ngừng/kẹt/nghẹt/mắc kẹt|nz
卡座=ghế dài/tạp tọa|nz
卡扣=móc cài|nz
卡文=kẹt văn|nz
卡片=tấm thẻ/tạp phiến/tấm/miếng/phên/cạc/các/phích/thẻ/thẻ|nz
卡片机=máy ảnh|nz
卡通=phim hoạt hình/phim hoạt hoạ/tranh châm biếm|nz
卡钻=kẹt khoan|nz
卢沟桥事变=biến cố cầu Lư Câu|nz
卤莽=lỗ mãng/táo bạo/liều lĩnh/ngạo mạn|nz
印信=ấn tín/con dấu|nz
印发=in và phát hành/ấn phát|nz
印地安人=người da đỏ|nz
印地语=tiếng Hindi|nz
印度人=người Ấn Độ|nz
印度教=Ấn Độ giáo|nz
印第安人=người Anh-điêng/người da đỏ ở Bắc Mỹ|nz
卷宗=hồ sơ/tài liệu/tập tin/cặp hồ sơ/quyển tông|nz
卸妆乳=nước tẩy trang/Sữa tẩy trang|nz
卸妆油=dầu tẩy trang/Dầu tẩy trang|nz
卸妆液=nước tẩy trang/Nước tẩy trang|nz
压榨机=máy ép|nz
厚利=lời nhiều/lợi to/lãi to|nz
厚德=hậu đức|nz
厚礼=hậu lễ/lễ hậu/lễ trọng|nz
厚福=hậu phúc|nz
厚谊=tình nghĩa thắm thiết/tình sâu nghĩa nặng/tình bạn sâu xa|nz
厥阴=Quyết Âm|nz
双乳=hai vú|nz
双人床=giường đôi/giường hai người|nz
双打=đánh kép/đánh đôi|nz
双星=song tinh/sao đôi/sao cặp|nz
双语=song ngữ|nz
双钩=chữ viết nét|nz
双鱼座=chòm Song Ngư|nz
双龙=song long|nz
反光镜=gương chiếu hậu|nz
反坦克=chống tăng|nz
反语=nói trái ý mình/cố tình nói ngược/phép nói ngược/nói mát/phép nói ngược|nz
反革命=phản cách mạng/phần tử phản cách mạng/bọn phản cách mạng|nz
发动战争=phát động chiến tranh/bắt đầu chiến tranh|nz
取暖器=máy sưởi|nz
变浓=trở nên nồng|nz
变速运动=chuyển động biến tốc|nz
古凰族=Cổ Hoàng tộc|nz
古玩店=tiệm bán đồ cổ/tiệm đồ cổ/cửa hàng đồ cổ|nz
古语=cổ ngữ/từ cổ/từ ngữ cổ/câu nói cổ/lời nói của người xưa để lại|nz
古里古怪=kỳ quái/kỳ lạ/lập dị|nz
可兰经=kinh Coran|nz
可嘉=đáng khen/có thể khen/có thể tăng|nz
各擅胜场=mỗi người một vẻ|nz
吉尼斯世界纪录=kỷ lục thế giới Guinness|nz
吊兰=lan điếu|nz
吊民伐罪=điếu dân phạt tội/trừng trị kẻ ác, cứu dân lành/phạt kẻ có tội, an ủi nhân dân|nz
吊篮=rổ treo|nz
吊钩=móc treo|nz
同族=đồng tộc|nz
同根=đồng căn|nz
同轴电缆=cáp đồng trục|nz
吐喷=phun ra|nz
吐字=đọc nhấn rõ từng chữ/đọc rõ từng chữ/đọc từng chữ|nz
吐杯=phun chén|nz
吐真剂=thuốc nói thật|nz
君主立宪制=chế độ quân chủ lập hiến|nz
君依=Quân Y|nz
君元=Quân Nguyên|nz
君士坦丁=Constantine|nz
君士坦丁堡=Constantinople|nz
君子兰=quân tử lan/Quân Tử Lan/Clivia miniata|nz
君子协定=lời quân tử/lời hứa danh dự|nz
君宝=Quân Bảo|nz
君易梦=Quân Dịch Mộng|nz
君氏=Quân thị|nz
君王=quân vương|nz
君莎=Jun Sha|nz
君远=Quân Viễn|nz
启明星=sao kim|nz
启迪=gợi mở/dẫn dắt/chỉ bảo/khải địch|nz
吸铁石=sắt nam châm/đá nam châm|nz
呢大衣=áo khoác nỉ|nz
呼啦圈=vòng lắc eo/hula|nz
呼语=hô ngữ|nz
和事佬=hòa sự lão|nz
和人族=cùng nhân tộc|nz
和和气气=hòa hòa khí khí|nz
和和美美=mỹ mãn/hòa hòa mỹ mỹ|nz
和平=hòa bình/BÌNH/hoà bình/ôn hoà/lành/nhã nhặn/êm dịu/bình tĩnh/trấn tĩnh/yên tĩnh/bình thản/Hoà Bình/tỉnh Hoà Bình/Hòa Bình|nz
和平主义=chủ nghĩa hoà bình/chủ nghĩa hòa bình|nz
和平主义者=người theo chủ nghĩa hòa bình/Pacifista|nz
和平共处=chung sống hoà bình/sống hoà bình/tồn tại hoà bình/sống chung hòa bình|nz
和平利用=dùng một cách hòa bình|nz
和平时期=thời kỳ hòa bình|nz
和平演变=diễn biến hoà bình/sự tiến hóa hòa bình|nz
和平鸽=chim hoà bình|nz
和文=cùng văn/chữ Nhật/tiếng Nhật|nz
和易王=và Dịch vương|nz
和服=kimono/kimônô/ki-mô-nô/áo ki-mô-nô/trang phục kiểu Nhật/trang phục truyền thống của Nhật Bản|nz
和炼=hòa luyện|nz
和田=Hòa Điền|nz
和议=đàm phán hoà bình|nz
和谈=hoà đàm/đàm phán hoà bình/hòa đàm|nz
和顺=hoà thuận/hiền hoà/hiền lành/dịu dàng/hoà nhã/nhẹ nhàng|nz
和风丽日=trời quang mây tạnh/và những ngày đẹp trời|nz
咳喘=ho suyễn|nz
哈尼族=dân tộc Ha-ni/Cáp Ni tộc|nz
哈次=Cáp Thứ|nz
哈气=hà hơi/hơi hà ra/hơi nước/hơi đọng|nz
哈萨克族=dân tộc Ka-giắc-stan|nz
哥德巴赫猜想=giả thuyết Goldbach/giả thuyết Goldbach trong lý thuyết số|nz
哥特式=Gothic|nz
唇彩=môi son|nz
唇膏=son môi/sáp môi|nz
唇角=khóe môi/thần giác|nz
唇语=môi ngữ|nz
唐月芙=Đường Nguyệt Phù|nz
喀斯特地貌=địa mạo karst/địa hình karst/dạng địa hình karst|nz
喀秋莎=Ca-chiu-sa/Khách Thu Toa|nz
喜讯=tin vui/tin mừng|nz
喷泉=suối phun|nz
喷火龙=rồng phun lửa|nz
喷雾剂=thuốc phun sương|nz
喷雾器=bình phun thuốc/bình xịt thuốc|nz
嘉华=Gia Hoa|nz
嘉奖=ngợi khen/lời khen/phần thưởng/khen thưởng/tán thưởng|nz
嘉年华=Carnival|nz
嘉雯=Gia Văn|nz
嘎山=dát sơn|nz
四世同堂=tứ đại đồng đường/bốn đời đồng đường/Bốn Thế Hệ Dưới Một Mái Nhà, tiểu thuyết của Lão Cô 老舍 [Lao3 She3]|nz
四书五经=tứ thư ngũ kinh|nz
四变=tứ biến|nz
四大家族=tứ đại gia tộc|nz
四星=tứ tinh/bốn sao/Tứ Tinh/Bốn Sao ★|nz
四海之内=trong bốn biển|nz
四蚀=tứ thực|nz
回二=Hồi thứ 2|nz
回人族=trở về Nhân tộc|nz
回元丹=Hồi Nguyên Đan|nz
回城卷=quyển trục về thành/Phù về thành/{Phù về thành}|nz
回天乏力=không đủ sức xoay chuyển cả đất trời|nz
回教=hồi giáo|nz
回文=hồi văn/văn tự ngôn ngữ của người Hồi/thơ văn thuận nghịch đọc|nz
回族=hồi tộc/dân tộc Hồi|nz
回朔=hồi sóc|nz
回纥=Hồi Hột|nz
回蓝=hồi lam/hồi mana|nz
回马枪=hồi mã thương|nz
国华=Quốc Hoa/quốc hoa|nz
国古=quốc cổ|nz
国基=quốc cơ|nz
国安=quốc an|nz
国宝=quốc bảo/bảo vật quốc gia/vật báu/báu vật|nz
国家机器=cơ quan quốc gia|nz
国家杜马=Duma Quốc gia|nz
国教=quốc giáo|nz
国文=quốc văn/quốc ngữ/bài ngữ văn|nz
国无二君=nước không có hai vua/nước không hai vua|nz
国正=quốc chính|nz
国泰民安=quốc thái dân an|nz
国瑞=quốc thụy|nz
国界线=đường biên giới|nz
国联=liên minh quốc tế/hội quốc liên|nz
国语=quốc ngữ/ngữ văn/bài học ngữ văn|nz
国际共管=công quản quốc tế|nz
国际日期变更线=đường phân chia ngày quốc tế|nz
国际米兰=Inter Milan/FC Internazionale Milano|nz
国际航班=chuyến bay quốc tế|nz
土地革命战争=chiến tranh cách mạng ruộng đất|nz
土家族=dân tộc Thổ Gia|nz
土族=Thổ tộc|nz
土语=thổ ngữ/phương ngôn/tiếng địa phương|nz
土鸡瓦狗=gà đất chó sành|nz
圣僧=thánh tăng|nz
圣战=Thánh chiến/thánh chiến|nz
圣战士=thánh chiến sĩ/Thánh chiến sĩ|nz
圣教=Thánh giáo/thánh giáo|nz
圣杯=chén thánh/thánh bôi|nz
圣泉=thánh tuyền|nz
圣马力诺=St. Marino|nz
圣龙一族=Thánh long nhất tộc|nz
地主之谊=chủ nhà tình nghĩa/người chủ địa phương|nz
地利人和=địa lợi nhân hòa/địa lợi nhân hoà|nz
地大物博=đất rộng của nhiều/đất nước bao la/của cải dồi dào/rừng vàng biển bạc/đất nước bao la, của cải dồi dào/đất rộng vật nhiều|nz
地广=đất rộng|nz
地广人稀=hoang vắng/vắng vẻ|nz
地广人稠=đất rộng người đông|nz
地精一族=Địa tinh nhất tộc|nz
地网天罗=địa võng thiên la|nz
地面战=trận chiến dưới mặt đất/trận địa chiến|nz
块根=rễ củ|nz
埃菲尔铁塔=tháp Eiffel|nz
培根=bồi căn/Bồi Căn/thịt lưng lợn muối xông khói/|nz
培训基地=căn cứ huấn luyện|nz
基佬=gay|nz
基尔=Kiel|nz
基尼系数=hệ số Gini/Hệ số Gini|nz
基弗=Kiefer|nz
基斯=Chris|nz
基督山=Cristo|nz
基督教=Cơ đốc giáo/cơ đốc giáo/đạo cơ đốc|nz
基诺=Keno|nz
基隆=Cơ Long|nz
堕云雾中=mơ hồ/không biết làm gì|nz
塔吉克族=Tháp Cát Khắc tộc|nz
塔罗牌=bài Tarot|nz
塔轮=ròng rọc hình nón/ròng rọc hình tháp|nz
塞尔维亚语=tiếng Serbia|nz
塞爆=tắc bạo|nz
填鸭=nhồi cho vịt ăn/vịt nhồi|nz
士别三日=sĩ biệt tam nhật/chia tay ba ngày/ba ngày không gặp kẻ sĩ|nz
壮丁=tráng đinh/trai tráng/thanh niên khoẻ mạnh|nz
壮丹=Tráng Đan|nz
壮大力量=tăng cường lực lượng|nz
壮志凌云=tráng chí lăng vân/chí khí ngút trời|nz
壮族=dân tộc Choang|nz
壮武=tráng vũ|nz
壮美=tráng lệ/hoa lệ/lộng lẫy|nz
壮语=tráng ngữ/ngôn ngữ Choang/tiếng Choang/lời lẽ hào hùng|nz
壮阳=tráng dương|nz
壮阳药=thuốc tráng dương|nz
声震寰宇=danh chấn hoàn vũ|nz
壶里乾坤=cuộc sống thần tiên|nz
复元=phục nguyên/bình phục như cũ|nz
复印纸=giấy photo|nz
复古风=phục nếp xưa/phong cách retro|nz
复合弓=phục hợp cung ghép/{phục hợp cung ghép}|nz
复旦=Phục Sáng|nz
夏族=Hạ Tộc|nz
外国语=tiếng nước ngoài/ngoại ngữ|nz
外来语=từ ngoại lai/từ vay mượn/từ có nguồn gốc tiếng nước ngoài|nz
外科医生=bác sĩ ngoại khoa|nz
多多指教=chỉ giáo nhiều hơn|nz
多巴胺=dopamine|nz
多棱镜=lăng kính/lăng trụ|nz
多礼=đa lễ|nz
多神教=đa thần giáo/thuyết nhiều thần|nz
多米诺骨牌=quân bài domino|nz
多语=nhiều lời|nz
大中华=Đại Trung Hoa|nz
大主教=đại chủ giáo/tổng giám mục/đại giáo chủ|nz
大乐透=đại nhạc thấu|nz
大乘=Đại Thừa|nz
大书特书=ghi lại việc quan trọng|nz
大仁大义=đại nhân đại nghĩa|nz
大众化=đại chúng hoá/quần chúng hoá|nz
大佛寺=đại phật tự|nz
大佬=đại lão|nz
大内=đại nội/hoàng cung|nz
大力发展=phát triển mạnh|nz
大力神杯=Cúp vàng vô địch/Cúp FIFA World Cup|nz
大千世界=đại thiên thế giới|nz
大华=đại hoa|nz
大厨=đầu bếp/đại trù/bếp trưởng|nz
大友克洋=Otomo Katsuhiro|nz
大发=đại phát/quá/quá độ/quá trớn/quá đáng|nz
大古族=đại cổ tộc|nz
大司农=Đại Tư Nông|nz
大吉大利=đại cát đại lợi|nz
大唐=Đại Đường|nz
大器晚成=có tài nhưng thành đạt muộn/đại tài trưởng thành trễ/có đại tài nên trưởng thành muộn|nz
大噪=lan truyền lớn/đại táo|nz
大大方方=thoải mái|nz
大奖=thưởng lớn/giải thưởng lớn/đại tưởng|nz
大姆指=ngón tay cái|nz
大安=bình phục/hồi phục/đại an|nz
大宛=Ðại uyên/tên một nước ở Tây-vực đời nhà Hán|nz
大宝=đại bảo/ngôi hoàng đế/bảo bối/vật báu/Phật pháp/khối vàng|nz
大家族=đại gia tộc/đại gia đình/gia tộc lớn|nz
大富=đại phú|nz
大屠杀=đại đồ sát|nz
大山深处=sâu trong núi lớn|nz
大山猫=mèo rừng lớn|nz
大峡谷=đại hạp cốc/hẻm núi lớn|nz
大巡狩=Đại tuần thú|nz
大开大合=đại khai đại hợp/thẳng thắn thoải mái|nz
大开杀界=đại khai sát giới|nz
大情圣=đại tình thánh|nz
大战=đại chiến/giải thi đấu/cuộc chiến lớn/cuộc chiến ác liệt/cuộc chiến quy mô lớn|nz
大手印=đại thủ ấn|nz
大捷=đại thắng/thắng lớn/thắng to/đại tiệp|nz
大放送=đại phóng túng|nz
大族=đại tộc/họ lớn/đại gia đình|nz
大明=Đại Minh|nz
大次元=đại thứ nguyên|nz
大步流星=sải bước/xoải bước|nz
大水牛=trâu nước lớn|nz
大水缸=chum đựng nước|nz
大汉民族=Đại Hán dân tộc|nz
大波浪=đại ba lãng/sóng lớn|nz
大浪=sóng lớn/sóng cồn/biển/sóng to|nz
大浪淘沙=sóng lớn đãi cát/đại lãng đào sa|nz
大海战=hải chiến lớn|nz
大润发=RT-Mart/RT Mart|nz
大片大片=từng mảng lớn|nz
大理寺=Đại Lý Tự|nz
大田=cánh đồng/đồng ruộng/ruộng đồng/ruộng nương|nz
大白鲨=cá mập trắng khổng lồ/cá mập trắng lớn|nz
大礼=đại lễ|nz
大禹=Đại Vũ/đại vũ|nz
大网=lưới lớn/võng lớn|nz
大罗=Đại La/đại la|nz
大肉棒=đại nhục bổng|nz
大英=Đại Anh|nz
大藏经=Đại Tạng Kinh|nz
大虎=đại hổ/con hổ lớn|nz
大跃进=kế hoạch đại nhảy vọt|nz
大运河=Đại Vận Hà|nz
大通=đại thông|nz
大都会=phần lớn đều/đại đô thị/đại đô hội|nz
大金虎=hổ vàng lớn|nz
大铁剑=đại thiết kiếm|nz
大革命=đại cách mạng/cuộc cách mạng lớn/cuộc nội chiến lần thứ nhất ở Trung Quốc|nz
大音希声=đại âm hi thanh|nz
大风大浪=sóng to gió lớn/gió to sóng lớn|nz
大饱=đại bão|nz
大饱口福=có lộc ăn no căng/no bụng/No nê thoả thích|nz
大饱眼福=mở rộng tầm mắt/nhìn no mắt/mở mang tầm mắt|nz
大马士革=Damascus/Đa-mát|nz
大马路=đại lộ/đường lớn|nz
大鱼缸=bể cá lớn|nz
大鼎=đại đỉnh|nz
大龙=đại long|nz
天主教=Thiên Chúa giáo/Thiên Chúa Giáo|nz
天份=thiên phú|nz
天兆=thiên triệu|nz
天农=Thiên Nông|nz
天净沙=Thiên Tịnh Sa|nz
天凤族=Thiên Phượng tộc|nz
天华=thiên hoa/Thiên Hoa|nz
天南星=thiên nam tinh|nz
天卫=Thiên Vệ|nz
天命=thiên mệnh/số trời/mệnh trời|nz
天和=thiên hòa|nz
天基=thiên cơ|nz
天塔=Thiên tháp|nz
天大=thiên đại|nz
天妇罗=tempura/Thiên Phụ La/còn được gọi là 甜不辣 [tian2 bu4 la4]|nz
天字=chữ thiên/chữ thiên (天)|nz
天字第一号=cao nhất/lớn nhất/mạnh nhất/số một|nz
天宏=Thiên Hoành|nz
天宗=Thiên Tông/thiên tông|nz
天宝=Thiên Bảo|nz
天富=Thiên Phú|nz
天尘丹=Thiên Trần Đan|nz
天届=Thiên giới|nz
天平座=chòm Thiên Bình|nz
天平秤=Thiên Bình Xứng|nz
天弓=Thiên Cung|nz
天恒城主=Thiên Hằng thành chủ|nz
天文=thiên văn|nz
天方教=Thiên Phương giáo|nz
天无二日=bầu trời không có hai mặt trời|nz
天时地利=thiên thời địa lợi|nz
天时地利人和=thiên thời địa lợi nhân hoà|nz
天明=bình minh/trời hửng sáng/trời sáng|nz
天星=Thiên Tinh/thiên tinh/sao trời/sao trên trời|nz
天杀星=thiên sát tinh|nz
天泉=thiên tuyền/Thiên Tuyền|nz
天涯海角=chân trời góc biển/chân mây cuối trời|nz
天牛=thiên ngưu/xén tóc/|nz
天狮=thiên sư/Thiên Sư|nz
天玑=Thiên Cơ|nz
天珠=Thiên Châu|nz
天理教=Thiên Lý giáo|nz
天生丽质=thiên sinh lệ chất/thiên sinh lệ chất/trời sinh quyến rũ|nz
天电=tĩnh điện trong khí quyển/thiên điện|nz
天皇=Thiên Hoàng/thiên tử/vua/Thiên hoàng|nz
天真=ngây thơ/khờ khạo/hồn nhiên/ngây ngô|nz
天秤=cán cân nghiêng|nz
天纵=ngút trời|nz
天线宝宝=Teletubbies|nz
天经地义=thiên kinh địa nghĩa/lẽ bất di bất dịch/lý lẽ chính đáng/đạo lý hiển nhiên, hai năm rõ mười|nz
天经地仪=thiên kinh địa nghĩa|nz
天网=Thiên Võng/Skynet|nz
天罗地网=thiên la địa võng|nz
天翻=trời lật|nz
天翼族=Thiên Dực Tộc|nz
天虎=thiên hổ|nz
天虹=Thiên Hồng|nz
天衍大阵=Thiên Diễn Đại Trận|nz
天衣教=Thiên Y giáo|nz
天语=Thiên Ngữ|nz
天镜=thiên kính|nz
天际线=đường chân trời|nz
天霸=Thiên Bá|nz
天顺=Thiên Thuận|nz
天驱=thiên khu|nz
天魂融血丹=Thiên Hồn Dung Huyết Đan|nz
天鸦界=Thiên Nha giới|nz
天鹅=thiên nga/ngỗng trời|nz
天鹅座=chòm Thiên Nga|nz
天鹅绒=lông nhung thiên nga/nhung thiên nga/nhung|nz
天鹰=Thiên Ưng/thiên ưng|nz
天鹰座=chòm Thiên Ưng|nz
天鼎=Thiên Đỉnh|nz
天龙=thiên long/Thiên Long/Thiên long|nz
天龙八部=Thiên Long Bát Bộ|nz
天龙座=chòm sao Thiên Long/Thiên Long Tọa/Draco|nz
太一教=Thái Nhất giáo|nz
太一神精丹=Thái Nhất Thần Tinh đan|nz
太和=thái hòa/Thái Hòa/quá hợp|nz
太大号=cỡ quá lớn|nz
太始=thái thủy|nz
太强大=quá cường đại/quá mạnh mẽ/quá mạnh mẽ|nz
太晚=quá muộn|nz
太盛=quá thịnh/thái thịnh|nz
太紧=quá gấp/thật chặt/thật chặt|nz
太阳历=Thái Dương lịch/Dương lịch|nz
太阳地儿=chỗ có ánh nắng chiếu/chỗ có ánh sáng mặt trời|nz
太阳电池=pin mặt trời|nz
太阳镜=kính mát/kính râm|nz
头奖=giải nhất|nz
奇佳=kỳ giai/kì diệu|nz
奇克=Cheek|nz
奇大无匹=vô cùng lớn|nz
奇奥=kỳ ảo|nz
奇斯=Keith|nz
奇特=kì lạ/lạ lùng/đặc biệt|nz
奇瑞=Chery|nz
奇虎=Kỳ Hổ|nz
奇鲁=Kỳ Lỗ|nz
奋争=tranh đấu|nz
奥兰治=Orange|nz
奥创=Ultron|nz
奥利=Olli|nz
奥姆真理教=Aum Chân Lý Giáo|nz
奥数=toán IMO/số áo/Olympic Toán học Quốc tế|nz
奥斯达=Áo Tư Đạt/Aosta|nz
奥林匹亚=Olympia/Olimpia|nz
奥林匹克=Olympic|nz
奥林匹克运动会=thế vận hội Olimpic|nz
奥林匹斯=Olympus|nz
奥美=đẹp và sâu sắc/Ogi|nz
奥达=Oda|nz
奥迪=Audi|nz
奥迪车=xe Audi|nz
女主内=nữ chủ nội|nz
女主播=nữ MC|nz
女体盛=Nữ Thể Thịnh|nz
女厨=nữ đầu bếp|nz
女学霸=nữ học bá|nz
女家教=nữ gia giáo|nz
女战士=nữ chiến sĩ/nữ quân nhân|nz
女杀星=Nữ Sát Tinh|nz
女浴室=phòng tắm nữ|nz
女真=Nữ Chân/dân tộc Nữ Chân|nz
女真族=Nữ Chân tộc|nz
妖丹内=yêu đan bên trong/trong yêu đan|nz
妖狐=yêu hồ|nz
威仪=uy nghi|nz
威信=uy tín|nz
威盛=Uy Thịnh|nz
威迪=Widy|nz
婆罗门教=Bà La Môn giáo|nz
孕妇装=quần áo bà bầu|nz
孕穗=làm đòng/có đòng/ngậm đòng/ngậm sữa|nz
孕龙=dựng long|nz
孝顺=hiếu thuận/có hiếu/hiếu thảo|nz
孟浪=càn rỡ/lỗ mãng/thô lỗ|nz
孵化器=máy ấp trứng|nz
孽海=Nghiệt Hải|nz
孽龙=Nghiệt Long|nz
宇内=vũ nội|nz
宇文=Vũ Văn|nz
安乐椅=ghế bành/trường kỷ/đi-văng|nz
安份=an phận|nz
安全套=áo mưa/áo mưa BCS/áo mưa an toàn/áo mưa (BCS)|nz
安全帽=nón bảo hộ/mũ sắt/mũ an toàn/nón an toàn|nz
安全电压=điện áp an toàn|nz
安全系数=hệ số an toàn|nz
安全阀=van an toàn|nz
安安全全=an an toàn toàn|nz
安安生生=yên ổn/yên ổn sinh sống|nz
安家乐业=an gia lạc nghiệp|nz
安居乐业=an cư lạc nghiệp|nz
安族=bộ lạc|nz
安泰=an khang/bình an khoẻ mạnh|nz
安熙=An Hi|nz
完美主义=chủ nghĩa hoàn mỹ/chủ nghĩa hoàn hảo|nz
宏博=khoáng đạt/rộng rãi/rộng lớn|nz
宏图大志=hoành đồ đại chí|nz
宏富=phong phú|nz
宏彬=Hồng Bân|nz
宏达=thông minh/thông hiểu/tinh thông|nz
官渡之战=trận Quan Độ|nz
定乾坤=định càn khôn|nz
宝卷=bảo quyển|nz
宝库=bảo khố/kho báu/kho tàng/nơi cất giấu những vật quý|nz
宝座=bảo tọa/ngai vàng/bảo toạ/ghế|nz
宝瓶座=chòm Bảo Bình|nz
宝盏=bảo trản|nz
宝芝林=Bảo Chi/Bảo Chi Lâm|nz
宝贝儿子=nhi tử bảo bối/con trai bảo bối|nz
宝轮=bảo luân|nz
宝镜=bảo kính|nz
家乐福=Carrefour|nz
家俱=gia câu|nz
家大业大=gia đại nghiệp đại|nz
家康=Ieyasu/Tokugawa|nz
家教=gia giáo/dạy kèm/dạy kèm tại nhà|nz
家族=gia tộc/dòng họ|nz
密语=mật ngữ|nz
富兰克林=Francklin|nz
富农=phú nông|nz
富国强兵=nước giàu binh mạnh|nz
富安=Phú Yên/tỉnh Phú Yên|nz
富甲一方=phú giáp một phương|nz
对乙酰氨基酚=Paracetamol/acetaminophen|nz
小手指=ngón tay nhỏ/ngón tay út|nz
小狐=Tiểu Hồ|nz
小鞋穿=tiểu hài xuyên|nz
少华=Thiếu Hoa|nz
尼龙袜=tất ni lông/vớ nylon/Tất ni lông|nz
屏保=screensaver|nz
山洪爆发=lũ quét cuốn tới|nz
川味=xuyên vị|nz
巡教=Tuần Giáo|nz
工业革命=cách mạng công nghiệp/cách mạng kỹ nghệ|nz
巨乳=cự nhũ|nz
巨变=biến đổi lớn/thay đổi lớn|nz
巨斧=cự phủ/búa lớn|nz
巨浪=sóng lớn|nz
巨蟹座=chòm Cự Giải/chòm sao cự giải|nz
布教=bố giáo|nz
布朗运动=chuyển động Brown|nz
布衣蔬食=cuộc sống giản dị/vải và các món ăn|nz
希伯来人=người Hebrew|nz
希伯来语=tiếng Do Thái|nz
希区柯克=Hitchcock|nz
希奇古怪=hi kỳ cổ quái|nz
希腊人=người Hy Lạp|nz
希腊字母=chữ cái Hy Lạp|nz
希腊语=tiếng Hi Lạp|nz
帕金森症=hội chứng Parkinson|nz
干燥剂=chất hút ẩm/sấy/làm khô/hút ẩm/chất làm khô|nz
平一指=Bình Nhất Chỉ|nz
幻狐=Huyễn Hồ|nz
广元=Quảng Nguyên|nz
广告语=lời quảng cáo|nz
广州起义=khởi nghĩa Quảng Châu|nz
广电=radio|nz
广绣=hàng thêu Quảng Đông/đồ thêu Quảng Đông|nz
广角镜=thấu kính wide/ống kính wide/chìa khoá|nz
庆历=Khánh Lịch|nz
庆大霉素=gen-ta-mi-xin|nz
庆宝=Khánh Bảo|nz
庆泉=Khánh Tuyền|nz
庆辉=Khánh Huy|nz
庐山真面=lư sơn chân diện/hiện lên rõ ràng như núi Lư Sơn/bộ mặt thật|nz
应届生=học sinh khóa này/sinh viên năm nhất|nz
庚子=canh tử|nz
庚精=Canh Tinh|nz
庚辰=canh thần/canh thình anh/năm thứ mười bảy G5 của chu kỳ 60 năm, ví dụ: 2000 hoặc 2060|nz
座丹炉=lò luyện đan|nz
康泰=an khang/khoẻ mạnh bình an/bình an/khoẻ mạnh|nz
延命元=kéo dài sức sống|nz
建元=Kiến Nguyên|nz
建华=Kiến Hoa|nz
建宁=Kiến Ninh|nz
建安=Kiến An|nz
建康=Kiến Khang/tên cũ của Nam Kinh 南京, đặc biệt. trong các triều đại phương Nam|nz
建教=kiến giáo|nz
建文=Kiến Văn|nz
开元=Khai Nguyên|nz
开天窗=bệnh loét mũi/cột báo bị bỏ trống/phần đục bỏ do kiểm duyệt/chuyên mục báo bị bỏ trống|nz
开奖=mở thưởng/mở giải thưởng|nz
开学典礼=lễ khai giảng/buỗi lễ tựu trường|nz
开宗=khai tông|nz
开尔文=Kelvin|nz
开库=mở ngân quỷ|nz
开弓=khai cung/mở cung/mở cung đi|nz
开普勒=Kepler|nz
开瓶器=dụng cụ mở chai|nz
开罗=Cairo|nz
开药方=hốt thuốc|nz
开镜=bấm máy/bắt đầu quay|nz
异教=dị giáo|nz
异次元=dị thứ nguyên|nz
弥勒=Di Lặc|nz
弥天=đầy trời/di thiên|nz
弥天大罪=tội lớn ngập trời|nz
弥赛亚=Messiah|nz
弥陀=Di Đà|nz
彝人=người Di|nz
彝族=Di tộc/dân tộc Di/di tộc|nz
彩旦=hề nữ/hề con gái/đào hề|nz
彩虹=cầu vồng/thải hồng/cầu vồng rực rỡ/mống|nz
循环论证=luận chứng tuần hoàn|nz
德乙=Bảng B nước Đức|nz
德文=tiếng Đức|nz
德语=tiếng Đức|nz
心脏起搏器=máy tạo nhịp tim|nz
必杀技=tất sát kỹ/tất sát kỹ (*)|nz
快信=thư phát chuyển nhanh/EMS|nz
快步流星=nhanh như chớp/nhanh như gió/nhanh như bay/nhanh như sao xẹt/đi nhanh như bay|nz
快讯=tin nhanh|nz
快语=khoái ngữ|nz
怒族=Nộ tộc|nz
思教=Tư Hân'|nz
怡神=di thần|nz
恆山派=phái Hằng Sơn|nz
恐爪龙=Khủng Trảo Long|nz
恐高症=chứng sợ độ cao/bệnh sợ độ cao|nz
恐龙=khủng long|nz
恒宇炉=Hằng Vũ Lô|nz
恒宇经=Hằng Vũ kinh|nz
恒定=cố định/bất biến/không thay đổi/không đổi/hằng định|nz
恒星=hằng tinh/định tinh/Hằng Tinh|nz
恒沙=hằng sa|nz
恒河=sông Hằng/hằng hà|nz
恒温=nhiệt độ ổn định/nhiệt độ không thay đổi/hằng ôn|nz
恒湿=độ ẩm ổn định/độ ẩm không đổi|nz
恒生=Hang Sinh|nz
恒远=hằng viễn/Hằng Viễn|nz
恢宏博大=mênh mông rộng rãi|nz
悦儿=Duyệt Nhi|nz
悦宾楼=Duyệt Tân lâu|nz
悦来=Duyệt Lai|nz
意大利杯=Coppa Italia|nz
意大利语=tiếng ý|nz
慢条斯理=chậm rãi/thong thả ung dung/mạn điều tư lý/ung dung thong thả|nz
慢班=lớp học chậm/dòng chảy chậm|nz
戈族=qua tộc|nz
戊申=Mậu Thân/mậu thân|nz
战战战=chiến chiến chiến|nz
戴绿帽=đội nón xanh/bị vợ ngoại tình/vợ ngoại tình/bị cắm sừng|nz
戴罪=mang tội|nz
戴角=cắm sừng|nz
所谓何来=làm sao đến đây/vì sao lại tới|nz
打卡机=máy quét thẻ/máy đánh thẻ/máy chấm công|nz
打哈哈=pha trò/nói đùa/đùa/đùa cợt/cười ha hả|nz
打江山=tranh đấu giành thiên hạ/đấu tranh giành thiên hạ|nz
打耳光=bạt tai/tát vào mặt/vả vào mặt|nz
托特纳姆热刺=Tottenham Hotspur|nz
扬声器=loa/loa phát thanh/máy biến điện năng thành âm thanh/dương thanh khí|nz
扬帆=giương buồm/dương phàm|nz
扬水站=trạm bơm|nz
扬花=phấn hoa phát tán/dương hoa|nz
抓丁=bắt phu/bắt lính|nz
投畀豺虎=vứt vào miệng cọp/ném cho hổ sói|nz
抗义=sự không đồng ý|nz
抗争=chống lại/đối chọi lại/kháng cự/chống đối/phản đối/kháng tranh|nz
抗力=kháng lực|nz
抗压=kháng áp/chịu áp lực|nz
抗命=kháng mệnh/chống lệnh/kháng lệnh/chống cự lại mệnh lệnh|nz
抗战=kháng chiến/kháng Nhật|nz
抗战时期=thời kỳ kháng chiến|nz
抗日=kháng Nhật|nz
抗日战争=chiến tranh kháng Nhật|nz
抗毒=kháng độc|nz
抗毒素=kháng độc tố/kháng độc/chất kháng độc|nz
抗水=water resistance|nz
抗法=kháng pháp|nz
抗生=kháng sinh|nz
抗生素=chất kháng sinh/thuốc kháng sinh/kháng sinh tố/kháng sinh tố|nz
抗药性=tính kháng thuốc/sức đề kháng/kháng thuốc|nz
抗菌素=kháng khuẩn tố/kháng sinh|nz
抗衡=chống lại/đối kháng/chống đối/chống chọi|nz
抗议=kháng nghị|nz
折叠床=giường xếp|nz
抢宝=đoạt bảo|nz
抢手货=hàng bán chạy/hàng hot|nz
抢救室=phòng cấp cứu|nz
护佑=bảo hộ/phù hộ/bảo vệ/giữ gìn|nz
护卫=hộ vệ/bảo hộ/bảo vệ/giữ gìn/gìn giữ/người bảo vệ/nhân viên bảo vệ|nz
护国寺=Hộ Quốc tự|nz
护城河=sông hộ thành/sông đào bảo vệ thành/thành hào/hào|nz
护士服=đồng phục y tá|nz
护山大阵=hộ sơn đại trận|nz
护手霜=kem bôi tay/kem tay/Sữa dưỡng da tay|nz
护教=hộ giáo|nz
护林=rừng phòng hộ/rừng bảo vệ|nz
护符=bùa hộ mệnh/bùa hộ thân|nz
护美=hộ mỹ|nz
护脉丹=Hộ Mạch đan|nz
护舒宝=hộ thư bảo|nz
护航舰队=hạm đội hộ tống|nz
抽丁=bắt lính/bọn đầu gấu/bọn bắt lính/cưỡng bức/bóc lột|nz
抽奖=rút thưởng/nhận thưởng|nz
抽根烟=hút điếu thuốc|nz
拉丁文=tiếng Latin|nz
拉丁语=tiếng Latinh/lạp đinh ngữ|nz
拉丁语系=hệ ngôn ngữ Latin/tiếng Latinh|nz
拉力=sức kéo/lực hút/sức dãn/sức căng|nz
拉套=kéo xe/giúp/giúp đỡ/cứu giúp|nz
拉床=máy cắt/máy thái rau|nz
拉弓=kéo cung/giương cung|nz
拉拉队=đội cổ động viên/nhóm cổ vũ/lạp lạp đội|nz
拉架=can ngăn/can/cản/tách/rẽ/ngăn|nz
拉洋片=phim đèn chiếu|nz
拉纤=kéo thuyền/làm mối/mai mối/mối mai/dẫn mối|nz
拉线=mai mối/làm mối/giới thiệu/mối mai|nz
拉绳=dây kéo|nz
拉网=kéo lưới|nz
拉辇=kéo xe|nz
拖把=đồ lau nhà/lau/chùi/cây lau nhà|nz
拖拉=kéo dài/lần lựa/dây dưa/lề mề/lôi thôi|nz
拖网=lưới kéo|nz
拜天地=bái thiên địa/lạy trời đất|nz
拜月教=Bái Nguyệt giáo|nz
拜火教=Bái Hỏa Giáo|nz
拜物教=bái vật giáo/sùng bái/tệ sùng bái|nz
拜金主义=chủ trương tôn thờ đồng tiền/sự tôn thờ đồng tiền/bệnh ham làm giàu/quan niệm duy vật lý tài/chủ nghĩa sùng vàng|nz
拦江=Lan giang|nz
拦路虎=chướng ngại vật/vật trở ngại|nz
挂勾=móc treo/quải câu|nz
挂灯结彩=treo đèn kết hoa|nz
挂靴=treo giày|nz
挤牙膏=nói lấp lửng/nói không chủ định/nói không chủ đích/bóp kem đánh răng|nz
振华=Chấn Hoa|nz
振铃=chấn linh|nz
振龙=Chấn Long|nz
换一命=đổi một mạng|nz
换一换=đổi một cái/reload|nz
换尿布=thay tã|nz
换工=đổi công/vần công|nz
换性=đổi họ/phái|nz
换房=đổi phòng|nz
换文=trao đổi văn kiện ngoại giao/trao đổi văn bản/trao đổi văn kiện/đổi công hàm|nz
换气=lấy hơi/để thở|nz
换牙=thay răng/thay răng sữa|nz
换班=thay ca/đổi ca/thay kíp/đổi kíp|nz
换盏=cạn ly|nz
换肩=đổi vai/sang vai|nz
换脑筋=thay đổi tư tưởng/thay đổi quan niệm|nz
换药=hoán dược/thay đổi thuốc|nz
换衣=thay y phục/thay áo|nz
换衣服=thay quần áo|nz
换角=đổi vai|nz
换貌=đổi dung mạo|nz
换鞋=đổi giày|nz
换马=thay ngựa/đổi ngựa/thay người/đổi người|nz
捷克语=tiếng Tiệp Khắc|nz
捷报=tin chiến thắng/tin thắng lợi/tin thắng trận|nz
捷报频传=tin chiến thắng liên tiếp báo về|nz
捷达=Jetta/tiệp đạt|nz
捷运=tàu điện ngầm|nz
捷速=nhanh/nhanh chóng|nz
排九=bài cửu (*)|nz
排华=bài Hoa/Chứng sợ tiếng Trung|nz
排长龙=xếp hàng dài|nz
排骨汤=canh sườn|nz
接二连三=liên tiếp/tiếp nhị liên tam|nz
接龙=solitaire|nz
握力=sức nắm/cầm chặt/nắm chặt|nz
握把=chuôi nắm|nz
握拳=nắm tay/nắm đấm/nắm quyền|nz
握的=cầm|nz
握菱铁斋=Tsukabishi Tessai|nz
搜奇=sưu kỳ|nz
搜狐=Sohu|nz
搜狗=Sogou|nz
搜索队=đội trinh sát/sưu tác đội|nz
搜罗=vơ vét/thu thập|nz
搢绅=quan/quan chức/chức sắc/hưu quan|nz
携美=mang theo mỹ nữ|nz
摇控器=diêu khống khí|nz
摩丝=ma ty|nz
摩利=Mari|nz
摩卡=Mocha|nz
摩天=cao chọc trời/ma thiên|nz
摩天大厦=cao ốc chọc trời|nz
摩天大楼=nhà chọc trời|nz
摩天岭=Ma Thiên Lĩnh|nz
摩天轮=đu quay|nz
摩尔=Moore|nz
摩尔根=Morgan|nz
摩尼教=Ma Ni giáo|nz
摩托化=cơ giới hoá|nz
摩托船=xuồng máy/ca-nô|nz
摩托车=xe gắn máy/xe máy/xe mô-tô|nz
摩斯=Morse|nz
摩星=Ma Tinh|nz
摩柯=Ma Kha|nz
摩柯指=Ma Kha Chỉ|nz
摩根=Morgan|nz
摩根士丹利=Morgan Stanley|nz
摩根斯坦利=Morgan Stanley|nz
摩的=ma|nz
摩羯=Ma Kết|nz
摩羯宫=cung Ma Kết|nz
摩羯座=chòm Ma Kết|nz
摩轮=ma luân|nz
摩门教=giáo phái Mormon/mormon|nz
摽梅之年=đến tuổi dựng vợ gả chồng|nz
撒泡尿=tè dầm|nz
撒盐=xát muối|nz
撒网=tung lưới/tát võng/giăng lưới|nz
撒腿=nhanh chân/ba chân bốn cẳng/ù té chạy/chạy thẳng|nz
擒拿格斗=cầm nã cách đấu|nz
擒王=bắt vua/đầu đảng|nz
擒龙控鹤=Cầm Long Khống Hạc|nz
改革家=nhà cải cách|nz
改革派=phái cải cách|nz
放鸽子=leo cây/thả chim bồ câu|nz
敲门砖=nước cờ đầu|nz
敷粉=thoa phấn/xoa phấn|nz
文化大革命=Đại Cách mạng Văn hóa|nz
文华=văn hoa|nz
文忧=Văn Ưu|nz
文房四宝=văn phòng tứ bảo/văn phòng tứ bảo (bút, mực, giấy, nghiên)|nz
文教=văn giáo/văn hoá giáo dục|nz
文文=Văn Văn|nz
文旦=quả bưởi/trái bưởi|nz
文曲星=Văn Khúc tinh|nz
文泰=Văn Thái|nz
文科=văn khoa/môn khoa học xã hội|nz
文科班=văn khoa ban|nz
文联=Văn Liên|nz
文龙=Văn Long|nz
斗技=đấu kỹ|nz
斗拱=đấu củng|nz
斗星=Đấu Tinh|nz
斗牛=đẩu ngưu/đấu bò/chọi trâu/đấu trâu/đấu ngưu|nz
斯大林格勒=Stalingrad|nz
斯文扫地=trí thức không được trọng dụng/trí thức quét rác|nz
新一轮=một vòng mới|nz
新世界=thế giới mới/tân thế giới|nz
新世纪=thế kỷ mới|nz
新东方=Tân Đông Phương|nz
新丰=Tân Phong|nz
新义安=Tân Nghĩa An|nz
新人王=Tân Nhân Vương|nz
新传=tân truyện/truyện mới|nz
新华=tân hoa|nz
新历=tân lịch|nz
新发明=phát minh mới|nz
新大陆=đại lục mới/tân đại lục|nz
新天地=thiên địa mới/trời mới/Xintiandi|nz
新川恭二=Shinkawa Kyouji|nz
新开业=mới khai trương/khai trương mới|nz
新手机=điện thoại mới|nz
新手村=Tân Thủ thôn|nz
新教=tân giáo/đạo Tin Lành/giáo phái Tin Lành/Tân Giáo|nz
新文化运动=phong trào văn hoá mới|nz
新星=tân tinh/ngôi sao mới/sao mới|nz
新正=tháng giêng|nz
新民主主义革命=cách mạng dân chủ mới|nz
新浪=Sina/Tân Lãng|nz
新浪网=Sina|nz
新浴=mới tắm|nz
新秀=tân tú|nz
新科=tân khoa|nz
新科状元=tân khoa Trạng Nguyên|nz
新纪元=kỷ nguyên mới|nz
新罗=Tân La|nz
新语=tân ngữ|nz
新闻联播=bản tin thời sự|nz
新面貌=diện mạo mới|nz
新鲜出炉=mới vừa ra lò/mới mẻ xuất hiện|nz
新鲜肉=thịt tươi|nz
新鲜血液=máu mới/thành phần chính (máu mới)|nz
方块字=chữ vuông|nz
方腊起义=khởi nghĩa Phương Lạp|nz
旅顺=Lữ Thuận/Lüshun|nz
无华=tự nhiên/không tô điểm/không trang trí|nz
无师自通=vô sự tự thông/vô sự tự thông (*không thầy cũng tự thông tỏ)|nz
无敌舰队=hạm đội vô địch|nz
无机盐=muối vô cơ|nz
无法控制=không cách nào khống chế|nz
无福=vô phúc|nz
无线电报=điện báo vô tuyến/điện báo|nz
无缝钢管=ống thép liền/thép ống không mối hàn/thép ống không viền|nz
日新月异=biến chuyển từng ngày/ngày tháng đổi mới/thay đổi từng ngày/nhật tân nguyệt dị|nz
日月无光=nhật nguyệt vô quang/nhật nguyệt vô quang (*)/nhật nguyệt ảm đạm|nz
日月星=nhật nguyệt tinh|nz
日月星辰=nhật nguyệt tinh thần/mặt trời mặt trăng và ngôi sao|nz
日月神教=Nhật Nguyệt thần giáo|nz
日月重光=Nhật Nguyệt Trọng Quang|nz
日盛=ngày càng hưng thịnh|nz
日蚀=nhật thực|nz
日语=tiếng Nhật/Nhật ngữ|nz
日霜=kem dưỡng ban ngày/Kem dưỡng da ban ngày|nz
时代华纳=Time Warner|nz
昊天=Hạo Thiên|nz
昊明=Hạo Minh|nz
昌盛=hưng thịnh/hưng vượng/thịnh vượng|nz
明争=minh tranh|nz
明教=Minh giáo|nz
明日之星=ngôi sao của ngày mai|nz
明日黄花=hoa vàng ngày mai/hoa cúc ngày mai/việc lỗi thời/việc đã qua|nz
明治维新=Minh Trị Duy Tân/Minh Trị Duy tân của Nhật Bản năm 1868|nz
易拉罐=lon nước|nz
易筋丹=dịch cân đan|nz
易筋经=Dịch Cân Kinh|nz
星战=tinh chiến/Tinh Chiến/Star Wars|nz
星族=Tinh tộc/tinh tộc|nz
星星=tinh tinh/ngôi sao/ánh sao/chấm sao/vì sao/sao/đốm nhỏ/chấm nhỏ/những vì sao|nz
星球大战=Star Wars|nz
星际大战=đại chiến giữa các vì sao|nz
春梦=mộng xuân/ảo mộng/ảo ảnh thoáng qua/giấc mơ không thể thành hiện thực/xuân mộng|nz
春联=câu đối xuân/câu đối Tết|nz
昭仪=Chiêu Nghi|nz
昭华=Chiêu Hoa|nz
昭和=Shōwa/Akikazu/Shōwa, tên thời đại Nhật Bản, tương ứng với triều đại|nz
昭明=Chiêu Minh|nz
显教=hiển giáo|nz
显示仪=máy hiển thị|nz
晖映=chiếu rọi/hắt sáng/sáng chói/chiếu sáng/toả sáng|nz
普华=Phổ Hoa|nz
普及化=phổ cập hóa|nz
普及率=tỉ lệ phổ cập|nz
普天=Phổ Thiên|nz
普度众生=phổ độ chúng sinh/Phổ Độ chúng sinh/Phù độ chúng sinh|nz
普普通通=bình thường|nz
普米族=Phổ Mễ tộc|nz
普罗米修斯=Prometheus|nz
普通=phổ thông/bình thường/nói chung/thông thường|nz
景教=Cảnh giáo/Cảnh Giáo/Cơ đốc giáo Nestorian|nz
景泰=Cảnh Thái|nz
景颇族=Cảnh Pha tộc|nz
晴和=nắng ấm/trời quang đãng ấm áp/tình hòa|nz
晴天=trời nắng/im trời/trời trong/trời đẹp/tình thiên|nz
晴川=tình xuyên|nz
晴日=tinh nhật|nz
晴空=trời trong/trời quang/bầu trời quang đãng/quang đãng|nz
晴雯=Tình Văn|nz
曙光=ánh rạng đông/ánh sáng ban mai/ánh sáng lúc rạng đông/bình minh/rực rỡ|nz
曝光=lộ ra ánh sáng/cho hấp thụ ánh sáng/ra ánh sáng|nz
曼佗罗=Mạn Đà La|nz
望族=vọng tộc/họ lớn/nhà có danh vọng trong xã hội phong kiến|nz
朝九晚五=9 giờ tới 5 giờ về/triêu cửu vãn ngũ|nz
朝内=trong triều|nz
朝华=Triêu Hoa|nz
朝日新闻=Asahi Tân Văn/Asahi Shimbun|nz
朝鲜族=Triều Tiên|nz
朝鲜语=tiếng Triều Tiên/tiếng Hàn/ngôn ngữ Hàn Quốc|nz
未丰=không gió|nz
本命=bản mệnh/bản mệnh/bản mạng|nz
本圣=bản thánh|nz
本地风光=phong cảnh vùng này|nz
本特利=Bentley|nz
本田=Honda|nz
本真=nguồn gốc/căn nguyên/chân tướng/thành thật/chân thật/thật thà|nz
本科生=sinh viên chưa tốt nghiệp|nz
本龙=bản long/Benlong/Ben Dragon|nz
杀王=sát vương|nz
杉木=gỗ sam|nz
杜族=Đỗ Tộc|nz
杨狩=Dương Thú|nz
枕藉=nằm ngổn ngang/nằm la liệt/nằm gối vào nhau|nz
林战天=Lâm Chiến Thiên|nz
枚举=mai cử/liệt kê|nz
枢机主教=hồng y giáo chủ|nz
枢纽站=trạm đầu mối|nz
柯文=Kevin|nz
柯美=Kha Mỹ|nz
柱光=trụ quang|nz
标准大气压=khí áp chuẩn|nz
标准语=tiếng chuẩn/ngôn ngữ chuẩn mực|nz
格斗之王=The King of Fighter|nz
格日勒=Cách Nhật Lặc/Gerile|nz
格杀=giết chết/đánh chết|nz
格林尼治=Greenwich|nz
格莱美奖=giải Grammy/Giải Grammy|nz
桑族=Tang tộc|nz
梦兆=ứng mộng/điềm mộng|nz
梦梦=mộng mộng/giấc mơ|nz
梭巡=đi tuần tra|nz
梳翎=rỉa lông|nz
梵乐=Phạn nhạc|nz
梵云=Phạm Vân|nz
梵净山=núi Phạm Tịnh|nz
梵天=Phạn Thiên|nz
梵文=Phạn văn|nz
梵族=Phạm tộc|nz
梵清惠=Phạn Thanh Huệ|nz
梵特=Vant|nz
梵语=Phạn ngữ|nz
梵音=Phạn âm/phạm âm/tiếng Phạn|nz
梵高=Van Gogh|nz
棉农=nông dân trồng bông|nz
棉薄之力=sức lực nhỏ bé|nz
棱角=góc cạnh/thể hiện sự sắc sảo|nz
棱锥=hình chóp/tháp chóp|nz
棱镜=lăng kính|nz
榛榛=um tùm/rậm rạp|nz
榛莽=um tùm/rậm rạp|nz
榛蘑=nấm mật ong/nấm trăn|nz
槽内=trong máng|nz
槽床=giá kê máng|nz
模拟战=mô phỏng chiến/mô nghĩ chiến|nz
欣兰=Hân Lan|nz
欧元=Euro/đồng iu rô|nz
欧协杯=Europa Conference League|nz
欧战=Âu chiến|nz
欧文=Irving|nz
欧洲杯=Cúp Châu Âu/cúp Châu Âu|nz
欧阳夫人=Âu Dương phu nhân|nz
正一教=Chính Nhất giáo|nz
正儿八经=đường đường chính chính/chính nhi bát kinh/đường hoàng ra dáng|nz
正大光明=quang minh chính đại/quang minh chính đại|nz
正太=chính thái/trai kute/món chính|nz
正宗=chính tông/phái chính tông/chính thống/chân chính/chính cống|nz
正当权利=chính đáng quyền lợi|nz
正教=chính giáo/đang dạy|nz
正文=chính văn/chính văn|nz
正正经经=đàng hoàng/đứng đứng đắn đắn/chính chính kinh kinh|nz
正经八百=đứng đắn/nghiêm túc/nghiêm chỉnh|nz
此景=cảnh này/cảnh này|nz
此语=lời này|nz
此际=lúc này/giữa các/kết quả là|nz
步度根=Bộ Độ Căn|nz
步弓=bộ cung/cung đo đất|nz
毓秀=dục tú|nz
民主革命=Cách Mạng dân chủ|nz
民族自治=dân tộc tự trị|nz
氟班色林=Flibanserin|nz
氟石=huỳnh thạch/fluorite/phất trạch/fluor|nz
氢氟酸=axit flohyđric|nz
氢氧化钙=Ca(OH)2|nz
氢氧化钠=NaOH|nz
氢氰酸=a xít xianogien|nz
氨基酸=axit amin|nz
氯化钠=NaCl|nz
氯酸=axit chloric/axit clohydric/clorat|nz
氰化氢=acid hydrocyanic/hydro xyanua|nz
氰化钾=Kali xyanua|nz
水准仪=máy đo mực nước|nz
水木年华=thủy mộc niên hoa|nz
水浒传=Thủy Hử truyện|nz
水门汀=xi măng|nz
永动机=động cơ vĩnh cửu|nz
永发=Vĩnh Phát|nz
永和=Vĩnh Hòa|nz
永恒不变=vĩnh hằng bất biến|nz
永无宁日=vĩnh viễn không có ngày yên tĩnh/mãi sẽ không được yên thân/không bao giờ có ngày yên bình/sẽ không có hòa bình|nz
永泰=Vĩnh Thái|nz
永田=Nagata|nz
永福=Vĩnh Phúc/tỉnh Vĩnh Phúc|nz
求援信号=tín hiệu cầu viện|nz
求救信=thư cầu cứu|nz
求救信号=tín hiệu cầu cứu|nz
求教=thỉnh giáo/xin chỉ bảo/cầu cạnh|nz
汇丰=Hối Phong|nz
汇报=báo cáo/hội báo/hồi báo|nz
汉书=Hán thư|nz
汉利=Hanley|nz
汉化=Hán hóa/hán hóa|nz
汉唐=Hán Đường|nz
汉堡包=hamburger|nz
汉字=chữ Hán/chữ Hoa/chữ Trung quốc/chữ hán|nz
汉室=Hán thất|nz
汉文=Hán văn/Hán Văn|nz
汉斯=Hans|nz
汉族=Hán tộc|nz
汉服=Hán phục/hán phục|nz
汉林=Hansen|nz
汉水=Hán Thủy|nz
汉王=Hán vương|nz
汉考克=Hancock|nz
汉芙=Hanff|nz
汉藏语系=ngữ hệ Hán Tạng/tiếng Hán Tạng|nz
汉语=Hán ngữ|nz
汉越=Hán Việt|nz
江华=Giang Hoa|nz
江南七怪=Giang Nam Thất Quái|nz
江族=Giang tộc|nz
江湖义气=nghĩa khí giang hồ|nz
江湖医生=lang băm/giả danh thầy thuốc/bán thuốc dạo/bán thuốc rong|nz
江湖气=giang hồ khí|nz
江雯=Giang Văn|nz
沈日=Thẩm Nhật|nz
沈沦=Thẩm luân|nz
沐四侠=Mộc tứ hiệp|nz
沐浴液=sữa tắm|nz
沐浴露=sữa tắm|nz
沐然=Mộc Nhiên|nz
沐英=mộc anh|nz
沐铁=Mộc Thiết|nz
沙发=ghế sô pha/bóc tem/sô pha/ghế xô-pha/ghế tràng kỷ/ghế sa lon|nz
沥沥=róc rách/phần phật|nz
沱茶=trà bánh|nz
治国安邦=trị quốc an bang|nz
泌尿科=khoa tiết niệu/tiết niệu/Khoa tiết niệu|nz
法乙=Ligue 2|nz
法兰克福=Frankfurt|nz
法宝=pháp bảo/bùa/phép/phép báu/phép màu|nz
法文=tiếng Pháp/pháp văn|nz
法西斯主义=chủ nghĩa phát xít|nz
法语=tiếng Pháp|nz
泛光照明=chiếu đèn pha|nz
泛舟=chèo thuyền du ngoạn/chơi thuyền|nz
泡沫塑料=chất dẻo xốp|nz
泡泡龙=Phao Phao Long|nz
泡温泉=tắm suối nước nóng/phao ôn tuyền|nz
泡馍=phao mô/bánh bao ngâm/thịt và bánh canh|nz
波光=ba quang/sóng ánh sáng|nz
波兰人=người Ba Lan|nz
波斯猫=mèo Ba Tư|nz
波江座=chòm sao Ba Giang/Chòm sao Ba Giang/Eridanus|nz
波浪=gợn sóng/cuộn sóng/sóng/sóng nhỏ|nz
波澜=gợn sóng/sóng lớn/ gợn sóng/ba đào/sóng dậy/cơn sóng/cơn sóng dữ/tình tiết gay cấn/tình tiết lắt léo/sóng lớn|nz
波粒二象性=lưỡng tính sóng-hạt|nz
泰克=Tec/Thái Khắc|nz
泰和=Thái Hòa|nz
泰坦尼克号=tàu Titanic|nz
泰拳=Thái Quyền|nz
泰日天=Poodle Nhật Thiên|nz
泰语=tiếng Thái|nz
洁希=Khiết Hi|nz
洁琼=Khiết Quỳnh|nz
洁面乳=sữa rửa mặt/sữa rửa mặt|nz
洗三=tắm ba ngày|nz
洗发水=nước gội đầu|nz
洗发液=dầu gội|nz
洗发精=dầu gội đầu|nz
洗发露=dầu gội|nz
洗手台=bồn rửa tay|nz
洗手池=bồn rửa tay|nz
洗手液=nước rửa tay|nz
洗洁精=nước rửa bát/chất tẩy rửa/Nước rửa bát|nz
洗澡水=nước tắm|nz
洗碗机=máy rửa bát|nz
洗礼=tẩy lễ/lễ rửa tội/rửa tội/sự thử thách/thử thách/gột rửa|nz
洗面奶=sữa rửa mặt/sữa rửa mặt/Sữa rửa mặt|nz
津津乐道=nói chuyện say sưa/nói chuyện hăng say|nz
津浪=sóng thần/sóng ngầm|nz
津液=nước bọt/nước dãi/nước miếng|nz
洪战=Hồng Chiến|nz
洪熙=Hồng Hi|nz
派大星=Patrick Star|nz
派瑞=Perry|nz
浆帆=vải buồm|nz
浆汁=tương trấp|nz
浆洗=giặt hồ/giặt và hồ quần áo|nz
测力=đo lực/phép đo lực|nz
测字=đoán chữ|nz
测试中心=trung tâm kiểm tra|nz
测试仪=máy kiểm tra|nz
测试方法=phương pháp khảo sát|nz
测距仪=trắc cự nghi|nz
测速仪=dụng cụ đo tốc độ|nz
测量仪=thiết bị đo lường|nz
测量器=máy thăm dò|nz
济世救人=tế thế cứu nhân/tế thế cứu người|nz
济济一堂=tụ tập dưới một mái nhà|nz
浩浩=mênh mông/bao la/cuồn cuộn|nz
浪族=Lãng Tộc|nz
浪涌=dâng lên|nz
浮华=Phù Hoa|nz
海丰=Hải Phong|nz
海信=Hải Tín/Hisense|nz
海克=Haikel/Heick|nz
海内无双=độc nhất vô nhị/biển là vô song|nz
海军基地=căn cứ hải quân|nz
海勒=Heiler|nz
海大=biển rộng lớn/hải đại|nz
海大富=Hải Đại Phú|nz
海天=biển trời/hải thiên|nz
海平线=đường chân trời|nz
海床=thềm lục địa|nz
海康=hải khang|nz
海战=hải chiến/chiến đấu trên biển/cuộc chiến trên biển|nz
海教=Hải Giáo|nz
海文=hải văn|nz
海星=hải tinh|nz
海浪=sóng biển|nz
海渗=hải sâm|nz
海湾战争=chiến tranh vùng Vịnh|nz
海滨浴场=bãi tắm ven biển|nz
海牛=trâu nước|nz
海狮=sư tử biển/hải sư|nz
海瑞=Hải Thụy|nz
海田=hải điền|nz
海盗王=Vua Hải Tặc|nz
海蚀=xâm thực/xâm thực biển/sự xâm thực của nước biển|nz
海豹=báo biển/hải báo|nz
海运业=ngành vận tải biển|nz
海龙=hải long|nz
浸剂=thuốc ngâm/nước pha/nước sắc/nước hãm|nz
浸膏=cao ngâm/cao/thuốc cao|nz
润湿=thấm ướt|nz
润滑剂=dầu bôi trơn/thuốc bôi trơn|nz
润美=nhuận mỹ|nz
润肤乳=kem dưỡng da|nz
润肤霜=kem dưỡng ẩm/Sữa dưỡng thể|nz
润肤露=sữa dưỡng thể/body lotion/kem dưỡng ẩm/kem dưỡng da|nz
淘宝=đào bảo/đào bảo vật|nz
淘淘=đào đào/đào bới|nz
淬元丹=Thối Nguyên đan|nz
淬炼=rèn luyện|nz
淬药=tôi dược|nz
淬骨丹=Thối Cốt đan|nz
淮海战役=chiến dịch Hoài Hải|nz
淮王=Hoài Vương|nz
深信=tin tưởng/thâm tín/rất tin|nz
深奥=thâm ảo/sâu sắc/sâu xa/huyền bí|nz
深明=rất rõ/biết rõ|nz
深明大义=hiểu rõ đại nghĩa|nz
深沟高垒=luỹ cao hào sâu/thành cao hào sâu/phòng bị nghiêm ngặt/lũy cao hào sâu|nz
深海蓝=xanh nước biển/màu xanh biển sâu|nz
深达=sâu đạt/sâu đến|nz
深透=sâu sắc/thấu triệt|nz
深通=tinh thông/nắm vững/quán triệt|nz
淳一=Thuần Nhất|nz
淳和=thuần hòa|nz
淳熙=Thuần Hi|nz
淳美=thuần khiết/thanh khiết đẹp đẽ|nz
混日子=sống qua ngày/kiếm sống/không lý tưởng/không như ý|nz
清华=Thanh Hoa|nz
清新剂=nước xịt thơm phòng/chất làm mát|nz
清泉=thanh tuyền|nz
渣仔=cặn bã|nz
渣打=Chartered|nz
渣网=lưới quét|nz
温饱线=ăn no mặc ấm|nz
湖光=hồ quang|nz
湖广=Hồ Quảng|nz
湘绣=Tương Tú|nz
湘语=Tương Ngữ|nz
源根=nguyên căn|nz
源氏物语=Genji Monogatari|nz
源泉=nguồn suối/nguồn/cội nguồn|nz
滇红=điền hồng/hồng trà|nz
滋滋=tư tư/xì xì|nz
滚汤=nước sôi|nz
滚珠轴承=ổ trục bi đũa|nz
满座=ngồi đầy/hết vé/hết chỗ/chật rạp|nz
满族=Mãn tộc|nz
满月酒=tiệc đầy tháng|nz
满田=Mãn Điền|nz
满船=cả thuyền|nz
满酸=rất đau|nz
满面春风=mặt mày hớn hở/mặt mày rạng rỡ/mặt mày tươi tỉnh|nz
满面红光=hồng quang đầy mặt/mặt đỏ lừ lừ|nz
滤器=thiết bị lọc/đồ lọc|nz
滤液=chất lỏng đã lọc/phần lọc/phần nước lọc|nz
滤纸=giấy lọc|nz
滤网=phiên lọc|nz
漏电=rò điện|nz
漏网=lọt lưới|nz
潞王=Lộ Vương|nz
澄光=Trừng Quang|nz
澄汁=nước cam|nz
澄粉=bột năng/bột trong suốt/tinh bột mì|nz
澄观=Trừng Quan|nz
灿光=ánh sáng rực rỡ|nz
炉箅子=ghi lò/vỉ lò|nz
炉衬=thành lò/vách lò|nz
炊金馔玉=bữa tiệc thịnh soạn/vàng và ngọc|nz
炖汤=nấu canh|nz
点铁成金=biến sắt thành vàng/sửa dở thành hay/chữa lời văn từ dở thành hay|nz
炼乳=sữa đặc|nz
炼钢炉=lò luyện thép|nz
烂柯=Lạn Kha|nz
烂柯山=Lạn Kha sơn|nz
烈斯=Liệt Tư|nz
烈日当空=liệt nhật đương không|nz
烟农=trồng thuốc lá|nz
烟熏=hun khói|nz
热成像仪=máy ảnh nhiệt|nz
热辐射=bức xạ nhiệt|nz
焊锡=hàn thiếc|nz
照本宣科=máy móc/lệ thuộc sách vở|nz
熏天=ngút trời/huân thiên/xông trời|nz
熏烤=hun sấy/hun nướng|nz
熏草=Huân Thảo|nz
熏香=huân hương|nz
熏鱼=cá xông khói|nz
熏黑=hun đen|nz
熙宁=Hi Trữ|nz
熙德=Cid|nz
熹微=mờ mờ/nắng yếu/ánh sáng ban mai mờ nhạt|nz
燕族=Yến Tộc/Yến tộc|nz
燕鱼=cá thiểu|nz
燕麦片=yến mạch cán dẹt/yến mạch/bột yến mạch/mảnh yến mạch dẹt mỏng|nz
爱国主义=chủ nghĩa yêu nước/lòng yêu nước|nz
爱尔兰语=tiếng Ireland|nz
爱恨交加=ái hận đan xen|nz
爱斯基摩=Eskimo|nz
爱荷华=Iowa|nz
爽利=nhanh nhẹn/vui mừng/lanh lẹ|nz
爽性=dứt khoát|nz
爽的=thoải mái|nz
爽肤水=toner/nước làm mát da|nz
爽身粉=phấn xoa người/phấn rôm|nz
片儿汤=mì Tàu|nz
片冈=Kataoka|nz
片语=phiến ngữ|nz
牙牙学语=bi bô tập nói/nói bập bẹ/bi bô|nz
牡丹花=hoa mẫu đơn|nz
牵引力=lực kéo/sức kéo|nz
牵引器=máy kéo|nz
牵强附会=miễn cưỡng gán ghép/gò ép/gán ghép/chắp vá/miễn cưỡng phụ hoạ|nz
牵星=khiên tinh|nz
牵牛=Khiên Ngưu/hoa khiên ngưu/sao khiên ngưu|nz
牵牛星=sao khiên ngưu|nz
牵牛花=vinh quang buổi sáng/cây bìm bìm/dây bìm bìm/bìm bìm/bìm bịp|nz
牵红线=dắt tơ hồng|nz
牵线=giật dây/làm mối/làm trung gian giới thiệu/khiên tuyến|nz
特混舰队=hạm đội hỗn hợp đặc biệt/hạm đội đặc biệt/Hạm đội hỗn hợp đặc biệt|nz
犁牛=trâu cày|nz
犹太=Do Thái|nz
犹太人=người Do Thái|nz
犹太教=Đạo Do Thái|nz
犹新=như mới|nz
犹若=như/do nhược|nz
狗宝=cẩu bảo|nz
狗肉汤=canh thịt chó|nz
独眼龙=Độc Nhãn Long/độc nhãn long/người một mắt/người chột mắt|nz
独立战争=cuộc chiến tranh giành độc lập|nz
独语=độc thoại/nói một mình|nz
独龙族=Độc Long tộc|nz
猪人族=trư nhân tộc|nz
猪杂=lòng lợn/lợn tạp|nz
猴儿精=tinh quái/tinh ranh/khỉ/khỉ khọt/lanh lợi nhưng nghịch ngợm|nz
猴年马月=ngày tháng năm nào/không biết khi nào/không biết năm nào tháng nào/năm thìn bão lụt/hầu niên mã nguyệt/năm nào tháng nào|nz
猴拳=hầu quyền|nz
猴掌=hầu chưởng|nz
猴族=hầu tộc|nz
猴王=Hầu Vương|nz
猴精=hầu tinh|nz
玉兰片=măng khô|nz
玉杯=chén ngọc|nz
玉液琼浆=ngọc dịch quỳnh tương|nz
玉碎=ngọc nát|nz
玉米粥=cháo ngô|nz
玉镯子=vòng ngọc|nz
玉靴=ủng ngọc|nz
珀伽索斯=Pegasus|nz
珀修斯=Perseus|nz
珀耳修斯=Perseus|nz
珍宝=trân bảo/châu báu/vật báu/của báu/vàng bạc châu báu|nz
珍珠贝=trai ngọc/ngọc trai|nz
珍珠项链=dây chuyền trân châu|nz
珍馐美味=trân tu mỹ vị/trân trọng ngon/tinh tế và hương vị tốt/một điều trị tuyệt vời|nz
珞巴族=Lạc Ba tộc|nz
珠三角=Châu Tam Giác/Châu thổ sông Châu Giang|nz
珠光=châu quang|nz
珠光宝气=phục trang đẹp đẽ/ăn mặc, trang điểm xinh đẹp/châu quang bảo khí|nz
珠宝=châu báu/châu bảo|nz
珠宝商=cửa hàng châu báu|nz
珠宝展=triển lãm châu báu|nz
珠玉=châu ngọc|nz
珠玑=châu ngọc/ngọc trai|nz
珠穆朗玛=Everest|nz
班尼路=ban ni lộ|nz
琉璃塔=Lưu Ly Tháp|nz
琼华=Quỳnh Hoa|nz
瑞兆=điềm lành|nz
瑞星=Rising|nz
瑶光星=dao quang tinh|nz
瑶族=Dao tộc|nz
瑶珠=Dao Châu|nz
瑶草=cỏ ngọc|nz
瑶迦=Dao Già|nz
甘氨酸=Glycine|nz
生抽=xì dầu loãng/hút sống/nước sốt đậu nành sánh quyện， xì dầu|nz
甲乙丙丁=Giáp Ất Bính Đinh|nz
甲乙双方=hai bên AB|nz
甲午战争=chiến tranh Giáp Ngọ|nz
甲烷=mê-tan/mêtan|nz
甲申=giáp thân|nz
甲第=trạng nguyên/biệt thự/đỗ đầu|nz
甲第星罗=nhà cao cửa rộng|nz
甲第连云=nhà cao cửa rộng|nz
甲苯=tô-lu-en/tôluen|nz
甲赫=koukaku|nz
甲酸=a-xít fê-mi-ê/axít fêmiê|nz
甲醇=men-ta-non/mentanon|nz
甲醛=foóc-man-đê-hít/foócmanđêhít|nz
甲骨文=giáp cốt văn/chữ giáp cốt/văn giáp cốt|nz
申屠=Thân Đồ|nz
申州=Thân Châu|nz
申报=trình báo/trình bày/thân báo|nz
电显=màn hình điện thoại|nz
电视广播=phát đi bằng truyền hình/phát thanh truyền hình|nz
界中界=thế giới trong thế giới|nz
界河=Giới Hà|nz
界龙=Giới Long|nz
番茄汁=nước cà chua|nz
畲族=dân tộc Xa|nz
瘦肉汤=canh thịt nạc|nz
瘦肉粥=cháo thịt nạc|nz
瘦马=ngựa gầy/sấu mã/ngựa gầy ốm|nz
癔症=động kinh/bệnh tâm thần|nz
登仙路=đăng tiên lộ|nz
登堂=đăng đường|nz
登天=lên trời/đăng thiên|nz
登山临水=du sơn ngoạn thuỷ|nz
登山包=ba lô leo núi|nz
登山家=nhà leo núi/người leo núi|nz
登山服=trang phục leo núi/đồ leo núi/quần áo rét/quần áo mùa đông/quần áo leo núi|nz
登山绳=dây leo núi|nz
登山者=người leo núi/kẻ leo núi|nz
登山运动=thể thao leo núi|nz
登山鞋=giày leo núi/Giày leo núi|nz
登峰=trèo núi|nz
登报=đăng báo/lên báo|nz
登月=lên mặt trăng/đăng nguyệt|nz
登机牌=thẻ lên máy bay|nz
登殿=đăng điện|nz
登科=đăng khoa/thi đỗ/thi đậu|nz
登第=đăng đệ/đăng khoa/đỗ tiến sĩ/thi đỗ|nz
登记处=chỗ ghi danh|nz
登记表=đơn đăng ký|nz
登陆战=đăng lục chiến|nz
登革热=sốt xuất huyết|nz
白兰地=Brandy/rượu bran-đi/rượu mạnh|nz
白吉馍=Bạch Cát Mô|nz
白手起家=dựng nghiệp bằng hai bàn tay trắng/tay trắng làm nên sự nghiệp/tay trắng dựng cơ đồ/tay trắng dựng nghiệp|nz
白族=Bạch tộc/Bai|nz
白日升天=bạch nhật thăng thiên/thành tiên/ban ngày bay lên thượng giới/thăng quan bất ngờ|nz
白日梦=nằm mơ ban ngày/mộng tưởng hão huyền/mơ mộng/hoang tưởng/mộng ban ngày|nz
白浪=sóng bạc|nz
白狐=bạch hồ/chồn bạc/cáo trắng/cáo Bắc cực|nz
白纸黑字=giấy trắng mực đen|nz
白鲨=cá mập trắng/bạch sa|nz
白鹅=ngỗng trắng|nz
白鹿书院=Bạch Lộc Thư Viện|nz
百事通=bách sự thông/người thông tỏ mọi việc/người chuyện gì cũng biết|nz
百人斩=Bách nhân trảm|nz
百依百顺=ngoan ngoãn phục tùng/vâng lời răm rắp/bảo sao làm vậy/thiên lôi chỉ đâu đánh đó/muốn gì được đó|nz
百兆=trăm ngàn tỉ|nz
百发百中=bách phát bách trúng/chắc chắn/ăn chắc|nz
百团大战=bách đoàn đại chiến|nz
百孔千创=khốn khổ tột cùng|nz
百宝=Bách Bảo|nz
百家乐=Barracat|nz
百年战争=chiến tranh trăm năm|nz
百慕大=Bermuda|nz
百慕达=Bermuda|nz
百战=bách chiến|nz
百战天虫=Worms|nz
百战百胜=bách chiến bách thắng/đánh trăm trận trăm thắng/đánh đâu thắng đấy/trăm trận trăm thắng|nz
百教=bách giáo|nz
百日红=bách nhật hồng/tử vi|nz
百日维新=cuộc Duy Tân trăm ngày|nz
百炼千锤=trăm luyện nghìn chuỳ/nhiều lần thử thách/nhiều lần đấu tranh/sửa chữa tỉ mỉ|nz
百炼成钢=bách luyện thành cương/luyện mãi thành thép/thép đã tôi|nz
百王=bách vương|nz
百理通=bách lý thông|nz
百瑞=Bách Thụy|nz
百盛=Bách Thịnh|nz
百科=bách khoa|nz
百科全书=bách khoa toàn thư/bộ sách bách khoa/sách bách khoa về kiến thức chung|nz
百美图=Bách Mỹ Đồ|nz
百胜=bách thắng|nz
百藤=Bách Đằng|nz
百越=Bách Việt|nz
百银=bách ngân|nz
百顺百依=bảo sao làm vậy|nz
皓天=hạo thiên|nz
皓承=Hạo Thừa|nz
皓日=hạo nhật|nz
皓晨=Hạo Thần|nz
皓月=hạo nguyệt/trăng sáng/Hạo Nguyệt|nz
皓月当空=trăng sáng nhô lên cao|nz
皓白=trắng muốt/trắng như tuyết/trắng tinh/trắng xóa/hạo bạch|nz
皓阳=Hạo Dương|nz
皓齿=răng trắng|nz
益发=càng thêm/thêm|nz
益处=có ích/bổ ích/chỗ ích lợi|nz
益盛=Ích Thịnh|nz
盎格鲁=Anglo|nz
盐泉=diêm tuyền/suối muối|nz
盐霜=sương muối|nz
真实世界=thế giới chân thật|nz
真格的=thật/thật sự|nz
真理教=Chân Lý Giáo|nz
眺望塔=tháp quan sát|nz
眼福=may mắn được thấy/phúc được thấy/nhãn phúc|nz
眼科医生=bác sĩ khoa mắt|nz
睡意正浓=đang buồn ngủ díp mắt|nz
瞄准具=ống ngắm|nz
瞄准器=ống nhắm|nz
瞄准镜=ống nhắm/kính nhắm|nz
矫情自饰=che đậy khuyết điểm|nz
短兵接战=đánh giáp lá cà/đoản binh tiếp chiến|nz
短统靴=giày ống ngắn|nz
短讯=tin vắn/tin ngắn|nz
短语=đoản ngữ/từ tổ/nhóm từ/cụm từ|nz
石狩=Ishikari|nz
石风战=Thạch Phong Chiến|nz
硅基=gốc Silic/máy silic/khuê cơ/nguyên tố Si-lic|nz
硅酸盐=si-li-cát/silicate|nz
硝化甘油=nitro glyxerin|nz
硝酸甘油=Nitroglycerin/nitroglycerine|nz
硝酸钠=ni-trát na-tri|nz
硝酸钾=ni-trát ka-li|nz
硝酸铵=ni-trát am-mô-ni|nz
硝酸银=bạc nitrat|nz
硫酸钡=bari sunfat|nz
硫酸铝=a-xit KCl|nz
硬弓=cung cứng/chiếc cung cứng|nz
硬战=ngạnh chiến|nz
碎语=toái ngữ|nz
碳酸钙=CaCO3|nz
碳酸钠=Na2CO3|nz
碳酸钾=K2CO3|nz
碳黑=than đen|nz
磁铁矿=quặng fe-rít/quặng sắt|nz
磷光=lân quang/lân tinh|nz
磷酸=axit photphoric|nz
社会秩序=trật tự xã hội|nz
祈福=cầu phúc|nz
祛风除湿=loại trừ phong thấp|nz
神佑=thần phù hộ|nz
神农=Thần Nông|nz
神凰草=Thần Hoàng thảo|nz
神华=thần hoa|nz
神教=thần giáo|nz
神族=Thần tộc|nz
神无毗桥=cầu Kannabi|nz
神月教=Thần Nguyệt giáo|nz
神狐=thần hồ|nz
神田=Kanda|nz
神经元=thần kinh nguyên/tế bào thần kinh|nz
神经外科=khoa giải phẫu thần kinh/phẫu thuật thần kinh|nz
神经战=chiến tranh cân não/tâm lý chiến|nz
神经科=thần kinh khoa|nz
神舟=Thần Châu|nz
神通=thần thông/bản lĩnh cao cường|nz
神通广大=thần thông quảng đại|nz
神鹰=Thần Ưng|nz
神龙=thần long/rồng thần/Thần Long|nz
神龙教=Thần Long giáo|nz
祥光=tường quang/ánh sáng mang điềm lành|nz
祥瑞=tường thụy/điềm lành/Tường Thụy|nz
福份=phúc phận|nz
福佑=giáng phúc/ban phúc|nz
福兰克=Phúc Lan Khắc|nz
福字=chữ Phúc|nz
福报=phúc báo|nz
福星=phúc tinh/cứu tinh|nz
福船=thuyền buồm cổ|nz
禾本科=họ lúa/thân lúa|nz
稀世之宝=hi thế chi bảo|nz
稻盛=Inamori|nz
穆克=Muck|nz
穆力=Mục Lực|nz
穆勒=Müller/Moere|nz
穆库=Mục Khố|nz
穆斯塔法=Moustafa|nz
穆斯林=người Hồi giáo/tín đồ đạo Hồi/tín đồ đạo Ít-xlam|nz
穆林=Mục Lâm|nz
穆迪=Mục Địch/Moody|nz
穗轴=lõi bông/lõi bắp|nz
穷人的孩子早当家=trẻ nhà nghèo sớm biết chuyện/trẻ em nghèo sớm là một gia đình|nz
空乘=tiếp viên hàng không/hàng không|nz
穿山龙=Xuyên Sơn Long|nz
端人正士=người đoan trang chính trực|nz
端正=đoan chính/cân đối/đều đặn/ngay ngắn/đoan trang/tề chỉnh/nghiêm chỉnh/chấn chỉnh/đoan chính|nz
竹亭=trúc đình|nz
竹兰梅菊=trúc lan mai cúc|nz
竹林=rừng trúc|nz
竹林七贤=Trúc Lâm Thất Hiền|nz
竹林中=trong rừng trúc|nz
竹根=rễ trúc|nz
竹溪=Trúc Khê|nz
竹筒倒豆子=triệt để/đến nơi đến chốn|nz
竹篮=giỏ trúc|nz
竹荪=nấm trúc|nz
竹马=ngựa tre/ngựa giấy/trúc mã|nz
第一书记=bí thư thứ nhất/Bí thư thứ nhất|nz
第一夫人=đệ nhất phu nhân|nz
第一战=trận chiến đầu tiên|nz
第一次世界大战=đại chiến thế giới thứ nhất/chiến tranh thế giới lần thứ nhất/đệ nhất thế chiến|nz
第一次鸦片战争=chiến tranh nha phiến lần thứ nhất|nz
第一波=đợt thứ nhất|nz
第三世界=thế giới thứ ba|nz
第三产业=ngành dịch vụ/dịch vụ|nz
第三国际=đệ tam quốc tế/quốc tế thứ ba|nz
第三梯队=thê đội thứ ba|nz
第三版=trang thứ ba|nz
第三纪=kỷ đệ tam/kỷ thứ ba|nz
第三者=bên thứ ba/kẻ thứ ba/người thứ ba/bồ nhí|nz
第二世界=thế giới thứ hai/Thế Giới Thứ Hai [The Second World]/Thế Giới Thứ Hai /The Second World|nz
第二产业=công nghiệp và kiến trúc/sản nghiệp thứ hai|nz
第二发=phát thứ hai|nz
第二次世界大战=đại chiến thế giới lần hai/thế chiến thứ hai|nz
第六感=giác quan thứ sáu|nz
第纳尔=dinar|nz
筑基=trúc cơ|nz
筑墙=tường/bức tường|nz
筑巢=xây tổ/làm tổ/tổ|nz
筑路=xây đường/làm đường|nz
简化汉字=giản hoá nét chữ Hán/chữ Hán đã giản hoá/chữ giản thể|nz
管教=quản giáo/bảo đảm/đảm bảo/dạy dỗ/quản lý giáo dục/cải tạo|nz
篮球运动=vận động bóng rổ|nz
米根=Meegan|nz
米缸=vại gạo/thùng đựng gạo|nz
米语=tiếng Mỹ|nz
粤语=tiếng Quảng đông/tiếng Việt/Việt ngữ|nz
粱肉=món ăn cao cấp|nz
精华=tinh hoa/tinh tuý|nz
索命=lấy mạng|nz
红利=tiền lãi/tiền lời/tiền thưởng/hoa hồng/tiền típ/thu nhập thêm/thu nhập ngoài lương|nz
红十字=Hồng Thập Tự|nz
红十字会=hội Chữ Thập Đỏ|nz
红地毯=thảm đỏ|nz
红头发=tóc đỏ|nz
红教=Hồng giáo|nz
红星=hồng tinh/sao đỏ/ngôi sao|nz
红楼梦=Hồng Lâu Mộng|nz
红毒=hồng độc|nz
红汞=thuốc đỏ|nz
红牛=trâu đỏ/Red Bull|nz
红狐=Hồng Hồ|nz
红狮=Hồng Sư|nz
红珊瑚=Hồng San Hô|nz
红磷=hồng lân/phốt pho đỏ|nz
红粉=phấn hồng/phấn trang điểm/mỹ nhân/mỹ nữ/phấn đỏ|nz
红纸=giấy đỏ|nz
红菱=Hồng Lăng|nz
红衣主教=hồng y giáo chủ/giáo chủ hồng y|nz
红豆杉=hồng đậu sam|nz
红龙=Hồng Long|nz
约书亚=Joshua|nz
纯银=thuần ngân|nz
纳克=Nạp Khắc|nz
纳兰文=Nạp Lan Văn|nz
纳兰星=Nạp Lan Tinh|nz
纳唐=Nathan|nz
纳库=nạp khố|nz
纳彩=nạp thái/lễ vật lúc đính hôn|nz
纳斯号=No. Salinas|nz
纳斯达=Nasda|nz
纳斯达克=NASDAQ|nz
纳福=hưởng phúc|nz
纳米线=nạp mễ tuyến|nz
纳美=Nạp Mỹ|nz
纳西族=Nạp Tây tộc|nz
纳贝流士=Naberius|nz
纳达=Nada|nz
维他命=vitamin/sinh tố|nz
维修站=trạm sửa chữa|nz
维内=duy nội|nz
维利=Willy|nz
维吾尔=Duy Ngô Nhĩ|nz
维吾尔族=Duy Ngô Nhĩ|nz
维和=duy hoà/gìn giữ hòa bình|nz
维基百科=Wikipedia|nz
维族=Duy tộc|nz
维科=Duy Khoa|nz
维纶=Duy Luân|nz
维达=Duy Đạt|nz
绿豆汤=canh đậu xanh|nz
网络安全=an ninh mạng/Internet Security|nz
罗大佑=La Đại Hữu|nz
罗技=Logitech|nz
罗汉床=giường La Hán|nz
罗网=lưới võng/lưới/cạm bẫy/la võng|nz
罩杯=cup/tráo bôi|nz
置信=tin/tin tưởng|nz
羊肉汤=canh thịt dê|nz
羌族=Khương tộc|nz
美丽动人=mỹ lệ làm rung động lòng người|nz
美乳=mỹ nhũ|nz
美人计=mỹ nhân kế|nz
美人鱼=mỹ nhân ngư|nz
美发=tóc đẹp|nz
美味=mỹ vị/món ăn ngon|nz
美国佬=nước Mỹ|nz
美国式=phong cách Mỹ|nz
美圆=đồng đô-la Mỹ/đô-la Mỹ/đồng đôla Mỹ|nz
美好时光=thời gian tốt đẹp|nz
美妇人=mỹ phụ nhân/người mỹ phụ|nz
美孚=Mobil|nz
美文=văn hay|nz
美杜莎=Medusa/Mỹ Đỗ Toa|nz
美梦=mộng đẹp|nz
美洲杯=Cúp Châu Mỹ|nz
美洲虎=Hổ Châu Mỹ/Jaguar|nz
美洲豹=Báo Châu Mỹ|nz
美浓=Mino|nz
美男计=mỹ nam kế|nz
美籍华人=người Mỹ gốc Hoa|nz
美纶=Mỹ Luân|nz
美腿=cặp đùi đẹp/đùi đẹp|nz
美英=Mỹ Anh|nz
美菱=Mỹ Lăng|nz
美观=mỹ quan/đẹp/dễ coi/duyên dáng/bảnh tỏn|nz
美谈=ca tụng/câu chuyện mọi người ca tụng|nz
美貌=mỹ mạo|nz
羚羊挂角=linh dương móc sừng|nz
羟基=gốc OH|nz
翔子=Syouko/Tường Tử|nz
翔宇=Tường Vũ|nz
翔龙=tường long|nz
翰林=Hàn Lâm/hàn lâm|nz
翰林院=Hàn Lâm viện|nz
翰海=hồ Baikal/sa mạc Gobi|nz
耀月=Diệu Nguyệt|nz
老抽=hắc xì dầu/rút cũ/Tương đen|nz
耐克=Nike|nz
耐克鞋=giày Nike|nz
耐力=sức chịu đựng/sự chịu đựng|nz
耐受力=sức chịu đựng|nz
耐打=chịu đánh|nz
耐火砖=gạch chịu lửa|nz
耐特=Nate|nz
耐腐蚀=chống ăn mòn|nz
耐药性=tính kháng dược/chịu được thuốc|nz
耐迪=Nại Địch|nz
耳聪=tai thính|nz
聊备一格=cách tạm thời/cách dự phòng/lấy có|nz
聊天=nói chuyện phiếm/tán gẫu|nz
聊天儿=tán gẫu/nói chuyện phiếm/tán dóc|nz
聊天室=phòng khách|nz
聊天工具=phần mềm chat|nz
聊天记录=lịch sử trò chuyện|nz
聊斋=liêu trai|nz
聊斋志异=Liêu Trai Chí Dị|nz
联华=Liên Hoa|nz
联合战线=mặt trận liên hiệp|nz
联网=mạng lưới liên lạc/nối mạng/liên võng|nz
联谊=quan hệ hữu nghị|nz
联通=liên thông/ăn thông|nz
聚一聚=tụ họp một chút|nz
聚丙烯=polypropylene|nz
聚乙烯=Polyethylene|nz
聚元丹=Tụ Nguyên Đan|nz
聚光镜=thấu kính lồi/thấu kính lõm|nz
聚四氟乙烯=polytetrafluoroethylene/polyetrafluoroethylene|nz
聚氨酯=polyurethane|nz
聚沙成塔=tích cát thành tháp/tích ít thành nhiều/tích tiểu thành đại|nz
肉搏战=vật lộn/đánh giáp lá cà/chiến đấu giáp lá cà/đánh vật lộn/đánh tay không/cận chiến|nz
肉桂粉=bột quế/Quế|nz
肉蒲团=Nhục Bồ Đoàn|nz
肌肉发达=vạm vỡ/đầy bắp thịt|nz
肌肉注射=tiêm thịt/chích thịt/chích bắp|nz
肯迪=Kendi|nz
胡亥=Hồ Hợi|nz
胶乳=mủ cao su/nhựa cao su|nz
胶靴=ủng cao su|nz
胺多酚=Endorphins|nz
腐乳=đậu nhự/đậu phụ nhự/chao|nz
腓力=Philip|nz
腓力二世=Philippe II|nz
腾讯=Tencent/Đằng Tấn|nz
腾讯网=Tencent|nz
自乘=tự thừa/tự nhân|nz
自投罗网=tự chui đầu vào lưới/chui đầu vô lưới|nz
自语=tự nói|nz
至友=chí hữu|nz
至圣=Chí Thánh/chí thánh|nz
至宝=chí bảo/của quý báu/vật quý báu/vật quý nhất|nz
至德=chí đức/đại đức|nz
至斯=đến thế|nz
至毒=chí độc|nz
至阳=chí dương|nz
至阴=chí âm|nz
至霸=chí phách|nz
致人死命=khiến người vong mạng/khiến người chết|nz
致幻剂=chất gây ảo ảnh/thuốc gây ảo ảnh|nz
舍命=liều mình/liều mạng/quên mình/xả thân|nz
舒肤佳=Safeguard/Bảo vệ|nz
航海日记=nhật ký hàng hải|nz
节选自=tiết chọn từ|nz
芬芳=hương thơm/thơm ngát/thơm/mùi thơm/thơm tho/thơm ngát|nz
花解语=Hoa Giải Ngữ|nz
花语=hoa ngữ|nz
芳华=phương hoa/Phương Hoa|nz
芳汀=Fantine|nz
芳香族化合物=hợp chất thơm|nz
苄基=ben-zyn/benzyn|nz
苏打饼干=bánh quy mặn|nz
苗床=ruộng ươm/vườn ươm/đất ươm|nz
苗族=Miêu tộc|nz
苗语=Miêu ngữ|nz
苯乙烯=Bổn Ất Hy|nz
苯基=phenyl/nhóm phenyl|nz
苯甲酸=acid Benzoid|nz
苯酚=phê-non|nz
英乙=Bảng B|nz
英仙座=Anh Tiên Tọa|nz
英华=anh hoa/cỏ cây tươi đẹp/tinh hoa|nz
英国人=người Anh/người nước Anh|nz
英姿=anh tư/tư thế oai hùng|nz
英宗=Anh Tông|nz
英文=tiếng Anh|nz
英文字=chữ Anh|nz
英日=Anh Nhật|nz
英明=anh minh/sáng suốt|nz
英法=Anh Pháp/Anh-Pháp|nz
英王=Anh Vương|nz
英皇=Anh Hoàng|nz
英秀=anh tú/Anh Tú/Ưu mĩ/cao thượng. ◇Tam quốc chí 三國志: Anh tú chi đức... trác lịch quán quần 英秀之德... 卓躒冠群|nz
英语=tiếng Anh/Anh ngữ/Anh văn|nz
英雄主义=chủ nghĩa anh hùng|nz
英雄好汉=anh hùng hảo hán/anh hùng|nz
英雄救美=anh hùng cứu mỹ nhân/anh hùng cứu vẻ đẹp|nz
茅盾文学奖=giải Văn học Mao Thuẫn/Giải thưởng Văn học Mao Shield/Giải thưởng Văn học Mao Dun, giải thưởng viết tiểu thuyết của CHND Trung Hoa, được trao từ năm 1982|nz
草莽=lùm cỏ/bụi cỏ/bãi cỏ hoang/dân gian/thảo mãng|nz
荷兰语=tiếng Hà Lan/Ngôn ngữ Hà Lan)|nz
莫日根=Mạc Nhật Căn|nz
莱温斯基=Lewinsky|nz
莹润=oánh nhuận/trơn bóng|nz
菁华=tinh hoa/tinh tuý|nz
菁英=tinh anh|nz
菁菁=Thanh Thanh|nz
菲仪=lễ mọn/món quà nhỏ mọn/quà mọn|nz
菲力普=Philip|nz
菲力浦=Filip/Phillipe/Philippe|nz
菲烟=Phỉ Yên|nz
葡萄牙语=tiếng Bồ Đào Nha/Tiếng Bồ Đào Nha|nz
葫芦藤=dây hồ lô/giàn dây hồ lô|nz
蒙元=Mông Nguyên|nz
蒙古包=nhà bạt|nz
蒙古族=tộc Mông Cổ/Mông Cổ|nz
蒙族=Mông tộc|nz
蒙皮=da phủ|nz
蒙药=thuốc mê/thuốc tê|nz
蒙语=tiếng Mông Cổ|nz
蒙迪=Mông Địch|nz
蒙逊=Menton|nz
蒙铁=mông thiết|nz
蒙面人=người bịt mặt|nz
蒸汽浴室=phòng tắm hơi|nz
蕙心兰质=huệ tâm lan chất/Ức Tâm Lan Chất|nz
薄伽丘=Boccaccio|nz
薄命=bạc mệnh|nz
藏书=tàng thư/sách vở cất giữ/hồ sơ lưu trữ/văn thư lưu trữ/lưu trữ sách/cất giữ sách/chứa sách|nz
藏书室=tàng thư thất/Tàng Thư thất|nz
藏书库=tàng thư khố|nz
藏修=chuyên tâm học tập|nz
藏历=lịch Tây Tạng|nz
藏宝=bảo tàng/tàng bảo|nz
藏富=tiềm tàng/tiềm ẩn/ẩn chứa|nz
藏文=Tạng văn|nz
藏族=Tạng tộc|nz
藏王=tàng vương|nz
藏红花=nghệ tây/Hoa hồng tây tạng|nz
藏纳=giấu vào|nz
藏经=tàng kinh|nz
藏经殿=Tàng Kinh Điện|nz
藏蓝=tím/màu tím/màu lam phớt hồng|nz
藏语=tiếng Tạng|nz
藏银=giấu bạc|nz
藏风=tàng phong|nz
藏龙=tàng long/đầm rồng|nz
蘑菇云=mây hình nấm/ma cô vân/đám mây hình nấm|nz
虎人族=hổ nhân tộc|nz
虎虎=uy vũ/mạnh mẽ/đầy sinh lực|nz
虎豹=hổ báo|nz
虎鲨=Hổ Sa|nz
虚拟世界=thế giới giả tưởng/thế giới giả lập|nz
蜀王=Thục vương|nz
蜘蛛丝=tơ nhện|nz
蜘蛛网=mạng nhện|nz
蝶兰=Điệp Lan|nz
蝶梦=Điệp Mộng|nz
螯钳=càng cua|nz
螳螂拳=Đường lang quyền|nz
蟠龙=Bàn Long|nz
蟹粉=thịt cua|nz
蟹黄=gạch cua|nz
血芒大盛=huyết mang hừng hực|nz
血阳丹=Huyết Dương Đan|nz
街头霸王=Street Fighter|nz
街霸=Street Fighter|nz
补丁=miếng vá/mụn vá/chỗ vá/băng/patch|nz
补元丹=Bổ Nguyên Đan|nz
补天丹=Bổ Thiên Đan|nz
补天教=Bổ Thiên giáo|nz
补天浴日=lấp bể vá trời thành tích vĩ đại/lấp bể vá trời/thành tích vĩ đại/sức mạnh vĩ đại của con người|nz
补天芝=bổ thiên chi|nz
补语=bổ ngữ/túc từ|nz
衫袖=tay áo|nz
裕丰=Dụ Phong|nz
裕固=Dụ Cố|nz
裕美=Dụ Mỹ|nz
西华=Tây Hoa|nz
西厢=tây sương|nz
西厢房=Tây Sương phòng|nz
西厢记=Tây Sương Ký|nz
西毒=Tây Độc|nz
西洋镜=tây dương kính/gương phương Tây/hanky-panky|nz
西班牙人=người Tây Ban Nha|nz
西班牙语=tiếng Tây Ban Nha|nz
西语=tiếng Tây/Tiếng Tây Ban Nha)|nz
西贝货=hàng lởm/tây bối hoá/hàng tây/Hàng giả/hàng giả hiệu/Chỉ con gái giả nam trang trong phim Trung Quốc.|nz
规矩准绳=tuân thủ phép tắc/la bàn, thiết lập hình vuông, mức độ tinh thần và đường ống nước/tiêu chuẩn thành lập|nz
规行矩步=theo đúng khuôn phép/đúng khuôn phép/làm theo quy củ/đúng quy củ/theo lề thói cũ|nz
解元=giải nguyên/thủ khoa|nz
解和=giảng hoà/giải quyết tranh chấp/giải quyết xích mích|nz
解放战争=chiến tranh giải phóng|nz
解放鞋=giày giải phóng/giày cởi ra|nz
解梦=giải mộng|nz
解毒丸=Giải Độc Hoàn|nz
解毒剂=thuốc giải độc/chất giải độc|nz
解毒药=thuốc giải độc|nz
解铃=giải linh|nz
触摸屏=màn hình cảm ứng|nz
许字=hứa hôn|nz
许族=Hứa tộc|nz
论争=luận chiến/tranh luận|nz
论坛网=forum|nz
论战=luận chiến/tranh luận/bàn cãi|nz
论文=luận văn|nz
论语=Luận Ngữ|nz
评语=lời bình/lời bình luận/bình ngữ|nz
诚信=thành tín|nz
该亚=Gaia|nz
该博=uyên bác/uyên thâm|nz
该当何罪=phải bị tội gì|nz
该教=nên dạy/giáo này/kia giáo|nz
诺丁汉=Nottingham|nz
诺仔=Nặc Tử|nz
诺伯=Norbert|nz
诺基亚=Nokia|nz
诺大=to như vậy|nz
诺奖=giải Nobel/giải thưởng Nobel|nz
诺查丹玛斯=Nostradamus|nz
诺言=lời hứa|nz
诺贝尔奖=giải thưởng Nobel/giải Nobel|nz
调三窝四=khiêu khích/điều chỉnh ba tổ bốn/gieo mầm bất hòa khắp nơi|nz
调和油=dầu ăn|nz
调度室=phòng điều hành|nz
调教=điều giáo/dạy dỗ/chăm sóc dạy bảo/chăm sóc huấn luyện|nz
调查科=khoa điều tra|nz
调的=giọng/điệu/giọng điệu/pha/điều|nz
贝雷帽=mũ nồi|nz
贝露丹迪=Belldandy|nz
贞德=Jeanne d'Arc/Joan of Arc|nz
贞节=trinh tiết/tiết tháo kiên trinh/trung trinh/tiết nghĩa/trung thành cương trực/trinh/trong trắng/trong sạch|nz
贞观=Trinh Quán|nz
贸易协定=hiệp định thương mại/Hiệp định thương mại|nz
赛亚=Saiya|nz
赛会=thi đấu hội/hành hương|nz
赛博坦星=Cybertron|nz
赛尔=Sayr|nz
赛文=Seven|nz
赛斯=Tái Tư|nz
赛昂=Tái Ngang|nz
赛特=Seth|nz
赛米=Saimi/Assaimi|nz
赛达=Tái Đạt|nz
赛迪=Shadi|nz
赛马=ngựa đua/đua ngựa|nz
赞语=lời khen/lời khen ngợi/lời tán dương|nz
赤月教=Xích Nguyệt Giáo|nz
赤狐=cáo lông đỏ/cáo lửa|nz
赤贝肉=thịt sò màu đỏ|nz
赤铁矿=quặng sắt/quặng phe-rít/khoáng chất hê-ma-tít|nz
起帆=kéo buồm|nz
超伦=nổi bật/trội/hơn hẳn/hơn người|nz
超巨星=siêu cự tinh|nz
超度众生=siêu độ chúng sinh|nz
超新星=siêu tân tinh/sao băng/ngôi sao cực mới|nz
超英=Triêu Anh|nz
超高温=nhiệt độ siêu cao|nz
超高速=tốc độ cực cao|nz
越南战争=chiến tranh ZNV'/chiến tranh Việt Nam|nz
越南语=tiếng Việt/Tiếng Việt, Tiếng Việt|nz
越广=càng rộng/càng rộng|nz
越战=càng đánh|nz
越族=Việt tộc|nz
越线=vượt tuyến|nz
越语=Việt ngữ|nz
足弓=mu bàn chân|nz
足球运动=hoạt động bóng đá|nz
跑龙套=đóng vai phụ/kẻ chạy cờ/vào vai phụ|nz
跟踪器=máy theo dõi|nz
路德教=giáo hội Luther|nz
路易十三=Louie XIII|nz
蹈厉奋发=hăng hái phấn đấu|nz
转圜余地=khoan nhượng|nz
软和=mềm mại/mềm mỏng/dịu dàng/ngọt ngào/êm dịu|nz
软语=mềm giọng/nhuyễn ngữ|nz
轻型坦克=xe tăng loại nhẹ|nz
轻巡洋舰=tàu tuần dương hạng nhẹ/tàu tuần dương nhẹ|nz
辅公佑=Phụ Công Hữu|nz
辅车相依=nương tựa/bổ trợ lẫn nhau/quan hệ mật thiết|nz
辅酶=coenzyme|nz
辛亥革命=cách mạng Tân Hợi|nz
辛克=Tân Khắc|nz
辛劳=vất vả/vất vả cực nhọc/gian lao|nz
辛夷=mộc lan|nz
辛家=Tân gia|nz
辛格=Singh|nz
辛迪=Cindy|nz
辛迪加=Syndicate/Xanhdica|nz
辛酸=chua xót/cay chua/chua cay|nz
辰光=thời gian/lúc/vào lúc|nz
辰大=thần đại|nz
辰龙=Thìn Long|nz
辽沈战役=chiến dịch Liêu Thẩm/Chiến dịch Liaoshen|nz
达尔文主义=chủ nghĩa Đác-uyn/học thuyết Đác-uyn|nz
达斡尔族=Đạt Oát Nhĩ tộc|nz
达达主义=chủ nghĩa Dada|nz
迅龙=tấn long|nz
过奖=quá khen|nz
过桥拆桥=qua cầu rút ván|nz
过桥米线=lẩu bún qua cầu/qua cầu bún/Món mì nấu với lẩu hoa/sợi mì làm từ gạo|nz
过河拆桥=qua sông đoạn cầu|nz
过滤嘴=đầu lọc|nz
过街天桥=cầu vượt|nz
近战=cận chiến|nz
近水楼台=lâu đài gần nước/gần các tòa nhà nước/một gian hàng gần mặt nước/sử dụng sự gần gũi của một người với những người có quyền lực để có được sự ưu ái|nz
还教=còn dạy|nz
还施彼身=trả lại cho người|nz
还珠格格=Hoàn Châu Cách Cách|nz
这歌=bài hát này|nz
连战连捷=liền chiến liền thắng/liên chiến liên tiệp|nz
选修科=môn học tự chọn|nz
逊尼=Sunni|nz
逊尼派=phái Sunni|nz
通信卫星=vệ tin thông tin|nz
通讯=thông tin/truyền tin/thông báo tin tức/bài thông tin|nz
道丹=đạo đan|nz
道信=Đạo Tín|nz
道尔=Doyle|nz
道成寺=Đạo Thành tự|nz
道教=đạo giáo|nz
道林纸=giấy Dowling/giấy Đạo Lâm|nz
道琼斯=Dow Jones|nz
道真=đạo chân|nz
遮日=che mặt trời|nz
遮瑕液=kem che khuyết điểm|nz
遮瑕膏=kem che khuyết điểm|nz
遮阳帽=mũ che nắng/Mũ che nắng|nz
遮阳网=màn lưới che nắng|nz
遵命=tuân mệnh/tuân lệnh/tuân lời|nz
那战龙=con rồng chiến kia|nz
邦迪=band-aid/Band-Aid/Bondi|nz
邱淑贞=Khưu Thục Trinh|nz
鄂伦春族=Ngạc Luân Xuân tộc|nz
鄂温克族=Ngạc Ôn Khắc tộc|nz
配电箱=hộp điện/hộp phân phối điện/Thùng phối điện. Hòm phối liệu|nz
酒池肉林=tửu trì nhục lâm|nz
酚妥拉明=Phentolamine|nz
酸根=gốc a-xít/gốc axít|nz
酸梅汤=nước ô mai|nz
酸牛奶=sữa chua|nz
酸辣汤=canh chua cay/súp chua cay/Canh chua cay|nz
酸辣粉=bún chua cay/bột chua cay|nz
酸钠=axit nitric|nz
醇化=điêu luyện/trau chuốt/cô đọng|nz
醇和=dịu/không gắt/dịu ngọt/dịu êm|nz
醇正=thuần chính|nz
醇美=thuần mỹ/trong sạch tốt đẹp|nz
醇酒=thuần tửu/rượu nguyên chất/rượu mạnh|nz
醇香=thuần hương/tinh khiết và thơm|nz
醋坛子=bình dấm chua|nz
释教=thích giáo/Phật giáo|nz
重大新闻=tin tức trọng đại|nz
重奖=trọng thưởng/giải thưởng lớn/giải thưởng đáng giá/tiền thưởng lớn/tặng phẩm đáng giá/tặng giải thưởng lớn/tặng tặng phẩm đáng giá|nz
野山参=dã sơn sâm/nhân sâm núi|nz
野战=dã chiến|nz
野战医院=bệnh viện dã chiến/Bệnh viện dã chiến|nz
野菱=Dã Lăng|nz
金三角=Tam Giác Vàng|nz
金丹期=Kim Đan kỳ|nz
金像奖=giải Kim Tượng|nz
金元=kim nguyên/Mỹ kim/đô-la/USD/đồng vàng|nz
金光大道=kim quang đại đạo|nz
金创药=kim sang dược|nz
金利=Kim Lợi|nz
金华=Kim Hoa|nz
金发=tóc vàng|nz
金嗓子=kẹo thanh giọng/Golden/giọng ngọt ngào/giọng oanh vàng|nz
金大牛=Kim Đại Ngưu|nz
金奖=giải vàng/huy chương vàng/giải nhất|nz
金属丝=tơ kim loại|nz
金属光泽=kim loại sáng bóng/ánh kim loại|nz
金属外壳=vỏ kim loại|nz
金属棒=gậy kim loại|nz
金属片=mảnh kim loại|nz
金属环=vòng kim loại|nz
金属矿=mỏ kim loại|nz
金属管=ống sắt|nz
金属线=giây kim loại/dây kim loại|nz
金属陶瓷=gốm sứ kim loại|nz
金库=kim khố/kho bạc nhà nước|nz
金戈铁马=kim qua thiết mã/tư thế hào hùng/tư thế anh hùng/chiến tranh|nz
金手指=kim thủ chỉ|nz
金文=kim văn|nz
金斯利=Kingsley|nz
金星=kim tinh/sao vàng/sao Kim/sao vàng năm cánh/mắt nổ đom đóm/Kim tinh|nz
金杯=chén vàng/Kim Bôi/kim bôi|nz
金棕榈奖=giải Cành cọ Vàng|nz
金泉=kim tuyền|nz
金泰熙=Kim Tae-hee|nz
金牛=Kim Ngưu|nz
金牛座=chòm Kim Ngưu|nz
金狮=kim sư|nz
金狮奖=Giải Sư tử vàng/Giải sư tử vàng|nz
金球奖=giải quả cầu vàng|nz
金箍=kim cô|nz
金色年华=Golden Age|nz
金苹果=quả táo vàng|nz
金轮法王=Kim Luân Pháp Vương|nz
金钻=Kim Toản|nz
金铃=Kim Linh|nz
金银=vàng bạc/vàng và bạc/kim ngân|nz
金银珠宝=vàng bạc châu báu|nz
金门大桥=Cầu Cổng Vàng|nz
金靴奖=Chiếc Giày Vàng|nz
金马=kim mã|nz
金马奖=giải Kim Mã/Giải kim mã|nz
金鱼缸=chậu cá vàng|nz
金鸡纳霜=Quinin|nz
金鹰奖=giải Kim Ưng|nz
金龙一族=Kim Long nhất tộc|nz
钛合金=hợp kim titan|nz
钛晶=thạch anh tóc vàng/rutile quartz/thái tinh/tinh thể titan|nz
铅华=duyên hoa|nz
银狐=ngân hồ/Ngân Hồ|nz
锂电池=pin lithium|nz
锡伯族=Tích Bá tộc/Tích Bá|nz
锡克=Sikh/Đạo Sikh|nz
锡石=đá cassiterite/tích thạch/thiếc/cassiterite|nz
锡矿=mỏ thiếc|nz
锡纸=giấy bạc/giấy thiếc|nz
锡锭=thỏi thiếc|nz
锦帆=buồm gấm|nz
锯床=máy cưa/bàn máy cưa|nz
锯齿状=hình răng cưa/răng cưa|nz
镁光=tia sáng huỳnh quang/ánh sáng Ma-giê|nz
镁光灯=đèn sân khấu/ánh đèn/đèn ma-giê/ánh sáng magiê/Đèn ma-giê|nz
镁粉=bột magiê|nz
长二=dài hai|nz
长传=chuyền xa|nz
长信=trường tín|nz
长发=tóc dài|nz
长命=trường mệnh/sống lâu|nz
长命锁=khoá trường mệnh/khóa cuộc sống dài|nz
长大成人=trưởng thành/thành người lớn/thành niên|nz
长大衣=áo bành tô|nz
长恨歌=Trường hận ca|nz
长手族=tộc tay dài|nz
长斋绣佛=ăn chay niệm phật/Trường Trai thêu Phật|nz
长盛=trường thịnh|nz
长筒靴=giày ống cao|nz
长虹=trường hồng/cầu vồng/cầu hình vòm|nz
长谈=nói chuyện lâu/trường đàm|nz
长靴=trường ngoa/giày bó|nz
门巴族=Môn Ba|nz
闪电战=tiến công chớp nhoáng/đánh chớp nhoáng/tiến công nhanh|nz
间谍卫星=vệ tinh gián điệp|nz
闻讯=nghe hỏi/nghe tin|nz
防晒乳=kem chống nắng|nz
防晒霜=kem chống nắng|nz
防盗网=lưới bảo vệ|nz
防腐剂=chất bảo quản/chất khử trùng/chất chống phân hủy|nz
防腐蚀=chống ăn mòn|nz
防风林=rừng chắn gió|nz
阿伽门农=Agamemnon|nz
阿司匹林=aspirin|nz
阿拉伯数字=chữ số Ả rập|nz
阿拉伯语=tiếng Á Rập/Tiếng Ả Rập|nz
阿散井恋次=Abarai Renji|nz
阿昌族=A Xương|nz
除役=loại biên chế|nz
除根=trừ tận gốc/nhổ bật rễ/trừ tiệt nọc/diệt sạch/nhổ tận gốc/chữa tận gốc/trị tới nơi tới chốn|nz
除草=nhổ cỏ/làm cỏ/trừ cỏ/giẫy cỏ|nz
除草剂=thuốc trừ cỏ/thuốc diệt cỏ|nz
除草机=máy cắt cỏ|nz
隔天=hôm sau|nz
隔山=cách sơn/anh chị em cùng cha khác mẹ|nz
隔离霜=kem lót/kem cách ly/Kem lót sáng da|nz
雀巢=Nestlé|nz
雀狐=Tước Hồ|nz
雀鹰=chim ưng|nz
雅佳=Nhã Giai|nz
雅号=nhã hào/tên tuổi|nz
雅座=nhã tọa/chỗ lịch sự/trong một phòng trang nhã/căn phòng lịch sự/chỗ trang nhã/chỗ ngồi trang nhã|nz
雅气=nhã khí|nz
雅片=thuốc phiện/nha phiến|nz
雅虎=Yahoo|nz
雅观=lịch sự/nho nhã|nz
雅雯=Nhã Văn|nz
集大成=góp lại/thu lại|nz
集成电路=mạch điện hợp thành/mạch tổ hợp|nz
雏森=Hinamori|nz
雪茄烟=thuốc xi gà|nz
雪豹=báo tuyết|nz
雪铁龙=Citroën/Citroen|nz
震楼器=máy chấn lầu|nz
震虎=chấn hổ|nz
震远=Chấn Viễn|nz
露云芙=Lộ Vân Phù|nz
青春年华=tuổi thanh xuân|nz
青春痘=mụn trứng cá/mụn trẻ/mụn|nz
青灯古佛=Thanh Đăng Cổ Phật|nz
青苹果=táo xanh/quả táo xanh|nz
青蚨=thanh phù/tiền bạc/đồng tiền bằng đồng cổ|nz
青霜=Thanh Sương|nz
非金属矿=phi kim loại|nz
革命党=đảng cách mạng|nz
革命家=nhà cách mạng|nz
革命道路=con đường cách mạng|nz
鞋根=gót giày|nz
韩剧=phim Hàn|nz
韩语=tiếng Hàn|nz
韶华=thiều hoa/cảnh xuân tươi đẹp/vẻ đẹp tuổi xuân|nz
顶真=nghiêm túc/chăm chỉ/phương pháp tu từ|nz
顺命=phục mệnh/chịu phép/phục tùng mệnh lệnh/theo thiên mệnh/phục mệnh trời|nz
顺和=thuận hoà/ôn hoà/hoà nhã|nz
顺水推舟=thuận nước đẩy thuyền/biết thời biết thế/thuận thủy thôi chu|nz
顿挫抑扬=lên bổng xuống trầm/một chút thất vọng/nhịp|nz
颐和=di hòa|nz
颗大星=ngôi sao lớn|nz
飞亚达=Phi Á Đạt|nz
飞凰爪=Phi Hoàng Trảo|nz
飞利浦=Felip|nz
飞梭=phi toa|nz
飞泉=suối phun/thác nước/thác|nz
飞狐=phi hồ|nz
飞翔=bay lượn/vờn bay|nz
飞舟=phi thuyền|nz
飞虎=Phi Hổ|nz
飞讯=phi tấn|nz
飞语=chuyện nhảm nhí/lời nói vu vơ/lời nói vô căn cứ|nz
飞鸽传书=dùng bồ câu đưa tin|nz
飞鹰=phi ưng|nz
飞龙=Phi Long/phi long|nz
香菱=Hương Lăng|nz
马战=mã chiến|nz
马靴=giày ủng/giày ống/giày bốt|nz
驾虹=ngự cầu vồng|nz
驾训班=lớp học lái xe|nz
驾驶座=ghế lái/chỗ điều khiển|nz
驾驶证=giấy lái xe/bằng lái|nz
驾鹤=cưỡi hạc|nz
骆驼绒=vải nhung lạc đà|nz
骨肉团圆=gia đình đoàn viên|nz
高丽纸=giấy Cao Ly|nz
高山族=dân tộc Cao Sơn|nz
高手林立=cao thủ lớp lớp|nz
高教=cao giáo/giáo dục cao đẳng|nz
高楼大厦=nhà cao tầng/cao ốc/nhà chọc trời|nz
高科技=công nghệ cao|nz
高统靴=ủng/giày không thấm nước/ủng không thấm nước|nz
高速移动=di động cao tốc|nz
高高大大=cao cao to to/vừa cao vừa to|nz
魔羯=Ma Kết|nz
鲤鱼=cá chép|nz
鲤龙=Lý Long|nz
鸟山明=Toriyama Akira|nz
鸟翔=chim bay lượn|nz
鸟语=điểu ngữ/tiếng chim|nz
鸟龙=điểu long|nz
鸡丁=gà xé phay|nz
鸡毛信=thư hoả tốc/thư lông gà/thư phát chuyển nhanh|nz
鸦片=nha phiến/thuốc phiện|nz
鸦片战争=chiến tranh nha phiến|nz
鸿元=Hồng Nguyên|nz
鸿基=Hòn Gai/hồng cơ|nz
鸿泰=hồng thái|nz
鸿福=hồng phúc/phúc lớn|nz
鸿达=Hồng Đạt|nz
鹏族=Bằng tộc|nz
鹏飞=Bằng Phi/chuyến bay của roc|nz
鹏鸟=chim bằng/chim đại bàng|nz
鹤发=tóc bạc/tóc hạc|nz
鹤发鸡皮=tóc bạc da mồi|nz
鹰洋=tiền chim ưng|nz
鹰王=Ưng Vương|nz
鹰翔=Ưng Tường|nz
鹰钩=mỏ ưng|nz
麟儿=Lân nhi|nz
麟哥=Lân ca|nz
麟天=lân thiên|nz
麟洲=lân châu|nz
麟片=lân phiến|nz
麦浪=sóng lúa|nz
麦片粥=cháo bột yến mạch/cháo ngũ cốc|nz
麦粉=bột lúa mì|nz
麦粥=cháo lúa mạch|nz
麦精=tinh bột lúa mì/cao lúa mì|nz
麦角=hạt cựa|nz
黄教=Hoàng Giáo|nz
黄日华=Hoàng Nhật Hoa|nz
黄粱一梦=Hoàng Lương nhất mộng|nz
黄表纸=giấy vàng/giấy tiền vàng bạc|nz
黎族=Lê tộc/dân tộc Lê|nz
黑天鹅=thiên nga đen|nz
黑漆一团=tối đen/một khối sơn đen|nz
黑龙一族=Hắc Long nhất tộc|nz
鼎鼎=lừng lẫy/lớn/to/lẫy lừng|nz
齐发=tề phát/phát ra cùng một lúc/cùng phát|nz
齐族=Tề tộc|nz
齐根=tận gốc|nz
齐泰=Tề Thái|nz
齐粉=phấn vụn|nz
齐聚一堂=tề tụ một phòng/tập hợp lại với nhau/để đến được với nhau cùng một lúc|nz
齐达内=Zidane|nz
齿发=cái răng cái tóc/răng tóc|nz
齿根=chân răng|nz
龙华=Long Hoa|nz
龙套=diễn viên quần chúng/áo rồng/diễn viên mặc áo vằn/đào kép áo vằn/long sáo|nz
龙山文化=văn hoá Long Sơn|nz
龙床=long sàng/giường rồng|nz
龙战=Long Chiến|nz
龙战士=long chiến sĩ|nz
龙文=Long Văn/Quận Longwen của thành phố Chương Châu 漳州 市 [Zhang1 zhou1 shi4], Phúc Kiến|nz
龙泉=Long Tuyền|nz
龙舟=thuyền rồng|nz
龙语=long ngữ|nz
龙跃凰飞=long dược hoàng phi|nz
龟命=quy mệnh|nz
龟息丹=Quy Tức Đan|nz
龟汤=canh rùa|nz
龟王=Quy vương|nz
