丁丁当当=đinh đinh đương đương|o
丁当=leng keng/lách cách/kính coong/loong coong/đinh đoong|o
丁零=đinh linh/leng keng|o
丁零当啷=lách cách/leng keng/loảng xoảng/loong coong|o
乒乒乓乓=binh binh bàng bàng|o
乒乓=lách cách/lạch lạch/lộp bộp/bóng bàn/ping-pong|o
刺啦=xoẹt xẹt/đâm rồi/đâm này|o
剥啄=cốc cốc/cộc cộc|o
劈劈啪啪=phách phách ba ba|o
劈啪=keng keng/đùng/đoàng/đồm độp/đôm đốp/phách ba|o
劈里啪啦=bùm bùm/lạch tạch/đùng đoàng/phách lý ba lạp/ầm ầm|o
叮叮=đinh đinh/leng keng/xủng xẻng|o
叮叮当当=đinh đinh đang đang/đinh đinh đương đương/leng keng leng keng|o
叮咚=leng keng/đinh đông|o
叮啷=đinh lang|o
叮当=đinh đương/leng keng/lách cách/loong coong|o
叽叽=chít chít|o
叽叽咕咕=chít chít ục ục/thì thầm|o
叽叽喳喳=líu ríu/chút chít/kỷ kỷ tra tra/líu ra líu ríu|o
叽叽嘎嘎=khúc kha khúc khích/líu lo/khúc khích|o
叽呀=két két|o
叽咕=thầm thì/thì thầm/nói nhỏ/xì xào/thì thà thì thầm|o
叽里呱啦=bô bô/quang quác/kỷ lý oa lạp|o
叽里咕噜=huyên thuyên/liến thoắng/không mạch lạc|o
吧唧=bẹp/chẹp/bập/bập môi/rít/hút|o
吧啦=ba lạp/thôi nào|o
吧嗒=xoạch/bập/xịch/ba tháp|o
吭哧=ấp úng/hự/hì hục/ấp a ấp úng|o
吱吱=chi chi/xèo...xèo/xèo xèo/lèo xèo/tiếng kêu/chít chít|o
吱吱喳喳=chi chi tra tra|o
吱吱嘎嘎=két két|o
吱呀=kẹt kẹt|o
吱呀呀=kẹt kẹt/chầm chậm|o
吱唔=ê a|o
呱呱=oa oa/hu hu/oe oe/cạc cạc|o
呱哒=lách cách/lập cập/lọc cọc|o
呱唧=bốp bốp/đôm đốp/vỗ tay|o
呱嗒=lạo xạo/châm chọc/châm chích/[guā·da]/sưng mặt/sưng sỉa/oang oang/oang oác|o
呼哧=hồng hộc/hổn hển|o
呼哧呼哧=hồng hộc/hổn hển|o
呼哨=hô lên/huýt còi/huýt sáo/huýt gió/thổi còi/hô tiếu|o
呼啦=phần phật/hô lạp|o
呼啦啦=phần phật/hô lạp lạp/hô hào/răng rắc rắc|o
呼喇=phần phật|o
呼噜=khò khè/ngáy khò khò/ngáy pho pho/ngáy o o/tiếng ngáy/hô lỗ|o
呼噜噜=phù phù phù|o
咔叽=ka-ki/kaki|o
咔吧=rắc/răng rắc|o
咔咔=ken két/kèn kẹt|o
咔哒=cùm cụp|o
咔哧=két két|o
咔喳=ken két|o
咔嚓=răng rắc/lạch cạch/tạch tạch/rắc rắc|o
咕叽=òm ọp/bì bõm/lõm bõm/thì thầm/thì thào/xì xào|o
咕咕=ục ục/xì xào/thầm thì/xúi giục/xúi bẩy|o
咕咚=ừng ực/rầm/tòm/tỏm/ùm/cô đông|o
咕哒=Gudao|o
咕哧=lép nhép/ì ọp/xì xào/thì thầm|o
咕唧=òm ọp/bì bõm/lõm bõm/thì thầm/lẩm bẩm/lầm rầm/thì thào/xì xào|o
咕啦=cô lạp|o
咕啦啦=cô lạp lạp|o
咕嘟=ừng ực/ùng ục/sùng sục/ào ạt/òng ọc|o
咕嘟嘟=ùng ục ùng ục|o
咕噔=ừng ực/ùm|o
咕噜=ùng ục/lộc cộc/ực ực/kêu càu nhàu/ừng ực/lẩm bẩm/càu nhàu/cảu nhảu/cô lỗ/ọt ọt|o
咕噜咕噜=ùng ục ùng ục/ùng ục|o
咕噜噜=ùng ục ục/cô lỗ lỗ/ùng ục ùng ục|o
咕隆=rầm rầm/ầm ầm/đùng đùng/ừng ực|o
咚咚=thùng thùng/tùng tùng|o
咣当=ầm/rầm/lạch cạch|o
咪咪=meo meo/mị mị|o
咯吧=rắc|o
咯吱=kẽo kẹt/xoẹt zoẹt/xoẹt zoẹt~|o
咯吱咯吱=kẽo kẹt kẽo kẹt|o
咯咯=lạc lạc/khanh khách|o
咯啦=rắc rắc|o
咯噔=lộp bộp/lộp cộp/hồi hộp/lạc đăng|o
咯嚓=Grắc.../lộp bộp|o
咿呀=ê a/bì bõm/bi bô|o
咿咿呀呀=y y nha nha/a a a a|o
咿咿唔唔=y y ngô ngô|o
咿唔=ê a/Y ngô/tiếng ngâm nga|o
哇哇=oa oa/quạ quạ|o
哇啦=quang quác|o
哇嗷=úi chà|o
哈哈=ha ha/đùa/đùa cợt/đùa giỡn/cười hô hố|o
哈哈哈=ha ha ha|o
哈哈哈哈=ha ha ha ha/cáp cáp cáp cáp|o
哈啾=hắt xì/ách xì/achoo|o
哈喇=hôi dầu/gắt dầu/giết chết|o
哐当=bịch/leng keng|o
哗哗哗=ào ào ào|o
哗啦=soạt/hoa lạp/Rầm rầm/rầm/ào/'Rầm Ào Ào'|o
哗啦哗啦=ào ào/rắc...rắc...|o
哗啦啦=rầm rầm/hoa lạp lạp/ào ào ào|o
哧啦=xoẹt/xích lạp/loạt xoạt|o
哧啦啦=xích lạp lạp|o
哧溜=oạch/huỵch/bịch/xích lưu|o
哼哈=hanh cáp|o
哼哧=phì phò/thở hổn hển/thở phì phò|o
哼唧=lẩm bẩm/rầm rì/nói nhỏ/ngâm khẽ/khe khẽ|o
哼唷=hò dô/hò dô ta/hò khoan|o
唧咕=thì thầm/nói khẽ|o
唧唧=chít chít|o
唧唧喳喳=ríu ra ríu rít/ríu rít/chút cha chút chít/chút chít|o
唧唧嘎嘎=khúc khích/rúc rích|o
唧啾=ríu rít|o
啧啧=chậc chậc/tấm tắc/ríu rít/líu lo/sách sách/chà chà|o
啪叽=ba kít|o
啪啦=cách cách/rè rè/cành cạch/ba lạp|o
啪嗒=lạch cạch/lách cách|o
啪嚓=choảng/xoảng|o
啪地=tát|o
喀吧=răng rắc/rắc|o
喀哒=xành xạch/sình sịch|o
喀啦啦=cạch cạch cạch|o
喀嚓=răng rắc/rắc/sồn sột/rột rột|o
喀隆=Karon|o
喃呢=thì thầm/nam ni|o
喃喃=thì thào/rì rà rì rầm/lẩm bẩm/lẩm nhẩm/Nam nam/tiếng nói lầm rầm|o
喳喳=thì thầm/thủ thỉ/rì rầm/thì thà thì thầm/thầm thầm thì thì/nói nhỏ|o
嗖嗖=sưu sưu|o
嗡嗡=ong ong/vù vù/vo ve|o
嗡隆=vù vù|o
嗷嗷=ngao ngao/gào khóc/gào gào|o
嘀咕=nói thầm/lẩm bẩm|o
嘀嗒=tí tách/tích tắc|o
嘀里嘟噜=líu ríu/nói sa sả/nói bô bô/bô lô ba la|o
嘁嘁喳喳=rì rầm/thì thào|o
嘎吱=két/cót két/hắt xì/cọt kẹt/kẽo kẹt/kĩu kịt/dát chi/cót kẹtzz|o
嘎啦=ầm ầm/đùng đùng|o
嘎嘎=cạc cạc/cạp cạp/quang quác/quác quác/cái 'cá'/vật hình giống cái 'cá'|o
嘎噔=tách/tanh tách|o
嘎巴=rắc/răng rắc/cốp/dính lại/kết lại/bám dính/bám/dính|o
嘖嘖=khen/khâm phục/Trách trách/nức nỏm khen hoài|o
嘟嘟=tút tút/ục ục|o
嘟噜=xâu/chùm/rủ xuống/buông rủ xuống/xụ/âm rung|o
嘿呀=Hây A|o
嘿嘿=hắc hắc/hì hì/khà khà|o
嘿嘿嘿=hắc hắc hắc/khà khà khà|o
噗呲=pffft|o
噗哧=phốc xích/vèo/PHỤT/phù phù|o
噗嗤=phốc phốc|o
噗噜噜=tí tách/lã chã/thánh thót|o
噗拉=phốc lạp|o
噗通=phù phù/phốc thông|o
噼哩=đùng|o
噼啪=đôm đốp/đùng đùng/ đùng/đùng/đoàng/đồm độp|o
噼噼啪啪=lốp ba lốp bốp/đùng đùng đùng đùng|o
噼里啪啦=lốp bốp/đùng đùng/bùm bùm/đùng đùng (*không dứt)|o
噼里啪拉=lốp bốp/tích lý ba lạp|o
当啷=leng keng/loong-coong/đương lang|o
当当当当=đương đương đương đương|o
当当当当当=đương đương đương đương đương|o
忽哨=huýt sáo/huýt gió|o
怦怦=thẳng thắn|o
扑哧=phốc/xì/phì/hì/khì khì/phác xích|o
扑通=bịch/phác thông/ùm/tõm/tũm/tùm/rầm|o
梵呗=tiếng tụng kinh|o
汩汩=cốt cốt/cuồn cuộn/ồ ồ/ào ạt|o
泼剌=roạt/xoẹt/bì bõm|o
淅沥=tí tách/rả rích|o
淙淙=róc rách/ríu rít/ùng ục/ồng ộc|o
滴哒=lộc cộc/tích đát|o
滴嗒=nhỏ giọt/nhểu giọt|o
滴沥=tí tách/lách tách/róc rách|o
滴溜=nhỏ giọt/rơi từng giọt|o
滴滴嗒嗒=tí tách|o
滴滴答答=tích táp/tiếng nước nhỏ giọt/tí tách/rơi lộp độp/tí tí tách tách|o
滴答=tí tách/tích tắc/tích đáp|o
滴里嘟噜=lớn nhỏ lẫn lộn/lung tung/cả xâu/cả chuỗi/tí tách/tích tắc|o
轰隆=ầm ầm/ầm vang/gầm vang/đùng đoàng/ầm|o
轰隆轰隆=rầm rập/ầm ầm|o
轰隆隆=ầm ầm/ùng ùng/ầm ầm ầm|o
铿锵=âm vang/leng keng/vang vang/khanh thương|o
锵锵=bang bang/tiếng chuông/leng keng|o
隆隆=ù ù/ầm ầm/ình ình|o
骨嘟=bĩu môi/chu miệng/trề môi/chu mỏ|o
