为之=vì đó/chịu/trở nên/hơi bị|p
为由=làm lý do|p
为着=để/vì|p
为过=quá đáng|p
乘着=đáp lấy/thừa lúc/ngồi/thừa dịp|p
依从=thuận theo/nghe theo/vâng theo/tuân theo|p
依据=căn cứ/theo/dựa vào/y theo|p
依照=y theo/theo/căn cứ vào/chiếu theo|p
借据=giấy nợ/biên lai mượn đồ/biên nhận mượn đồ|p
借着=mượn/nương/dựa vào|p
关于=liên quan tới/về/liên quan với|p
关照=chiếu cố/chăm sóc/quan tâm/phối hợp với nhau, sắp xếp toàn diện/nhắn tin/báo tin/nhắc/thông báo miệng|p
冲着=hướng về phía|p
凭借=bằng vào/dựa vào/nhờ vào|p
凭借着=nương tựa theo/bằng vào|p
凭据=bằng chứng/cớ/chứng cớ|p
凭照=giấy chứng nhận/giấy xác nhận/thị thực|p
凭着=dựa vào|p
向着=hướng về/nhìn về/bênh vực/thiên vị/hướng|p
基于=căn cứ vào/dựa vào/dựa trên|p
对之=đối lại/đối với đó|p
对了=đúng rồi/đúng/Đúng rồi|p
对于=đối với/về..|p
对照=so sánh/đối chiếu|p
对过=đối diện/trước mặt/phía bên kia/đối qua|p
当着=ngay trước/làm trò/đang tại/ngay ở trước mặt|p
按了=ấn/xoa bóp/nhấn|p
按照=dựa theo/chiếu theo/theo/dựa vào/căn cứ vào|p
按着=án lấy/đè xuống/ấn lại|p
朝着=hướng phía/hướng/hướng về|p
本着=căn cứ/dựa vào/trên nguyên tắc/vốn|p
根据=căn cứ/căn cứ vào/dựa vào/chứng cứ/luận cứ|p
根由=căn do/lai lịch/nguyên nhân/nguyên do/duyên cớ|p
每当=mỗi khi|p
比照=đối chiếu/chiếu theo/so sánh/so sánh đối chiếu|p
沿着=dọc theo|p
经由=trải qua/đi qua/qua/chạy qua|p
经过=trải qua/đi qua/kinh qua/qua/đã được/quá trình/tiến trình/dòng|p
缘由=nguyên do/nguyên nhân/lý do/duyên do|p
自从=từ khi/từ/từ lúc/kể từ|p
自打=từ lúc/từ khi|p
至于=về phần/đến mức/đến nỗi/còn như/còn/cho tới|p
趁着=thừa dịp/lợi dụng khi|p
通着=thông lên|p
通过=thông qua/đi qua/qua|p
鉴于=xét thấy/thấy rằng/xét theo/giám vu|p
针对=nhằm vào/chĩa vào/chĩa mũi nhọn vào/đứng trước/đối với|p
除了=trừ/ngoại trừ/ngoài ra/trừ ra/ngoài...ra/ngoài...ra thì chỉ có../loại trừ|p
随之=tùy theo|p
随从=tùy tùng/đi theo/nhân viên tuỳ tùng/người đi theo|p
随同=hộ tống/đi cùng|p
随着=theo|p
靠了=lại gần|p
靠着=dựa vào|p
顺从=thuận theo/nghe theo/vâng theo/ngoan ngoãn theo|p
顺当=thuận lợi/trôi chảy/thuận đương|p
顺着=thuận/theo|p
