乇=thác|q
些=ta|q
仞=nhận|q
兆儿=Triệu nhi|q
兆里=tỷ dặm/ngàn tỉ dặm|q
公亩=công mẫu/A|q
公元=công nguyên/công lịch/dương lịch|q
公厘=milimet/cây số|q
公尺=mét/công xích|q
公斤=ký/kg/ki-lô-gam/kí lô|q
公里=cây số/km/công lý|q
公顷=hécta/héc-ta|q
分列=phân loại/chia loại/chia nhóm/chia|q
分厘卡=thước bách phân|q
分秒=giây phút/từng phút từng giây|q
分钟=phút|q
刻钟=khắc đồng hồ|q
加元=gia nguyên/đô la Canada|q
千克=kilôgam/ki-lô-gam|q
千卡=ki-lô-cal/kilôcal|q
千米=ngàn mét/cây số/ki-lô-mét/ngàn mét|q
千里=ngàn dặm/thiên lý/nghìn dặm/ngàn dặm|q
卡路里=Calorie|q
厘米=centimet/centimét/cm|q
句=cú|q
句句=câu câu/những câu|q
圈里=trong vòng|q
天元=Thiên Nguyên/thiên nguyên|q
层天=tầng trời|q
居里=Cu-ri/ở giữa|q
帙=trật|q
帧=tránh|q
平儿=Bình nhi|q
平克=Pinky|q
平列=ngang hàng/ngang nhau|q
平方=bình phương/bậc hai/mét vuông/thước vuông|q
平方公里=cây số vuông/kilômét vuông/ki-lô-mét vuông/km2|q
平方分米=cm vuông|q
平方尺=thước vuông|q
平方米=mét vuông/thước vuông|q
平步=bình bộ|q
平米=mét vuông/thước vuông|q
微簇=co lại|q
微米=bé nhỏ/mi-crô-mét/micron/micrômét|q
斛=hộc|q
朵儿=đoá hoa/bông hoa/đoá/đám|q
朵朵=đóa đóa/Đóa Đóa/nhiều đóa/từng đoá/từng đoá từng đoá|q
桿=can|q
棵=khỏa|q
楹=doanh|q
樘=đường|q
毛里=dưới lông|q
毫升=ml/milliliter|q
毫厘=chút xíu/ít/ít ỏi/số lượng rất nhỏ/chút ít/tí tẹo/tí/không chút/tẹo|q
毫厘千里=sai một li đi một dặm|q
毫安=mA/milliampere|q
毫秒=mili giây|q
毫米=li/milimét|q
泓=hoằng|q
海米=tôm nõn/tôm khô|q
澳元=đô la Úc/AUD/Đô la Úc|q
炷=chú|q
点钟=giờ|q
爿=tường|q
犋=cụ|q
畈=phán|q
盎=áng|q
盎司=ounce|q
盏=trản|q
磴=đặng|q
种种=đủ loại/các loại/trồng chút|q
立方=lập phương/hình khối/luỹ thừa ba/mũ ba/lập thể/mét khối/vuông|q
立方公里=cây số vuông|q
立方毫米=mm³|q
立方米=mét khối|q
簇簇=lũ|q
系列=hệ liệt/series/dẫy/ loạt/hàng loạt/hàng loạt /(*series)|q
級=cấp|q
绺=lữu|q
缗=mân|q
美元=đôla/đô la/đôla Mỹ|q
美方=Mỹ|q
英亩=mẫu Anh|q
英尺=thước Anh|q
英镑=bảng Anh/đồng bảng Anh|q
茬=tra|q
蔸=đâu|q
锭=đĩnh|q
锾=hoàn|q
镒=dật|q
阕=khuyết|q
阵列=trận liệt/hàng ngũ|q
阵阵=trận trận/từng cơn/từng trận|q
頁=hiệt|q
马列=Marx-Lenin/Marx và Lenin|q
马里=Ma-li/Mali/Republic of Mali|q
