一伙人=một nhóm người/nhất hỏa nhân|r
一伙儿=một đám|r
一切=hết thảy/tất cả/mọi/mọi thứ/toàn bộ/nhất thiết/hết thẩy|r
一己=bản thân/cá nhân/tự mình|r
一样=một dạng/đồng dạng/như nhau/giống nhau/cũng như/cũng thế/vậy/như thế|r
不但如此=không chỉ như thế/bất đãn như thử/chẳng những chỉ như thế|r
两样=hai loại/khác biệt/khác nhau/lưỡng dạng/khác nhau/không giống nhau|r
个个=từng cái/mỗi người/mọi người/người người/mỗi/từng|r
为人=làm người/vì người/thái độ làm người/đối nhân xử thế/tính tình|r
为什么=vì cái gì/vì sao/tại sao|r
为何=vì sao/là gì/là sao/vì cái gì/tại sao|r
为啥=vì sao/tại sao|r
为天=là trời/là thiên|r
为己=vì bản thân|r
为期=trong vòng/trong khi/kỳ hạn/thời gian/thời hạn|r
为次=làm thứ|r
为此=vì thế|r
为父=vi phụ/là cha|r
为界=làm ranh giới|r
为笔=làm bút|r
为级=30 cấp|r
之一=một trong/chi nhất|r
之中=bên trong/trong|r
之举=cử chỉ/tiến hành|r
之久=lâu/lâu dài|r
之么=hay sao|r
之书=chi thư|r
之事=sự tình/việc/chuyện|r
之二=thứ hai/hai|r
之人=người/chi nhân|r
之会=chi hội/hội|r
之位=chi vị/vị trí/vị|r
之初=chi sơ/mới bắt đầu/ban đầu|r
之刻=thời khắc|r
之处=chỗ|r
之妻=vợ|r
之子=chi tử/con trai/người ấy/con của|r
之少=rất ít|r
之局=chi cục/kết quả|r
之式=chi thức/thức|r
之心=chi tâm|r
之战=chi chiến|r
之日=ngày|r
之月=chi nguyệt|r
之机=cơ hội/chi cơ|r
之流=chi lưu/hàng ngũ|r
之父=chi phụ/cha|r
之用=chi dụng/tác dụng|r
之盒=chi hạp|r
之种=chi chủng|r
之类=loại hình/các loại|r
之行=chi hành/hành trình/chuyến đi/hành vi|r
之话=lời nói|r
之身=chi thân/thân|r
之轮=chi luân|r
之辈=hạng người/thế hệ|r
什么=cái gì/cái đó/gì/nào/gì đó/nhậm chỉ/mọi thứ/nấy/cái quái gì/hả/nào là|r
什么样=cái dạng gì/ra sao|r
什什什什什=cái cái cái cái cái|r
什物=các đồ lặt vặt/đồ vặt vãnh/đồ lặt vặt/thập vật|r
什麼=cái gì/gì|r
他=tha|r
他事=việc khác/việc mà hắn/tha sự/chuyện hắn|r
他人=người khác/kẻ khác/hắn người|r
他们=bọn hắn/bọn họ/chúng nó/họ|r
他俩=hai người bọn họ|r
他們=bọn hắn/bọn họ|r
他儿=con hắn|r
他国=nước khác/nước hắn|r
他处=chỗ hắn/chỗ khác|r
他家=nhà hắn|r
他年=năm nào/năm kia/năm đó|r
他心=tâm hắn/lòng hắn|r
他族=tộc khác/hắn tộc|r
他日=ngày khác/hôm nào đó/ngày đó/nó nhật|r
他法=cách khác/phương pháp/phương thức/hắn pháp/khác pháp|r
他父=cha hắn|r
他物=vật khác/những thứ của mình/đồ đạc của hắn|r
他界=giới khác|r
他的=hắn/của hắn/khác|r
任他=mặc hắn|r
任何=bất luận cái gì/bất kỳ|r
任何人=bất luận kẻ nào/bất luận người nào|r
任何时刻=bất kỳ thời khắc nào|r
任儿=Nhâm nhi|r
任它=mặc nó|r
何事=chuyện gì|r
何人=người nào/người phương nào|r
何儿=Hà nhi|r
何地=chỗ nào/đất/nơi nào|r
何处=nơi nào|r
何妨=ngại gì/sợ gì/có sao đâu/hà phương|r
何年=năm nào|r
何方=phương nào|r
何日=ngày nào|r
何月=tháng nào|r
何样=kiểu gì|r
何种=loại nào|r
何等=cỡ nào/hạng gì/hạng/loại/như thế nào/ra sao/vô cùng/rất/biết bao/quá/bực nào|r
你=nhĩ|r
你们=các ngươi/các ông/các bà/các anh/các chị|r
你俩=hai ngươi|r
你儿=con trai của ngươi|r
你地=ngươi/của ngươi|r
你家=nhà ngươi/nhà của ngươi|r
你己=tự ngươi|r
你父=cha ngươi|r
你的=ngươi/của ngươi|r
你老=ngươi lão|r
你身=thân ngươi|r
俺=yêm|r
俺们=bọn ta|r
其=kỳ|r
其一=một/thứ nhất|r
其三=thứ ba|r
其中=trong đó/nó trung|r
其事=việc/chuyện lạ|r
其二=hai/thứ hai/nó hai|r
其人=một thân/kỳ nhân|r
其他=cái khác/mặt khác/khác/những khác|r
其余=còn lại/ngoài ra|r
其四=thứ tư/bốn|r
其地=nó đất/kỳ địa|r
其妻=vợ hắn|r
其它=cái khác/khác|r
其户=cửa đó|r
其时=lúc đó|r
其次=tiếp theo/thứ nhì/thứ hai/tiếp đó/sau đó/sau nó/thứ yếu|r
其里=trong đó|r
其间=ở giữa/trong đó/trong thời gian đó/trong lúc|r
几何=bao nhiêu/hình học/bấy nhiêu|r
別人=người khác|r
别个=người khác/kẻ khác/người ta/khác|r
别事=việc khác|r
别人=người khác/kẻ khác/người ta|r
别县=huyện khác|r
别国=nước khác|r
别地=nơi khác/khác địa|r
别处=nơi khác/chỗ khác|r
别家=nhà khác/đơn vị khác|r
别州=châu khác|r
别族=tộc khác|r
别本=bản khác|r
别样=khác/ngoài/kiểu khác/cách khác/biệt dạng|r
别班=lớp khác|r
别的=khác/cái khác/những khác|r
别种=loại khác|r
别类=khác loại|r
别组=tổ khác|r
别自=chớ tự|r
别院=biệt viện|r
别馆=biệt quán/hành cung/biệt thự/vi-la/nhà khách|r
前些=trước mấy|r
前次=lần trước|r
前身=tiền thân/đời trước/vạt trước áo dài/vạt trước|r
前项=số hạng trước/mục trước|r
厥=quyết|r
各=các|r
各个=các/từng cái/mỗi cái/mỗi/tất cả mọi cái/mỗi cái|r
各人=mọi người/mỗi người|r
各位=các vị/mọi người/các ngài|r
各国=các quốc gia|r
各地=các nơi|r
各型=các loại|r
各处=các nơi/nơi nơi/mọi nơi/khắp nơi/khắp chốn|r
各式=các thức/các loại|r
各方=các phương/các phe/khắp nơi|r
各族=các tộc|r
各样=các dạng|r
各派=các phái/đều phái|r
各界=các giới|r
各省=các tỉnh|r
各种=các loại/mọi/đủ loại|r
各站=các trạm|r
各等=các cấp|r
各类=các loại|r
各系=các hệ|r
各级=các cấp|r
各自=riêng phần mình/đều tự/từng người/riêng phần mình/mỗi người|r
各色=các loại/các màu/đủ thứ/đặc biệt/đặc biệt/sắc thái riêng/đủ loại|r
各路=các lộ|r
各部=các bộ|r
各间=các gian|r
各项=các hạng|r
同种=cùng loại|r
后此=về sau/sau đấy|r
吾=ngô|r
吾人=chúng ta/chúng tôi|r
吾侪=chúng ta/lứa chúng ta/thế hệ chúng ta|r
吾儿=con ta|r
吾师=thầy ta|r
吾身=thân ta|r
吾辈=chúng ta/lứa chúng ta/thế hệ chúng ta|r
呒啥=không có gì/không sao/không sao hết|r
咋=trách|r
咋们=chúng ta|r
咋样=kiểu gì/trách dạng|r
咋种=trách chủng|r
咱=cha|r
咱们=chúng ta/chúng mình/tôi/bạn|r
咱俩=hai ta|r
咱县=huyện ta|r
咱家=nhà ta/chúng ta|r
哪一位=vị nào/vị kia|r
哪一天=có một ngày/một ngày kia/một ngày nào|r
哪一年=năm nào|r
哪一部=một bộ nào|r
哪个=cái nào/cái kia/người nào/nào/ai/cái nào/cái này/này|r
哪么=như vậy|r
哪事=chuyện kia|r
哪些=những cái nào/những cái kia/nào|r
哪会=làm sao|r
哪会儿=lúc nào/bao giờ/khi nào/bất cứ lúc nào|r
哪位=vị nào/vị kia/vị ấy/vị nào|r
哪儿=chỗ nào/chỗ đó/chỗ/nơi nào/đâu/nơi đó|r
哪国=nước nào/quốc gia nào|r
哪处=chỗ nào/chỗ kia|r
哪天=ngày nào/ngày đó|r
哪家=nhà nào/nhà kia/nhà ai|r
哪年=năm nào|r
哪日=ngày nào|r
哪样=loại nào/thứ nào/thứ gì/bất kì loại nào/dạng kia|r
哪次=lần nào/lần đó|r
哪派=phái nào|r
哪种=loại kia/loại nào|r
哪级=cấp nào|r
哪行=sao được|r
哪裡=ở đâu/na y/cái nào|r
哪边=bên nào/bên kia|r
哪里=nơi nào/chỗ đó/chỗ nào/ở đâu/ở đó/đâu/đâu có/đâu phải|r
啥=xá|r
啥事=chuyện gì|r
啥子=cái gì/thứ gì|r
啥时=lúc nào|r
啥时候=lúc nào/khi nào|r
啥样=dạng gì/dạng gì/xá dạng|r
在么=ở đó không|r
在家=ở nhà/tại gia/có nhà|r
多么=cỡ nào/bao nhiêu/bao xa/biết bao/thật/mấy/dường nào|r
多些=nhiều chút/thật nhiều|r
多妻=nhiều vợ|r
多样=đa dạng/nhiều loại/nhiều kiểu/nhiều vẻ/nhiều mẫu mã|r
多边=nhiều phía/nhiều bên|r
多麼=thế/cỡ nào|r
大中=trung tâm/đại trung|r
大伙儿=mọi người/tất cả mọi người|r
大样=bản in cả trang báo/bản vẽ chi tiết công trình|r
她=tha|r
她们=các nàng/họ/các chị ấy/các cô ấy/các bà ấy|r
她俩=hai nàng|r
她儿=con trai của nàng|r
她家=nhà nàng|r
她的=nàng/của nàng|r
如中=như trúng|r
如人=như người|r
如何=như thế nào/làm sao/thế nào/ra sao|r
如家=như gia|r
如次=như sau/như dưới đây|r
如父=như cha|r
孰=thục|r
它=tha|r
它人=người khác|r
它们=bọn chúng/bọn nó/bọn hắn/bọn họ/chúng/chúng nó/chúng nó|r
它儿=con trai của nó|r
它日=ngày nào đó|r
它物=vật khác|r
它的=nó/khác|r
己身=bản thân|r
彼地=đất kia|r
彼方=phương kia|r
彼时=lúc đó/khi đó|r
彼此=lẫn nhau/đây đó/hai bên/bên này với bên kia/cũng vậy/cũng thế/với nhau|r
彼等=họ/chúng nó|r
怎=chẩm|r
怎么=làm sao/thế nào/như thế/như thế nào/thế nấy|r
怎么样=thế nào/ra làm sao/làm gì/như thế nào|r
怎么着=làm gì/dù thế nào/thế nào|r
怎会=như thế nào/sao|r
怎地=như thế nào/chẩm địa/sao/tại sao/thế nào|r
怎样=như thế nào/thế nào/ra sao|r
怎的=sao/thế nào/ra sao/như thế nào|r
怎麼=thế nào/chẩm ma/thế nào|r
您们=các ngài|r
您儿=con trai ngài|r
您老=ngài/ngài lão/lão gia ngài|r
我人=chúng ta|r
我们=chúng ta/chúng tôi/chúng tao/chúng tớ|r
我俩=hai ta/đôi ta|r
我儿=con ta/hài nhi của ta/con trai của ta|r
我县=huyện ta|r
我国=nước ta/quốc gia của ta/nước tôi|r
我家=nhà ta/nhà của ta|r
我方=bên ta/phe ta|r
我的=ta/của ta|r
我等=chúng ta/ta đợi|r
我辈=chúng ta/đời ta|r
敝=tệ|r
旁人=người bên ngoài/người ngoài/người khác/người bên cạnh|r
旁的=bên cạnh/cái khác/cạnh|r
旁者=kẻ bên cạnh|r
有事=có việc/1.có vấn đề/có chuyện xảy ra/có chuyện|r
有些=có chút/có một số/có/có một ít/hơi/có phần|r
有余=có thừa/có dư/có dôi/có lẻ/trên|r
有年=nhiều năm/lâu năm|r
有方=có cách/có phương pháp|r
有时=có khi/có lúc/thỉnh thoảng|r
有点儿=có chút|r
有种=có loại/có gan/có dũng khí/có khí phách/gan dạ|r
本乡=quê hương/làng này/xã này/đồng hương/cùng quê|r
本书=quyển sách|r
本事=bản sự/bản lĩnh/cốt truyện/câu chuyện thật/truyện nguyên mẫu/bản lãnh/bổn sự|r
本人=bản nhân/bản thân/tôi/tự/tự mình/chính người đó/bổn nhân|r
本位=bản vị/đơn vị tiền tệ gốc/cương vị/nơi làm việc của mình/cơ quan công tác của mình|r
本县=bản huyện|r
本国=bổn quốc/nước nhà/nước mình|r
本地=bản địa/vùng này/trong vùng/đặc sản/bản xứ/bổn địa|r
本城=bản thành/bổn thành|r
本家=bản gia/bổn gia/người trong tộc/người họ nội/Bổn gia|r
本家儿=tự nó/tự anh ta/bản thân anh ta|r
本届=năm nay/đang tiến hành/đang thi đấu/lần này/bổn giới|r
本州=bản châu/Tiểu bang này/Bản Châu/Honshu|r
本我=bản ngã|r
本文=bài này/nguyên văn/bản gốc/bổn văn|r
本方=bản phương/bổn phương|r
本村=bổn thôn|r
本案=bản án/trường hợp này|r
本次=lần này|r
本省=bản tỉnh/bổn tỉnh|r
本科=bản khoa/khoa chính quy|r
本章=tấu chương/sớ/biểu/bổn chương/chương này|r
本篇=bổn thiên|r
本行=nghề chính/nghề lâu dài/sở trường/nghề nghiệp hiện tại|r
本身=bản thân/thân mình/ta/mình/chính mình|r
本轮=lượt này|r
本部=bản bộ/phần quan trọng/cốt lõi/phần trung tâm/bổn bộ|r
本镇=bổn trấn/bản trấn|r
某=mỗ|r
某个=cái nào đó/một cái/một cái nào đó|r
某事=chuyện gì|r
某些=một ít/một số/có chút|r
某人=người nào đó/người khác|r
某位=một vị nào đó/một vị|r
某国=nước nào đó|r
某地=nơi nào đó|r
某城=thành nào đó|r
某处=nơi nào đó/một chỗ|r
某天=ngày nào đó|r
某家=mỗ gia/nhà ta/nhà nào đó|r
某日=ngày nào đó|r
某时=một lúc nào đó|r
某月=tháng nào/tháng nào đó|r
某本=nào đó bản/mỗ vốn|r
某某=mỗ mỗ/một cái gì đó/so-và-như vậy|r
某某某=nào đó nào đó nào đó|r
某校=một trường nào đó|r
某次=một lần nào đó|r
某物=vật gì đó/cái/vật/việc gì đó|r
某种=loại nào đó|r
某间=gian nào đó|r
此举=cử động lần này/động tác này|r
此书=cuốn sách này/sách này|r
此事=việc này/chuyện này|r
此人=người này/cái này người|r
此位=lúc này|r
此刻=giờ phút này/lúc này/bây giờ/giờ đây/ngày nay/hiện nay/giờ khắc này|r
此地=nơi đây|r
此处=nơi đây/nơi này|r
此役=chiến dịch này/trận này|r
此情=tình này|r
此战=trận chiến này|r
此族=tộc này|r
此案=án này|r
此次=lần này|r
此法=pháp này/phương pháp này|r
此物=vật này|r
此瓶=bình này|r
此界=giới này|r
此病=bệnh này|r
此种=loại này|r
此等=như thế/cỡ này|r
此类=loại này|r
此老=lão này|r
此行=chuyến này/việc này|r
此话=lời này/chuyện đó/nói thế/lời ấy|r
此路=đường này|r
此身=thân này|r
此里=trong cái này/trong này|r
此镇=trấn này|r
此门=cửa này/môn này|r
此院=viện này|r
每一=mỗi một|r
每一刻=mỗi một khắc|r
每一处=mỗi một chỗ|r
每一项=mỗi một hạng/mỗi một điều|r
每下=mỗi lần|r
每个=mỗi cái/từng/mỗi|r
每人=mỗi người|r
每份=mỗi bản|r
每周=mỗi tuần|r
每天=mỗi ngày|r
每届=mỗi lần|r
每年=hàng năm/hằng năm/mỗi năm/năm qua|r
每张=mỗi tấm|r
每日=mỗi ngày|r
每晚=mỗi đêm|r
每月=mỗi tháng|r
每次=mỗi lần|r
每班=mỗi ban/mỗi lớp|r
每种=mỗi loại|r
每秒=mỗi giây|r
每间=mỗi gian phòng|r
洒家=ta/ta đây/tớ/sái gia|r
爷们=gia môn/đàn ông/chồng|r
甚么=cái gì/chuyện gì|r
缘何=tại sao/vì sao|r
老么=lão yêu|r
老何=lão Hà|r
老少=già trẻ|r
自个=chính mình/tự mình/tự cái|r
自个儿=bản thân/mình/tự mình|r
自国=nước mình|r
自如=tự nhiên/như thường/thành thạo/thoải mái/tựa như|r
自家=nhà mình/tự/tự mình/bản thân/mình/chính mình|r
自家人=người trong nhà/tự gia nhân|r
自己=mình/chính mình/chính/tự mình/bản thân/nhà|r
自我=bản thân/mình/tự mình/tự ta|r
自此=từ đó|r
自的=mục đích bản thân/mục đích tự nhiên|r
自省=tự xét lại/tự suy ngẫm|r
自行=tự hành/tự mình làm/tự động/tự đi/tự mình|r
自身=tự thân/bản thân/mình/tự mình|r
自里=từ trong|r
若何=như thế nào/thế nào/ra sao|r
该=cai|r
该人=người đó/người trên|r
该县=cai huyện/quận|r
该国=nước nọ/Đế Quốc|r
该地=nơi đó|r
该城=cai thành|r
该处=nơi đó|r
该是=nên là/nên/phải|r
诸事=mọi việc/mọi chuyện|r
诸种=các loại|r
诸般=các loại/nhiều loại/các loại|r
谁=thùy|r
谁个=người nào/đâu|r
谁家=nhà ai|r
谁边=chỗ nào/đâu|r
这=giá|r
这下=lần này/cái này|r
这个=cái này/này/việc này/vật này/quá/rất/cái|r
这么=như thế/như vậy/thế này|r
这么久=lâu như vậy|r
这么些=nhiều như vậy/nhiều ... thế này/ngần này|r
这么晚=muộn như vậy/trễ như thế|r
这么样=như vậy/như thế/thế này|r
这么点儿=ít như vậy/ít thế này/một tí thế này|r
这么着=cứ như vậy/thế này/như thế này/như vậy|r
这乡=xã này|r
这书=sách này|r
这事=việc này/chuyện này|r
这些=những này/những thứ này/những/những ... này/những...này|r
这人=người này|r
这伙=nhóm này|r
这会儿=lúc này/bây giờ/vào lúc này|r
这会所=này hội sở/hội sở này|r
这儿=chỗ này/ở đây/người này/nơi này/lúc này/bây giờ|r
这党=đảng này|r
这刻=thời khắc này/thời gian này/khắc này|r
这周=tuần này|r
这地=đất này|r
这块=khối này|r
这城=thành này|r
这处=chỗ này|r
这天=ngày này/trời này/thiên này/hôm nay|r
这套=bộ này|r
这它=nó đây|r
这家=nhà này|r
这局=ván này|r
这届=giới này/khóa này|r
这年=năm này/năm đó|r
这店=tiệm này|r
这情=tình này|r
这我=ta đây|r
这方=phương này|r
这日=ngày hôm đó|r
这时=lúc này|r
这时候=lúc này/lúc này thời điểm|r
这晚=đêm nay|r
这月=tháng này|r
这本=bản này/đây vốn|r
这村=thôn này|r
这栋=nhà này|r
这样=dạng này/như vậy/như thế/thế này|r
这楼=lầu này|r
这次=lần này|r
这款=cái này|r
这此=lần này|r
这段=đoạn này|r
这点儿=này một ít|r
这片=mảnh này|r
这班=lớp này/ban này|r
这理=nơi này|r
这瓶=bình này/chai này|r
这病=bệnh này|r
这的=cái này/ở đây|r
这着=điều này|r
这种=loại này|r
这章=chương này|r
这笔=khoản này|r
这等=bực này|r
这篇=bản này|r
这类=cái này/loại này|r
这组=nhóm này|r
这股=cỗ này/này cỗ|r
这般=như vậy|r
这药=thuốc này|r
这行=dòng này/nghề này|r
这话=lời này|r
这路=đường này|r
这车=xe này|r
这辈=đời này|r
这边=bên này|r
这部=bộ này|r
这里=nơi này/tại đây/ở đây/nơi đây|r
这门=môn này/cửa này|r
这间=căn này/gian phòng này|r
这院=viện này|r
这项=cái này|r
这餐=bữa ăn này|r
這=giá|r
那=na|r
那一刻=một khắc này/một khắc kia/một khắc đó|r
那个=cái kia/cái nào/cái đó/cái ấy/việc ấy/ghê lắm/ấy|r
那么=như vậy/thế đấy/như thế/như thế nào|r
那么些=nhiều như vậy|r
那么点儿=ít như vậy/một chút/chừng ấy/một tí tẹo/một chút như thế|r
那些=những cái kia/những cái nào|r
那他=vậy hắn|r
那伙=đám kia|r
那会=vậy sẽ/nào sẽ/vậy biết/lúc đó/biết được/na hội/nào biết|r
那会儿=lúc ấy/lúc bấy giờ/khi đó/hồi đó|r
那位=vị kia/vị nào|r
那儿=chỗ ấy/chỗ/nơi nào/lúc ấy/chỗ ấy/nơi ấy/bấy giờ/Na nhi|r
那刻=thời khắc đó/thời gian đó/lúc đó/khắc kia|r
那双=cặp kia|r
那啥=cái kia/ừm|r
那团=đoàn kia|r
那块=khối kia/khối nào|r
那天=ngày đó/ngày nào/thiên kia/trời kia/bầu trời kia/cái kia thiên|r
那它=vậy nó|r
那家伙=tên kia/tên nào|r
那幅=bức kia|r
那年=năm đó/năm ấy|r
那店=tiệm kia|r
那日=ngày ấy/ngày nào/hôm đó|r
那时=khi đó|r
那晚=đêm đó|r
那株=gốc kia/gốc cây kia|r
那样=như thế/dạng kia/như vậy/thế|r
那楼=lầu đó|r
那次=lần kia/lần nào/nọ/lần đó|r
那段=đoạn kia/đoạn đó|r
那物=vật kia|r
那种=loại kia/loại nào/cái loại này/cái loại đó/cái loại này|r
那笔=bút kia|r
那等=loại kia/vậy chờ/cấp độ kia/kia chờ|r
那篇=thiên kia/thiên nào|r
那类=loại này|r
那般=như vậy/vậy/như thế nào|r
那药=thuốc kia|r
那行=vậy được|r
那话=lời kia|r
那路=đường kia|r
那边=bên kia/bên nào|r
那里=nơi đó/nơi nào/chỗ đó/đó/chỗ ấy/nơi ấy|r
那门=môn kia/cánh cửa kia/cửa kia|r
那门儿=môn kia|r
那麼=như thế/vậy|r
鄙人=bỉ nhân/kẻ hèn này/kẻ hèn|r
鄙国=bỉ quốc|r
