一中=một trung/nhất trung/lớp 10/vừa trúng|s
一旁=một bên/bên cạnh|s
不远处=cách đó không xa|s
世上=trên đời/trong xã hội|s
世外=thế ngoại|s
东壁=Đông Bích|s
东头=đầu đông|s
东岸=bờ đông|s
东方=phương đông/đông phương/họ Đông Phương/phía đông/Phương Đông/Châu Á/Đông Phương|s
东起=đông khởi|s
东边=phía đông/đông/hướng đông|s
东郊=Đông Giao/ngoại thành phía đông|s
东门外=ngoài cửa đông|s
乡上=xã trên|s
乡下=nông thôn/ở nông thôn/ở quê/hương hạ|s
乡内=trong thôn|s
乡里=trong thôn/quê nhà/người cùng quê/người đồng hương/hương lý|s
书上=trên sách/trong sách|s
书中=trong sách|s
书内=trong sách|s
井上=bờ giếng|s
井下=dưới giếng/xuống giếng|s
井中=trong giếng|s
井内=trong giếng|s
井壁=vách giếng|s
井底=đáy giếng|s
井旁=bên giếng|s
井边=bên cạnh giếng|s
井里=trong giếng/tỉnh lý|s
体中=trong cơ thể|s
体内=thể nội/trong cơ thể|s
体外=bên ngoài cơ thể|s
体里=trong cơ thể|s
党内=trong đảng|s
兜中=trong túi quần|s
兜内=trong túi quần/trong túi|s
兜底=lật tẩy/vạch mặt/phơi bày mặt trái|s
兜里=trong túi/trong túi quần|s
关上=đóng lại/đóng cửa/thốn khẩu/mạch cổ tay/nhốt lại|s
关中=Quan Trung|s
关内=quan nội|s
关外=quan ngoại|s
内外=trong ngoài/nội ngoại/trong và ngoài/độ/khoảng chừng/trong vòng|s
内里=bên trong/nội bộ|s
军中=trong quân|s
军内=trong quân|s
军里=trong quân|s
前沿=tuyến đầu|s
区内=trong vùng/trong khu vực|s
半中=giữa chừng|s
半内=giữa chừng|s
半边=nửa bên/bên/phía/phần/bên cạnh/cạnh|s
半途中=trên nửa đường|s
口上=trên miệng|s
口中=trong miệng/trong miệng|s
口内=trong miệng/trong miệng|s
口前=trước mồm|s
口外=Khẩu Bắc/bên ngoài miệng|s
口岸=bến cảng/cảng/bến tàu/khẩu ngạn|s
口边=bên miệng|s
口里=trong miệng|s
台上=trên đài|s
台下=dưới đài|s
台内=giữa đài|s
台前=trước sân khấu/trước đài/thai tiền/đều là theo cái nghĩa đó|s
台后=sau đài|s
台边=bên bàn/bên đài|s
嘴上=ngoài miệng|s
嘴中=trong miệng|s
嘴内=trong miệng|s
嘴前=trước miệng|s
嘴头=miệng|s
嘴岔=khéo miệng|s
嘴边=bên miệng/bên mép/mép|s
嘴里=miệng/trong miệng|s
囊中=trong túi|s
囊内=trong túi|s
囊里=trong túi|s
园中=trong vườn|s
园内=bên trong vườn|s
园外=viên ngoại|s
园里=trong vườn/trong viên|s
国上=quốc thượng|s
国中=quốc trung/nước bên trong/trong nước|s
国内=trong nước/quốc nội|s
国内外=trong ngoài nước|s
国外=nước ngoài/ngoài nước|s
国里=trong nước|s
地上=trên mặt đất/trên đất|s
地下=dưới mặt đất/trong bóng tối/ngầm/trong lòng đất/dưới đất/bí mật/không công khai/trên mặt đất/lòng đất|s
地内=trong đất|s
地处=chỗ/vị trí|s
地外=địa ngoại|s
地底下=dưới nền đất/dưới lòng đất|s
地里=trong đất|s
场上=trên trận/trên sân|s
场下=dưới trận|s
场中=giữa sân/trong tràng/tràng trung/giữa trường/trường bên trong|s
场内=trong tràng/tràng nội/trong sân|s
场地=sân bãi/nơi sân/nơi chốn|s
场外=bên ngoài sân/bên ngoài tràng/ngoài sân|s
场边=bên sân|s
场里=trong tràng/giữa trường|s
坝上=trên đê/trên đập|s
城上=trên thành|s
城下=dưới thành/bên dưới thành|s
城中=trong thành|s
城内=thành nội/nội thành/bên trong thành/trong thành|s
城前=trước thành|s
城北=thành bắc|s
城外=ngoài thành/bên ngoài thành|s
城旁=bên cạnh thành|s
城边=bên cạnh thành|s
城郊=ngoại ô/ngoại thành|s
城里=trong thành/nội thành|s
域内=vực nội|s
域外=vực ngoại|s
堤上=trên đê|s
堤岸=con đê/NGẠN/đê/Chợ Lớn/đê ngạn/bờ đê|s
塞下=tắc hạ|s
塞外=tái ngoại/phía Bắc Trường Thành|s
境内=cảnh nội|s
境地=hoàn cảnh/tình trạng/cảnh ngộ/tình huống/tình cảnh|s
境外=ngoại cảnh|s
墙上=trên tường|s
墙下=dưới tường/chân tường|s
墙内=trong tường|s
墙后=sau tường|s
墙壁=vách tường/tường/bức tường|s
墙外=ngoài tường|s
墙头=đầu tường/mái tường/chóp tường/tường bao quanh|s
墙角处=góc tường|s
墙边=bên tường|s
墙里=trong tường|s
壁上=trên vách/trên vách đá|s
壁下=dưới vách đá|s
壁中=trong vách|s
壁里=trong vách|s
外沿=rìa ngoài|s
天上=trên trời/không trung/bầu trời|s
天下=thiên hạ/thế giới/quyền thống trị của nhà nước|s
天外=thiên ngoại/ngoài bầu trời/xa xôi/cao xa|s
天底下=trên đời này/trên thế giới/dưới đời này/trên đời|s
天边=chân trời/xa vời/nơi xa xôi|s
头上=trên đầu|s
头中=trong đầu|s
头内=trong đầu|s
头处=nơi cuối|s
头里=trước/phía trước/trước đó/trước đây/trước kia|s
室中=trong phòng|s
室内=trong phòng/bên trong/bên trong phòng|s
室外=bên ngoài/bên ngoài phòng|s
室里=trong phòng|s
宫中=cung trong/trong cung/trong nội cung|s
宫内=cung nội/cung trong/trong cung/trong nội cung|s
宫外=ngoài cung/phía ngoài cung/bên ngoài cung|s
宫里=trong cung/cung trong/trong nội cung|s
家中=trong nhà|s
家内=trong nhà|s
家底=vốn liếng/của cải/gia sản/gia cơ/vốn tích luỹ|s
家方=gia phương|s
家里=trong nhà/trong/cả nhà/trong gia đình/bà xã/bà nhà/vợ/đơn vị tôi/nhà|s
家门口=cửa nhà|s
对内=đối nội|s
对外=đối ngoại|s
寺中=trong chùa|s
寺内=trong chùa/bên trong chùa|s
寺外=bên ngoài chùa|s
寺里=trong chùa|s
屋中=trong phòng|s
屋內=bên trong phòng|s
屋内=trong phòng/phòng trong/bên trong nhà|s
屋后=sau phòng/sau nhà|s
屋外=ngoài phòng|s
屋边=bên phòng|s
屋里=trong phòng|s
山上=trên núi|s
山下=dưới núi/dưới chân núi/chân núi/bên dưới ngọn núi|s
山中=trong núi|s
山内=trong núi/trên núi/trong ngọn núi|s
山前=trước núi|s
山旁=bên cạnh ngọn núi|s
山脚下=chân núi/dưới chân núi|s
山边=bên cạnh ngọn núi|s
山里=trên núi/ngọn núi/trong núi/trong ngọn núi|s
岛上=ở trên đảo/trên đảo|s
岛下=dưới đảo|s
岛中=trong đảo|s
岛内=trong đảo|s
岛里=trong đảo|s
岭内=Lĩnh Nội|s
岭北=Lĩnh Bắc|s
岭外=Lĩnh Ngoại|s
岸上=trên bờ|s
岸下=dưới bờ|s
岸壁=bờ tường|s
岸头=bên bờ sông|s
岸旁=cạnh bờ/bên bờ|s
岸线=khu bờ sông/khu cảng/bến tàu|s
岸边=bên bờ/bên cạnh bờ|s
崖上=trên sườn núi/nhai thượng|s
崖内=trong vách núi|s
崖外=ngoài vách núi|s
崖岸=nhai ngạn/cũng cùng một ý cao cả|s
崖旁=bên cạnh vách núi|s
崖边=vách đá/bên cạnh vách núi|s
崖里=trong vách núi|s
巷中=ngõ hẻm trong|s
巷内=ngõ hẻm trong|s
巷口=cửa ngõ/đầu hẻm|s
巷外=phía ngoài hẻm|s
巷角里=trong góc ngõ|s
巷里=trong ngõ/ngõ hẻm trong|s
市上=trên chợ|s
市中=thành thị/khu phố|s
市内=trong thành phố|s
市郊=ngoại ô thành phố/ngoại ô|s
市里=dặm/thành phố/trong thành phố|s
幕后=phía sau màn/hậu trường/hậu đài/hậu trường|s
当中=ở trong/trong đó/chính giữa/ở giữa/trong/trong khi/bên trong|s
当地=nơi đó/bản xứ/đương địa/đương/địa phương/bản địa|s
当场=tại chỗ/ngay tại chỗ/ngay tại trận|s
当头=vào đầu/phủ đầu/lên đầu/rơi xuống/ập xuống/đứng đầu/hàng đầu/đi đầu/bậc nhất/phủ xuống/đồ thế chấp/vật thế chấp/đương đầu|s
当空=giữa trời/nhô lên cao/trên không/trên trời|s
当街=bên đường/sát đường/trông ra đường/trên đường/trên đường phố/ngoài đường phố|s
心上=trong lòng|s
心中=trong lòng/trong nội tâm|s
心内=trong nội tâm/trong lòng|s
心口=tim/trong ngực/ngực/trong lòng|s
心地=tâm địa/tấm lòng/lòng dạ/tâm tình/nỗi lòng|s
心境=tâm cảnh/tâm tình/cõi lòng/trong lòng|s
心处=trung tâm|s
心头=trong lòng|s
心底=đáy lòng/lòng dạ/dụng tâm|s
心海中=trong tâm hải|s
心空=Tâm Không|s
心里=trong lòng/trong nội tâm/ngực/trong tư tưởng/trong đầu/trong bụng/tâm lý|s
怀上=mang thai/có bầu|s
怀中=trong ngực/trong lòng/ngực|s
怀内=trong ngực/trong áo|s
怀里=trong ngực/trong lòng/ngực/trong lồng ngực|s
户外=ngoài trời/bên ngoài|s
房上=trên phòng|s
房中=trong phòng|s
房前=trước phòng|s
房处=phòng xử|s
房里=trong phòng|s
手上=trên tay|s
手下=thủ hạ/dưới tay|s
手中=trong tay|s
手内=trong tay|s
手底下=dưới tay/thuộc hạ/người dưới quyền|s
手裡=trong tay|s
手起=tay nâng|s
手边=trong tay/trong tầm tay/bên tay|s
手里=trong tay|s
摊下=dưới quán|s
摊前=trước sạp|s
暗内=trong bóng tối|s
暗地里=vụng trộm/ngầm/thầm/lén/trong bụng/sau lưng/rón rén/lén lút/thầm kín/trong thâm tâm/trong tối|s
暗里=ngầm/kín/bí mật/lén/trong lòng/trong thâm tâm/trong tối|s
最前沿=tuyến ngoài cùng/tuyến đầu tiên|s
村内=trong thôn|s
村外=ngoài thôn|s
村里=trong thôn|s
杯中=trong chén|s
杯内=trong chén|s
杯里=trong chén|s
枕上=trên gối|s
枕下=dưới gối|s
枕中=trong gối|s
枕内=trong gối|s
枕边=bên gối|s
枕里=trong gối|s
林下=nơi ở ẩn|s
林中=trong rừng|s
林内=trong rừng|s
林外=ngoài rừng|s
林边=bên rừng/bìa rừng|s
林里=trong rừng|s
架上=trên kệ|s
架空=giá không/vô căn cứ/mất quyền lực/gác trên không/gác trên cao/không có cơ sở/không tưởng/không thể thực hiện được/cho đi tàu bay giấy|s
架起=dựng lên/nhấc lên|s
柜上=cửa hàng/quầy|s
柜中=trong tủ/trong quầy|s
柜内=trong tủ/trong quầy|s
树上=trên cây|s
树前=trước cây|s
树旁=bên cây|s
树起=dựng lên|s
树边=bên cây|s
校中=trong trường|s
校内=trong trường|s
校外=ra ngoài trường|s
校里=trong trường|s
桌上=trên bàn|s
桌下=dưới bàn|s
桌中=trong bàn|s
桌侧=bên bàn|s
桌内=trong bàn|s
桌前=trước bàn|s
桌后=sau cái bàn|s
桌底=đáy bàn|s
桌旁=bên cạnh bàn|s
桌沿=mép bàn|s
桌角上=góc bàn|s
桌边=bên cạnh bàn|s
桌里=trong bàn|s
桥上=trên cầu|s
桥下=dưới cầu|s
桥堍=đầu cầu|s
桥底=gầm cầu|s
桥旁=cạnh cầu|s
桥边=bên cạnh cây cầu|s
棚中=trong rạp|s
棚内=trong rạp|s
棚外=bền ngoài lán/bên ngoài rạp|s
棚里=trong rạp/bằng lý|s
楼上=trên lầu|s
楼下=dưới lầu/lầu dưới|s
楼中=trong lầu|s
楼内=trong lâu/trong lầu/bên trong lầu|s
楼前=trước lầu|s
楼底=dưới lầu|s
楼底下=dưới lầu|s
楼空=nhà trống/lầu trống|s
楼门口=cửa lầu|s
殿上=trên điện|s
殿下=điện hạ/thái tử/hoàng tử|s
殿中=trong điện|s
殿内=trong điện|s
殿前=trước điện|s
殿后=bọc hậu/sau điện/đi đoạn hậu/đi sau cùng/điện hậu|s
殿外=ngoài điện|s
殿里=trong điện|s
水上=trên nước/thủy thượng|s
水下=dưới nước|s
水中=trong nước|s
水内=trong nước|s
水南=Thủy Nam|s
水边=mép nước/bờ nước|s
江上=trên sông/giang thượng|s
江内=trong nước/trong sông|s
江岸=bờ sông|s
江沿=Giang Duyên|s
江边=bờ sông|s
池内=trong ao/bên trong ao|s
池边=bên cạnh ao|s
池里=trong ao|s
沟中=trong khe|s
沟内=trong khe|s
沟里=trong rãnh/trong khe|s
河上=trên sông|s
河内=trong sông/Hà Nội/TP Hà Nội/thủ đô Hà Nội|s
河处=nơi nào|s
河外=ngoài thiên hà|s
河岸=bờ sông|s
河沿=ven sông|s
河边=bờ sông/ven sông|s
海上=trên biển|s
海下=dưới biển|s
海内=trong nước/đất liền/bốn biển/bốn bể/trong biển|s
海北=biển bắc/Hải Bắc/Quận tự trị Haibei của Tây Tạng ở Thanh Hải|s
海口=cửa biển/hải khẩu/cảng biển/bến cảng/nói khoác/nói phách/nói thách/ba hoa khoác lác|s
海地=dưới biển/Ha-i-ti/Haiti|s
海外=hải ngoại/ngoài nước/ở nước ngoài|s
海岸=bờ biển/hải ngạn|s
海底=đáy biển|s
海空=hải không|s
海边=bờ biển/cạnh biển|s
海里=trong biển/hải lý|s
海陆=hải lục|s
深处=chỗ sâu/ở chỗ sâu trong/ở trong chỗ sâu/nơi sâu xa|s
深空=thâm không|s
湖上=trên hồ|s
湖下=dưới hồ|s
湖中=trong hồ|s
湖内=trong hồ|s
湖前=trước hồ|s
湖岸=bờ hồ|s
湖旁=bên hồ/cạnh hồ nước|s
湖边=bên hồ|s
湖里=trong hồ|s
溪内=trong suối|s
溪旁=cạnh suối|s
溪边=bên dòng suối/bên dòng suối|s
溪里=trong suối|s
炉前=trước lò|s
炉里=trong lò|s
炕上=trên giường/trên giường gạch/kháng thượng|s
炕下=dưới giường gạch|s
片中=trong phim|s
片内=trong phim|s
狱中=trong ngục/trong tù|s
狱内=trong ngục|s
狱里=trong ngục|s
班上=lớp học/trong lớp|s
班中=trong ban|s
班内=trong ban/bên trong lớp/trong lớp|s
班里=trong lớp/trong ban|s
田内=trong ruộng|s
田里=trong ruộng/bên trong ruộng/điền lý|s
界外=giới ngoại|s
盘中=trong mâm|s
盘内=trong mâm|s
盘里=trong mâm/đĩa|s
省上=giảm bớt|s
省内=trong tỉnh/tỉnh bên trong|s
省外=bên ngoài tỉnh|s
省里=trong tỉnh/tỉnh lý|s
眉前=trước lông mày|s
眼中=trong mắt|s
眼内=trong mắt/bên trong mắt|s
眼底下=tầm mắt/tận mắt/trước mắt|s
眼里=trong mắt|s
空中=không trung/bầu trời/trên không/thông tin|s
空内=trong không gian|s
空前=chưa từng có/hơn bao giờ hết/trước đây không có|s
空里=trong không gian|s
窗上=trên cửa/trên cửa sổ|s
窗下=dưới cửa/dưới cửa sổ|s
窗前=phía trước cửa sổ/trước cửa sổ|s
窗口=cửa sổ/trước cửa sổ/cửa bán vé/cửa xoay/cửa chắn/cửa xép|s
窗后=sau cửa sổ|s
窗处=nơi cửa sổ|s
窗外=ngoài cửa sổ|s
窗沿=bệ cửa sổ|s
窗边=bên cửa sổ|s
窗里=bên cửa|s
站上=đứng lên/trạm bên trên|s
站中=đứng ở giữa|s
站内=đứng ở giữa|s
站里=đứng ở giữa|s
箱中=trong rương|s
箱内=trong rương|s
箱里=trong rương|s
篮上=trên rổ|s
篮中=trong rổ|s
篮内=trong rổ|s
篮里=trong rổ|s
线上=tuyến thượng/trực tuyến/Tuyến|s
网上=trên mạng/online/trên web/internet|s
网中=trong lưới|s
网内=trong lưới|s
网底=đáy lưới|s
网路上=trên mạng|s
网里=trong lưới|s
耳中=trong tai|s
耳内=trong tai/truyền vào tai/trong lỗ tai|s
耳后=sau tai|s
耳旁=bên tai|s
耳边=bên tai|s
耳里=trong tai|s
肩上=trên vai|s
肩下=dưới vai|s
肩处=bả vai|s
肩起=đặt trên vai/mang trên vai|s
胸上=trên ngực|s
胸下=dưới ngực|s
胸中=trong ngực/trong lồng ngực|s
胸内=trong lồng ngực|s
胸前=trước ngực|s
胸口=ngực/ở ngực|s
胸里=trong lồng ngực/trong ngực|s
脸上=trên mặt|s
脸下=dưới mặt|s
脸前=trước mặt|s
脸边=bên mặt|s
腋上=trên nách|s
腋下=dưới nách|s
腕上=trên cổ tay|s
腕下=dưới cổ tay|s
腹上=trên bụng|s
腹中=trong bụng/bụng trúng|s
腹内=trong bụng|s
腹里=trong bụng/phúc lý|s
舱中=trong khoang thuyền|s
舱内=trong khoang thuyền/bên trong khoang thuyền/trong khoang|s
舱口=cửa hầm/cửa sập/cửa xuống hầm|s
舱壁=vách khoang|s
舱外=bên ngoài khoang thuyền|s
舱里=trong khoang thuyền|s
舱门口=cửa khoang|s
船上=trên thuyền|s
船下=dưới thuyền|s
船中=trong thuyền|s
船内=trong thuyền/bên trong thuyền|s
船前=trước thuyền|s
船底=đáy thuyền|s
船里=trong thuyền|s
营中=trong doanh/trong doanh trại|s
营内=trong doanh|s
营里=trong doanh trại|s
藏内=núp bên trong|s
藏处=chỗ giấu|s
藏里=núp bên trong|s
街上=trên đường/đường phố|s
街下=dưới đường|s
街中=giữa đường|s
街内=giữa đường|s
街区=quảng trường/khu vực giữa bốn con đường/nhai khu|s
街口=đầu phố|s
街后=sau phố|s
街头=đầu đường/đầu phố/trên phố|s
街边=bên đường/bên cạnh/rìa đường|s
街里=giữa đường|s
街间=giữa đường|s
袋中=trong túi|s
袋内=trong túi/bên trong túi|s
袋口=miệng túi|s
袋里=trong túi|s
西北郊=ngoại ô tây bắc|s
西头=đầu tây|s
西岸=bờ tây|s
西方=phương tây/tây phương/Tây Phương/phía tây|s
西海岸=bờ biển Tây|s
西线=tây tuyến|s
西边=phía tây/hướng tây|s
西郊=tây ngoại ô/vùng ngoại ô phía tây|s
路上=trên đường/dọc đường/trên đường đi|s
路下=dưới đường|s
路中=giữa đường/giữa lộ|s
路内=giữa lộ|s
路南=lộ nam|s
路口=giao lộ/lộ khẩu/đường giao/đầu đường|s
路旁=bên đường|s
路边=ven đường|s
路里=giữa lộ|s
身上=trên thân/trên người/trên mình/bên mình/trong người|s
身下=dưới thân/dưới người|s
身中=thân trúng|s
身处=thân ở|s
身外=ngoài thân|s
身旁=bên cạnh/bên người|s
身边=bên người/bên cạnh/bên mình/trong người|s
车上=trên xe|s
车下=dưới xe|s
车前=trước xe/cỏ xa tiền|s
车旁=bên cạnh xe|s
车边=bên cạnh xe|s
车里=trong xe|s
辖下=địa bàn quản lý|s
边上=bên cạnh|s
边旁=bên cạnh|s
边沿=vùng ven/bên bờ/ven/rìa/mép/biên cương/bờ|s
边疆=biên cương/bờ cõi/biên thuỳ|s
边陲=biên thuỳ/biên cương/biên giới/vùng sát biên giới/biên thùy|s
近地=gần đất/gần xung quanh|s
近处=chỗ gần/gần bên/ở gần|s
近岸=gần bờ|s
近旁=bên cạnh/ở gần|s
近郊=vùng ngoại thành/ngoại ô|s
远处=nơi xa/xa xa/viễn xứ/phương xa|s
远方=phương xa/viễn phương/nơi xa/viễn xứ|s
远空=viễn không|s
远郊=ngoại thành/ngoại ô|s
途中=trên đường|s
道上=trên đường|s
道内=đạo nội|s
道外=đạo ngoại|s
道旁=bên đường/đạo bên cạnh/đạo bàng/bên cạnh đường|s
道里=chặng đường/lộ trình/đạo lý|s
遠方=nơi xa|s
郊区=vùng ngoại thành/vùng ngoại ô/khu vực ngoại thành/ngoại ô|s
郊外=vùng ngoại ô/vùng ngoại thành/khu vực ngoại thành/ngoại ô|s
野外=dã ngoại/thôn quê|s
门上=trên cửa/trong môn|s
门下=môn hạ/môn khách/học trò/môn đệ|s
门侧=bên cửa|s
门内=trong cửa/trong môn/bên trong cánh cửa/trong môn phái|s
门前=trước cửa|s
门口=cổng/cửa ra vào/cửa|s
门外=ngoài cửa/ngoài môn|s
门旁=bên cạnh cửa/bên cạnh/bên/cạnh - cửa|s
门边=cạnh cửa|s
门里=trong môn/trong cửa/trong môn phái|s
阵中=trong trận|s
阵内=trong trận|s
阵前=trước trận/trận tiền|s
阵外=ngoài trận|s
陆上=trên lục địa/lục thượng|s
陆岸=Lục Ngạn|s
院中=trong viện/trong nội viện/trong sân|s
院内=trong viện/trong nội viện/bên trong viện/trong sân|s
院前=trước viện|s
院外=ngoài viện/bên ngoài viện/ngoài sân|s
隔壁=sát vách/bên cạnh/bên cạnh/láng giềng/hàng xóm sát vách/nhà bên cạnh/cách vách|s
隔外=không thân/xem như người ngoài/khác/ngoài ra|s
隔岸=cách bờ|s
隔街=cách con đường|s
零上=trên 0|s
面里=trong mì|s
颅内=trong đầu|s
颅底=cái cằm|s
颈上=trên cổ|s
颈中=giữa cổ|s
颈边=bên cổ|s
高中=cao trung/cao trúng/trường trung học bậc cao đẳng/trung học đệ nhị cấp/trường cấp 3|s
鼻内=trong mũi|s
鼻前=trước mũi|s
