一上午=cho tới trưa/vừa giữa trưa|t
一世=một thế/đệ nhất/một đời/cả đời/một thời/một thời kỳ/nhất thế|t
一元化=nhất nguyên hoá/tập trung thống nhất|t
一刹那=một sát na/trong tích tắc/trong nháy mắt/trong một sát na|t
一去=vừa đi/đi một lần|t
一启=mở ra|t
一夕=một buổi|t
一夜间=trong vòng một đêm|t
一时半晌=nhất thời bán hội/một chút|t
一时间=trong lúc nhất thời|t
一更=canh một/một canh|t
一月底=cuối tháng một|t
一朝=một khi/mai kia/một buổi sáng/một mai/một triều|t
一清早=sáng sớm/sớm tinh sương/mới hừng sáng|t
一瞬=một cái chớp mắt/trong nháy mắt/phút chốc/nháy mắt|t
一霎=một sát na/một chốc/một lát/một thoáng|t
一霎时=một lát|t
一霎眼=trong nháy mắt|t
一霎那=một sát na|t
一霎间=một chốc|t
七代=đời bảy/bảy đời/thất đại|t
七叶=Thất Diệp|t
七夕=đêm thất tịch/thất tịch|t
七夕节=tết Thất Tịch|t
七夜=bảy đêm/[Thất Dạ]/Thất Dạ/7 đêm|t
七天=bảy ngày/bảy ngày|t
七日=bảy ngày/bảy ngày|t
七旬=thất tuần|t
七时=7h|t
七更=bảy chương|t
七月=tháng bảy/bảy tháng|t
七石半=bảy thạch rưỡi|t
七节=bảy đốt|t
七间=bảy gian|t
万代=muôn đời/vạn đời|t
万初=Vạn Sơ|t
万年前=vạn năm trước|t
万年历=lịch vạn niên/lịch thế kỷ|t
三代=đời thứ ba/ba đời/tam đại/đệ tam|t
三伏天=tiết trời đầu hạ|t
三休日=ba ngày nghỉ|t
三冬=mùa đông/ba tháng mùa đông/ba đông/ba năm|t
三叠纪=kỷ Tam Điệp/kỉ Tam Điệp|t
三宋=tam tống|t
三才=tam tài|t
三日=ba ngày|t
三更=ba canh/canh ba/Canh 3|t
三月初=đầu tháng ba|t
三月底=cuối tháng ba/cuối tháng 3|t
三月末=cuối tháng ba|t
三来=thứ ba|t
三清=Tam Thanh|t
三秋=tam thu/ba tháng mùa thu/tháng 9 âm lịch/ba năm/ba thu|t
上一年=một năm trước|t
上上个月=tháng trước nữa|t
上个世纪=thế kỷ trước|t
上个星期=vào tuần lễ trước/tuần lễ trước|t
上个月=tháng trước|t
上九=thượng cửu/hơn chín|t
上代=đời trước/thế hệ trước|t
上元节=tết Thượng Nguyên/tết Nguyên Tiêu|t
上前=tiến lên|t
上午=buổi sáng|t
上半=trên nửa/hơn nửa|t
上半夜=nửa đêm trước/nửa đêm đầu/quá nửa đêm|t
上半天=hơn nửa ngày/buổi sáng|t
上半年=hơn nửa năm|t
上去=đi lên/đi tới/lên/ra|t
上古时代=thời đại thượng cổ|t
上周=đầu tuần/tuần trước|t
上夜=trực đêm/gác đêm|t
上天=thượng thiên/lên trời/phóng lên trời/lên thiên đàng/chầu trời/ông trời/trời/trời cao|t
上季=quý trước|t
上年=năm ngoái|t
上旬=thượng tuần|t
上月=tháng trước|t
上朝=vào triều/thượng triều/vào chầu/lên triều|t
上来=đi lên/bắt đầu/khởi đầu/trên đây/đến/được/rồi/tới|t
上次=lần trước|t
上清天=Thượng Thanh Thiên|t
下一代=đời sau/đời kế tiếp|t
下个世纪=thế kỷ tiếp theo|t
下个周=tuần sau|t
下个星期=tuần sau|t
下个月=tháng sau|t
下代=đời sau|t
下午=buổi chiều|t
下半夜=nửa đêm về sáng/nửa đêm sau/quá nửa đêm|t
下半年=sáu tháng cuối năm/cuối năm/nửa năm sau/nửa cuối năm|t
下半月=nửa tháng sau|t
下半生=nửa đời sau/nửa cuối cuộc đời|t
下去=xuống dưới/đi xuống/xuống/tiếp/thêm|t
下启=khởi đầu|t
下周=cuối tuần/tuần sau|t
下旬=hạ tuần|t
下星期=tuần sau|t
下晚儿=chập tối|t
下月初=đầu tháng sau|t
下期=lần tới/kỳ tiếp theo/Lần sau/kì sau|t
下来=xuống tới/xuống/lại/tiếp/hạ xuống|t
下次=lần sau|t
下里=phía/hướng|t
不久前=trước đây không lâu/không lâu/vừa mới|t
不周=không chu toàn/không chu đáo/không hoàn hảo/không đầy đủ/bất chu|t
不夜天=Bất Dạ Thiên|t
丑时=giờ sửu|t
世代=thế hệ/đời đời/thời đại/nhiều thế hệ/đời/mấy đời/thế đại|t
世纪末=thời kì cuối/thời kì suy tàn của một xã hội/cuối thế kỷ|t
东去=đi về hướng đông|t
东周=Đông Chu|t
东晋=Đông Tấn|t
东月=Đông Nguyệt|t
东来=đông lai/đi về đông|t
东汉=Đông Hán|t
东魏=Đông Nguỵ|t
两宋=Lưỡng Tống/đề cập đến phương Bắc|t
两晚=hai đêm/hai tối|t
中元节=tết Trung Nguyên|t
中午=giữa trưa/buổi trưa/đứng bóng|t
中古时代=thời đại trung cổ|t
中叶=trung kỳ/thời kỳ giữa/khoảng giữa|t
中夜=trung dạ/nửa đêm|t
中年=trung niên|t
中旬=trung tuần|t
中暑=bị cảm nắng/bị trúng nắng/bệnh cảm nắng/trúng thử/bị phải nắng|t
中期=trung kỳ/giai đoạn giữa/thời kỳ giữa/giữa/trung hạn|t
中生代=đời trung niên|t
中秋=Trung thu|t
中秋节=tết Trung thu|t
九世=cửu thế|t
九五=cửu ngũ/ngôi vua|t
九代=chín đời/cửu đại|t
九叶=Cửu Diệp|t
九夜=chín đêm|t
九天=cửu thiên/chín ngày/chín tầng trời/thiên cung/chín tầng mây|t
九宵=cửu tiêu|t
九年=chín năm/chín năm|t
九日=chín ngày/chín ngày|t
九旬=cửu tuần|t
九月=tháng chín/chín tháng|t
九月初=đầu tháng chín|t
九月底=cuối tháng chín|t
九月末=cuối tháng chín|t
九清=Cửu Thanh|t
九秋=cửu thu/Cửu Thu|t
九间=chín gian|t
乾天=càn thiên|t
事前=trước đó/trước khi xảy ra sự việc|t
事后=sau đó/sau/sau khi sự việc xảy ra|t
二代=đời thứ hai/nhị đại/hai đời/đệ nhị|t
二去=ngoại trừ|t
二叠纪=kỷ nhị điệp/kỷ péc-mi|t
二日=hai ngày|t
二更=canh hai|t
二朝=hai triều|t
二来=thứ hai|t
五代=đời thứ năm/năm đời/ngũ đại/thời Ngũ Đại|t
五天=năm ngày|t
五常=ngũ thường/năm ấy là năm đạo thường của người lúc nào cũng phải có không thể thiếu được|t
五年=năm năm|t
五日=năm ngày|t
五旬=ngũ tuần/năm mươi tuổi|t
五更=canh năm/năm canh/Canh 5|t
五月=tháng năm/năm tháng|t
五月天=ngày tháng năm/Ngày tháng 5/Ngũ nguyệt thiên|t
五月节=tiết Đoan Ngọ|t
五间=năm gian|t
交午=trưa/buổi trưa/đến trưa/ngang dọc/đan xen|t
亥伯=Hyperion|t
亥时=giờ Hợi/giờ hợi|t
亥猪=Hợi Trư|t
今上=kim thượng/Vua đang tại vị.|t
今不如昔=nay không bằng xưa|t
今世=đương thời/kiếp này/kiếp/tuổi này/đương đại/đời này|t
今个=bây giờ|t
今儿=hôm nay/ngày hôm nay|t
今儿个=ngày hôm nay|t
今午=trưa nay/buổi trưa hôm nay|t
今古=kim cổ/Kim Cổ|t
今后=sau này/về sau/từ nay về sau|t
今夕=chiều nay|t
今夜=tối nay|t
今天=hôm nay/ngày hôm nay/hiện tại/trước mắt/kim thiên|t
今季=quý này|t
今宵=đêm nay|t
今岁=năm nay/năm này|t
今年=năm nay|t
今年初=đầu năm nay|t
今年年初=đầu năm nay|t
今年年底=cuối năm nay|t
今文=thể chữ Lệ|t
今日=hôm nay/ngày hôm nay|t
今早=sáng nay|t
今时=thời nay/lúc này|t
今明=nay mai|t
今昔=xưa nay/xưa và ngay/cổ và kim/hiện tại và quá khứ|t
今晚=đêm nay/tối nay|t
今晨=sáng nay/kim thần|t
今月=tháng này/tháng này|t
今朝=hôm nay/sáng nay/Kim triều/hiện tại/trước mắt|t
今生=kiếp này/kiếp này/trọn kiếp này/đời này|t
今番=lần này|t
从今=từ hôm nay|t
从前=lúc trước/từ trước/ngày trước/trước đây/thuở xưa|t
以往=dĩ vãng/ngày xưa/ngày trước/trước kia/đã qua|t
以才=nên mới|t
以武=dùng võ|t
伏天=phục thiên/tháng nóng nhất trong mùa hè|t
休息天=ngày nghỉ ngơi|t
休息日=ngày nghỉ|t
会上=sẽ lên/trong buổi họp|t
会内=trong hội|t
会去=sẽ đi|t
会后=sau đó|t
会期=ngày họp/thời gian họp/số ngày họp|t
会齐=tụ họp/gặp nhau/tập trung/tập hợp|t
侏罗纪=Jurassic|t
假天=giả thiên|t
假日=ngày nghỉ|t
假期=ngày nghỉ/kỳ nghỉ/thời gian nghỉ|t
假节=giả tiết|t
傍上=dính vào|t
傍午=gần trưa/bàng ngọ/bày đặt ngổn ngang|t
傍晚=chập tối/chạng vạng tối/chạng vạng/gần tối/nhá nhem tối/sẩm tối/hoàng hôn/sập tối|t
傍近=gần/kề/kế|t
儿时=hồi nhỏ/lúc đó/nối khố|t
元代=nguyên đại|t
元元=Nguyên Nguyên/từ đầu chí cuối/đầu đuôi ngọn nguồn/ngọn nguồn|t
元初=nguyên sơ|t
元启=Nguyên Khải|t
元夜=nguyên tiêu/đêm nguyên tiêu|t
元天=Nguyên Thiên|t
元宵=Nguyên Tiêu/nguyên tiêu/đêm rằm tháng giêng/bánh nguyên tiêu/bánh trôi/chè trôi nước|t
元宵夜=đêm nguyên tiêu|t
元宵节=tết nguyên tiêu/tiết nguyên tiêu/thượng nguyên|t
元常=Nguyên Thường|t
元年=nguyên niên/năm đầu|t
元庆=Nguyên Khánh|t
元日=mồng một tết/ngày đầu tiên của một năm|t
元旦=tết nguyên đán/nguyên đán/ngày đầu năm âm lịch|t
元旦节=tiết nguyên đán|t
元月=tháng giêng|t
元朝=Nguyên triều|t
元末=cuối thời nhà Nguyên|t
元清=Nguyên Thanh|t
元首=nguyên thủ/tổng thống/quân chủ/người đứng đầu nhà nước|t
先上去=đi lên trước|t
先代=đời trước/trước thay/tổ tiên|t
先前=lúc trước/trước kia/trước|t
先去=trước đi/đi trước|t
先后=trước sau/tuần tự/lần lượt|t
先天=tiên thiên/bẩm sinh/năng khiếu bẩm sinh/tiên nghiệm|t
先期=trước/trước đó/tiên kỳ|t
先秦=Tiên Tần|t
八代=tám đời/bát đại/|t
八天=tám ngày/tám ngày|t
八年=tám năm|t
八德=bát đức/tám đức|t
八日=tám ngày/tám ngày|t
八旬=bát tuần|t
八月=tháng tám/tám tháng/tám tháng|t
八月节=tiết Trung thu/tết Trung thu|t
八节=tám tiết/tám tiết trong năm/quanh năm|t
八间=tám gian|t
公元前=trước công nguyên|t
六世=lục thế|t
六世纪=sáu thế kỷ|t
六代=lục đại/sáu đời/đời sáu|t
六叶=Lục Diệp|t
六日=sáu ngày/sáu ngày|t
六旬=lục tuần|t
六时=lục thời/6h|t
六更=sáu chương|t
六月=tháng sáu/sáu tháng|t
六朝=lục triều/thời kỳ Nam Bắc triều|t
六间=sáu gian|t
其才=kỳ tài|t
冬假=nghỉ đông|t
冬冬=tùng tùng|t
冬初=bắt đầu vào mùa đông|t
冬夜=đêm đông/Đông Dạ|t
冬天=mùa đông|t
冬季=mùa đông|t
冬寒=đông hàn/mùa đông lạnh lẽo/khí lạnh mùa đông|t
冬日=ngày đông/vào đông/mùa đông|t
冬月=Đông Nguyệt|t
冬末=cuối đông/cúi đông|t
冬至=đông chí|t
冬节=đông tiết/đông chí|t
冬蜇=ngủ đông/sự ngủ đông|t
冬雨=Đông Vũ|t
冰天=băng thiên|t
冰川期=kỷ Băng Hà|t
冰月=Băng Nguyệt|t
冰期=băng kỳ/thời kỳ băng hà/thời kỳ trong kỷ băng hà lần thứ nhất|t
冰河时代=thời đại băng hà|t
冷天=trời lạnh/lãnh thiên|t
冷月=lãnh nguyệt/trăng lạnh|t
凌二=Lăng Nhị|t
凌四=Lăng Tứ|t
凌天=lăng thiên|t
凌日=lăng nhật|t
凌晨=rạng sáng|t
凌月=Lăng Nguyệt|t
凌月月=Lăng Nguyệt Nguyệt|t
刚才=vừa rồi/vừa/vừa mới/ban nãy/mới vừa rồi/vừa nãy|t
初一=lần đầu tiên/mùng một|t
初七=mùng bảy/sơ thất|t
初三=lớp 8/sơ tam/đầu tháng ba/lớp 8/lớp 9|t
初九=sơ cửu/mùng chín|t
初二=mùng hai/đầu cấp hai/mùng 2|t
初五=đầu năm/mùng năm|t
初八=mùng tám|t
初六=mùng sáu|t
初冬=đầu mùa đông/đầu đông/tháng 10/tháng đầu tiên của mùa đông|t
初十=mùng mười|t
初唐=Sơ Đường|t
初四=mùng bốn|t
初夏=đầu hạ/tháng 4/tháng đầu tiên của mùa hạ/đầu mùa hè|t
初夜=đêm đầu/đêm đầu tiên/đầu đêm/canh đầu/đêm động phòng|t
初年=năm đầu/giai đoạn đầu|t
初日=sơ nhật|t
初旬=sơ tuần/mười ngày đầu tháng|t
初时=lúc đầu|t
初明=hừng đông|t
初春=đầu mùa xuân/đầu xuân/tháng giêng/tháng đầu tiên của mùa xuân|t
初晨=sáng sớm|t
初期=sơ kỳ/lúc đầu/giai đoạn đầu/thời kỳ đầu/thuở đầu|t
初生儿=trẻ sơ sinh|t
初秋=đầu thu/tháng 7/tháng đầu mùa thu|t
刹时=tức khắc|t
刹时间=tức khắc|t
刹罗=Sát La|t
刹那=sát na/nháy mắt/chớp mắt/nháy mắt|t
刹那间=trong chốc lát/trong sát na/sát na bên trong|t
前一天=một ngày trước|t
前七=trước bảy/bảy vị trí đầu|t
前三天=trước ba ngày/ba ngày trước|t
前世=kiếp trước/đời trước/tiền kiếp|t
前九=trước chín/chín vị trí đầu|t
前二=hai vị trí đầu|t
前些天=vài ngày trước/ít ngày trước/mấy ngày trước|t
前些年=trước đây ít năm/những năm trước đây|t
前些日=vài ngày trước|t
前些时候=chút thời gian trước|t
前些时日=vài ngày trước|t
前六=trước sáu/sáu vị trí đầu|t
前半夜=đầu hôm/nửa đầu hôm|t
前半天=buổi sáng|t
前半年=nửa năm trước|t
前半晌=buổi sáng|t
前半生=nửa đời trước/nửa thân trước|t
前去=tiến đến/đi vào/đi trước|t
前四=trước bốn/bốn vị trí đầu|t
前夜=đêm trước|t
前天=hôm trước/ngày hôm trước/hôm kia|t
前宋=Tiền Tống|t
前年=năm trước/năm kia|t
前往=tiến về/đi trước/tiến về phía trước/đi/tiến về trước/đi tới|t
前日=ngày hôm trước/hôm kia/hôm trước|t
前晌=buổi sáng|t
前晚=tối hôm trước|t
前月=tháng trước|t
前朝=tiền triều|t
前来=đến đây/tới trước|t
前汉=Tây Hán/Tiền Hán|t
前秦=tiền tần|t
前魏=tiền Ngụy|t
剎那=sát na|t
劫后=kiếp sau|t
北二=Bắc Nhị|t
北周=Bắc Chu|t
北夜=Bắc Dạ|t
北天=Bắc Thiên|t
北宋=Bắc Tống|t
北朝=Bắc triều|t
北秦=Bắc Tần|t
北魏=Bắc Ngụy|t
十五世纪=thế kỷ 15|t
十代=mười đời|t
十夜=mười đêm|t
十年间=trong mười năm|t
十日=mười ngày|t
十更=mười chương|t
十月=tháng mười/mười tháng|t
十月初=đầu tháng mười|t
十月底=cuối tháng mười|t
十间=mười gian|t
午前=sáng/buổi sáng|t
午后=buổi chiều/sau giờ Ngọ/chiều|t
午夜=nửa đêm|t
午时=buổi trưa/giờ ngọ|t
午间=giờ ngọ|t
半世=nửa đời|t
半世纪=nửa thế kỉ|t
半今=hiện nửa/một nửa|t
半夜三更=khuya khoắt/nửa đêm canh ba/đêm hôm khuya khoắt/nửa đêm nửa hôm/giữa đêm giữa hôm|t
半夜里=lúc nửa đêm|t
半年前=nửa năm trước|t
半日=nửa ngày/khá lâu/cả buổi|t
半时=nửa giờ/nửa tiếng|t
半晚=nửa đêm|t
半月=nửa tháng/bán nguyệt/nửa vầng trăng|t
半朝=nửa triều|t
半来=hơn nửa|t
南北朝=Nam Bắc triều|t
南唐=Nam Đường|t
南天=Nam Thiên|t
南宋=Nam Tống|t
南晋=Nam Tấn|t
南朝=nam triều/Nam Triều|t
卯上=dính lên|t
卯兔=Mão Thỏ|t
卯日=mão nhật|t
卯时=giờ Mão/giờ mẹo/giờ Mẹo|t
卯眼=ngàm/lỗ mộng/lỗ bắt bu-lông/lỗ bắt ri-vê|t
即去=liền đi|t
即夕=tối nay|t
即日=ngay hôm đó/ngay trong ngày/hôm nay/trong ngày/cùng ngày/ngay hôm ấy/mấy ngày sắp tới/sắp sửa/bây giờ|t
去下=đi tới|t
去不去=có đi hay không/có đi không|t
去世=qua đời/tạ thế/từ trần/chết/khuất bóng/khuất núi|t
去后=về phía sau|t
去回=trở về|t
去国=rời nước/rời khỏi đất nước của một người|t
去岁=năm ngoái/năm rồi/năm qua|t
去年=năm ngoái/năm trước/năm qua/năm rồi/khứ niên|t
去年底=cuối năm ngoái|t
去晚=đi trễ|t
去那=đi chỗ đó|t
双休日=hai ngày nghỉ/hai ngày nghỉ|t
古今=cổ kim/xưa và nay|t
古代=cổ đại/thời cổ/ngày xưa/thời đại xã hội nô lệ/xã hội nguyên thuỷ|t
古历=nông lịch/âm lịch|t
古时=thời cổ/thời xưa/cổ thì|t
古昔=cổ xưa/thời xưa/thời cổ|t
古月=cổ nguyệt|t
古朝=cổ triều|t
古来=xưa nay/từ xưa đến nay|t
古汉=Cổ Hán|t
古生代=cổ sinh đại|t
古里=Cổ Lí/cổ lý|t
古阵上=trên tòa cổ trận|t
同年=đồng niên/cùng năm/cùng tuổi/bằng tuổi/người đỗ cùng khoá thi|t
同日=cùng ngày/đồng nhất|t
同时代=cùng thời đại|t
同月=cùng tháng|t
后世=hậu thế/đời sau/hậu duệ/con cháu/người nối dõi/kiếp sau/kiếp lai sinh|t
后久=hậu cửu|t
后代=hậu đại/đời sau/thời đại sau/hậu sinh/hậu duệ/con cháu|t
后先=bước nhỏ/tầm gần/sau trước|t
后半夜=sau nửa đêm/nửa đêm về sáng|t
后半段=nửa đoạn sau/nửa phần sau|t
后半生=tuổi già/cuối đời/những năm cuối đời/nửa đời sau|t
后半辈子=nửa đời sau|t
后周=Hậu Chu|t
后唐=Hậu Đường|t
后天=hậu thiên/ngày mốt/sau này/ngày kia/lớn lên/thời kỳ lớn lên/ngày mai/ngày sau|t
后年=năm sau/sang năm|t
后日=sau này/từ nay trở đi/ngày mai|t
后晋=hậu Tấn|t
后晌=chiều/buổi chiều/tối/buổi tối|t
后期=hậu kỳ/giai đoạn sau/thời kỳ sau/cuối|t
后来=về sau/sau lại/sau này/sau/sau đó/đến sau/trưởng thành sau/kế thừa/kế tiếp/kế nghiệp|t
后汉=Hậu Hán|t
向前=hướng về phía trước/về phía trước|t
周一=thứ hai|t
周三=thứ tư|t
周二=thứ ba|t
周五=thứ sáu|t
周代=đời Chu|t
周六=thứ bảy|t
周冬=Chu Đông|t
周初=đầu tuần|t
周四=thứ năm|t
周回=vòng|t
周天=chu thiên|t
周年=tròn năm/đầy năm/một năm tròn/chu niên|t
周恩来=Chu Ân Lai|t
周才=Chu Tài|t
周日=chủ nhật|t
周朝=Chu triều|t
周期=chu kỳ|t
周末=cuối tuần|t
周纪=Chu Kỷ|t
周至=chu đáo/kỹ lưỡng/kỹ càng|t
唐代=thời Đường/Đường đại|t
唐初=Đường sơ/đầu thời nhà Đường|t
唐周=Đường Chu|t
唐唐=đường đường/Đường Đường|t
唐天=Đường Thiên/đường thiên|t
唐宋=Đường Tống|t
唐时=thời nhà Đường|t
唐晨=Đường Thần|t
唐朝=Đường triều|t
唐末=Đường mạt|t
唐汉=Đường Hán|t
唐秦=Đường Tần|t
商代=đời nhà Thương|t
商周=Thương Chu|t
商朝=Thương triều/triều nhà Thương/triều nhà thương|t
嗣后=về sau/sau/sau này|t
嗣子=tự tử/con nối/con nối dõi|t
嘉来=Gia Lai/tỉnh Gia Lai|t
嘉靖=Gia Tĩnh|t
四代=đời bốn/bốn đời/tứ đại/bốn đời|t
四叶=bốn lá/Yotsuba|t
四日=bốn ngày/bốn ngày|t
四时=bốn mùa/bốn giờ|t
国初=quốc sơ|t
国庆=quốc khánh|t
国庆日=ngày Quốc khánh|t
国庆节=lễ quốc khánh|t
圆周=chu vi hình tròn/vòng tròn|t
圆月=trăng tròn/viên nguyệt|t
圣上=Thánh thượng/Thánh Thượng/thánh thượng/hoàng đế|t
圣代=kem tươi|t
圣后=Thánh Hậu|t
圣天=Thánh Thiên/thánh thiên|t
圣日=Thánh Nhật|t
圣朝=Thánh Triều|t
圣诞=Giáng Sinh/thánh đản/ngày sinh Khổng Tử/sinh nhật Khổng Tử/lễ Nô-en/ngày Chúa sinh ra đời/giáng sinh|t
圣诞夜=đêm giáng sinh|t
圣诞节=lễ Giáng Sinh|t
壮年=tráng niên/đứng tuổi/trung niên|t
壮汉=tráng hán|t
夏元=Hạ Nguyên|t
夏冬=Hạ Đông|t
夏初=đầu mùa hè|t
夏历=nông lịch/âm lịch|t
夏叶=Hạ Diệp|t
夏启=Hạ Khải|t
夏夜=đêm hè|t
夏天=mùa hè/mùa hạ|t
夏季=mùa hạ/mùa hè|t
夏日=ngày mùa hè/mùa hè|t
夏朝=Hạ triều|t
夏末=cuối mùa hè/cuối hè|t
夏秋=Hạ Thu|t
夏种=gieo hạt mùa hè|t
夏至=Hạ Chí|t
夜中=trong đêm|t
夜内=trong đêm|t
夜凉=đêm lạnh|t
夜半=nửa đêm|t
夜半三更=nửa đêm canh ba|t
夜后=Dạ Hậu|t
夜四=Dạ Tứ|t
夜夜=hàng đêm|t
夜天=trời đêm|t
夜宵=bữa ăn khuya/dạ tiêu|t
夜明=dạ minh|t
夜晚=ban đêm/buổi tối|t
夜月=trăng đêm/dạ nguyệt|t
夜来=hôm qua/ban đêm|t
夜深=đêm dài/đêm khuya/màn đêm thăm thẳm|t
夜里=trong đêm/ban đêm|t
夜间=ban đêm|t
夜雨=mưa đêm/Dạ Vũ/dạ vũ/đêm mưa|t
夤夜=đêm khuya|t
大前年=năm kia/ba năm trước|t
大半夜=hơn nửa đêm|t
大半天=hơn nửa ngày/ban ngày|t
大半年=hơn nửa năm|t
大半日=hơn nửa ngày|t
大后年=ba năm sau|t
大宋=Đại Tống|t
大年初一=đầu năm mùng một|t
大年初三=ngày mồng ba tết|t
大年初二=ngày mồng hai tết|t
天前=ngày trước|t
天天=mỗi ngày/hàng ngày/ngày ngày|t
天日=mặt trời/thiên nhật/mặt trời và trời|t
天早=sáng sớm/buổi sáng|t
天时=thiên thời/khí hậu/thời tiết/điều kiện khí hậu/tình hình thời tiết/tình hình khí hậu/thời gian|t
天朝=thiên triều/Thiên triều|t
天近=trời sắp|t
头前=phía trước/đằng trước/trước/trước đây/trước kia/trước đầu|t
头天=ngày hôm trước/ngày thứ nhất/ngày đầu tiên/ngày đầu|t
头年=năm đầu/năm ngoái/năm trước/năm rồi|t
头昏=đầu choáng váng|t
如下=như sau/dưới đây/sau đây|t
如今=bây giờ/ngày nay/hôm nay/giờ đây/đến nay|t
如初=như lúc ban đầu|t
如前=như trước|t
如叶=như lá|t
如常=như thường/như cũ|t
如昔=như trước/xưa|t
如期=đúng hạn/đúng kỳ hạn|t
如来=Như Lai/như lai|t
如水月=như thủy nguyệt|t
如霜=như sương|t
婚前=trước hôn nhân/trước khi cưới|t
婚庆=hôn khánh/hôn lễ|t
婚期=hôn kỳ/ngày kết hôn/ngày cưới|t
婚秦=hôn thê|t
子午=Tý Ngọ|t
孕期=thời gian mang thai/thời kỳ thai nghén|t
宋代=Đại Tống|t
宋时=thời Tống|t
宋朝=Tống triều|t
宋末=Tống Mạt|t
寅时=giờ Dần/giờ dần|t
寒冬=trời đông/trời đông giá rét/mùa đông lạnh lẽo/mùa đông giá rét|t
寒夜=đêm lạnh/đêm rét|t
寒宵=Hàn Tiêu|t
寒月=Hàn Nguyệt|t
封底=nền tảng/trang bìa bốn|t
将上=đem lên|t
将去=phải đi|t
将在=sẽ tại/đem tại|t
将往=tướng đến|t
将才=tướng tài/vừa mới/vừa|t
将来=tương lai/sau này/mai sau/sẽ tới|t
将近=gần/sắp tới/gần tới/ngót/sấp sỉ|t
小前=Tiểu Tiền|t
小半夜=gần nửa đêm|t
岁半=tuổi rưỡi|t
岁暮=cuối năm/gần cuối năm|t
岁月=tuế nguyệt/năm tháng|t
岁末=cuối năm|t
崇朝=sùng triêu/trọn một buổi sớm|t
巳时=giờ Tỵ|t
巳蛇=Tị Xà|t
平年=năm thường/năm mùa màng thu hoạch bình thường|t
平底=đáy bằng|t
平日=ngày thường/thường ngày/thường thường/bình nhật|t
平时=bình thường/lúc thường/ngày thường/thời bình/bình thời|t
平昔=trước kia/trước đây/hồi trước/ngày trước|t
平靖=dẹp yên/ổn định/an toàn|t
年代=niên đại/thời đại/thời kỳ/những năm tháng/thập kỷ/những năm|t
年内=năm bên trong/trong năm/năm trong|t
年初=đầu năm/mấy ngày đầu năm|t
年初三=ngày mùng ba tháng giêng|t
年前=năm trước|t
年半=năm rưỡi|t
年半前=năm rưỡi trước|t
年历=niên lịch/lịch/lịch năm|t
年后=năm sau|t
年复一年=năm qua năm/năm này qua năm khác|t
年夜=đêm giao thừa/đêm 30 tết/đêm trừ tịch|t
年年=mỗi năm/hàng năm/hằng năm|t
年庆=lễ mừng mỗi năm|t
年底=cuối năm/những ngày cuối năm|t
年时=thâm niên/năm xưa/năm ngoái/năm lúc|t
年末=cuối năm|t
年来=năm qua/từ năm nay/mấy năm gần đây|t
年纪=niên kỷ/tuổi/tuổi tác|t
年终=cuối năm|t
年节=ngày tết|t
年近=tuổi gần/tuổi gần|t
年间=năm bên trong/trong năm/trong thời kỳ/thời kì|t
幼年=còn nhỏ/tuổi thơ/tuổi nhỏ|t
幼年时代=thời tuổi thơ|t
幼年时期=khi còn bé|t
幼年期=ấu niên kỳ|t
幼时=khi còn bé|t
开斋节=lễ khai trai/tiết khai trai|t
弘历=Hoằng Lịch|t
当下=lập tức/ngay lập tức/tức thì/liền/ngay sau đó|t
当不上=làm không được|t
当不了=làm không được|t
当今=đương kim/hiện nay/hiện thời/trước mắt/đương kim hoàng thượng/đương kim hoàng đế|t
当代=đương đại|t
当儿=đương lúc/đang khi/ngay lúc đó/khoảng trống/khoảng không|t
当初=lúc trước/trước đây/đương sơ/lúc đầu/hồi đó/khi đó/lúc đó/xưa kia/ban đầu|t
当前=trước mắt/trước mặt/phía trước/ở trước mặt/đối mặt|t
当午=giữa trưa/trưa/đương ngọ|t
当夜=màn đêm buông xuống/đêm đó/đêm hôm đó/ngay đêm đó|t
当天=cùng ngày/ngay ngày hôm ấy/ngay hôm đó/trong ngày/ngày đó/khi thiên|t
当季=mùa này|t
当年=năm đó/lúc đó/lúc đấy/đương niên/trước kia/trước đây/tráng niên/thời sung sức/lúc sung sức/thời khoẻ mạnh/năm ấy/cùng năm|t
当日=ngày đó/lúc đầu/lúc đó/khi đó/hôm đó/hôm ấy|t
当时=lúc ấy/lúc đó/khi đó/đương thời/lập tức/liền/ngay lúc đó/ngay lúc ấy|t
当晚=đêm đó/tối hôm đó/buổi tối hôm đó/tối cùng ngày|t
当月=tháng đó/cùng tháng/ngay trong tháng đó|t
当朝=đương triều/triều đại đương thời/hoàng đế đương thời/cầm quyền/lo việc triều chính|t
当清=cầm sạch|t
当阳=đương dương/Đương Dương/Dangyang/vùng nắng ấm|t
彼伏=liên tiếp|t
彼往=kia đi|t
往世=vãng thế|t
往前=hướng phía trước/đi phía trước|t
往后=về sau/sau này/từ nay về sau/trong tương lai/lui về phía sau|t
往回=trở về|t
往年=những năm qua/năm rồi/trước/trước kia/năm xưa/năm trước|t
往往=thường thường/thường hay/nơi nơi/khắp nơi|t
往日=ngày xưa/những ngày qua/trước kia/vãng nhật|t
往时=lúc đi/trong quá khứ/thời gian trước đây|t
往昔=trước kia/chuyện xưa/vãng tích/hồi ức/xưa kia/năm xưa/như trước|t
往来=vãng lai/lui tới/đi lại/qua lại/tới lui/thăm viếng/lai vãng|t
忌日=ngày giỗ/ngày kị|t
志常=Chí Thường|t
恢复期=thời kỳ dưỡng bệnh|t
惊天=kinh thiên|t
惊蛰=Kinh Trập/kinh trập|t
感恩节=Lễ Tạ Ơn|t
戊午=Mậu Ngọ|t
戌时=giờ Tuất/giờ tuất|t
戌狗=Tuất Cẩu|t
成天=suốt ngày/cả ngày/thành thiên|t
成年=trưởng thành/thành niên/quanh năm/suốt năm/cả năm|t
成年期=thành niên kỳ|t
战前=chiến trước/trước khi chiến đấu/trước trận chiến|t
战后=chiến hậu/sau khi chiến đấu/hậu chiến/sau chiến tranh/sau cuộc chiến|t
战时=thời gian chiến tranh/chiến thời/thời chiến/chiến lúc|t
拂中=phất trúng|t
拂去=phủi nhẹ|t
拂晓=tảng sáng/tờ mờ sáng/bình minh/sáng sớm|t
排卵日=ngày trứng rụng|t
斋月=tháng ăn chay/tháng nhịn ăn ban ngày|t
新一代=một đời mới|t
新年=năm mới/tân niên/tết Dương lịch|t
新月=trăng non/trăng lưỡi liềm/trăng mồng một|t
新近=gần đây/mới đây|t
方今=ngày nay/hiện nay/hiện thời|t
方晨=Phương Thần|t
方近=gần/kề/kế/cạnh/không xa|t
无霜期=thời kì không có sương muối|t
既往=chuyện xưa/vừa hướng/chuyện đã qua/trước đây/trước kia|t
日上=mặt trời lên cao/mặt trời đã cao|t
日前=ngày trước/mấy ngày trước/hôm trước|t
日历=lịch ngày|t
日后=ngày sau/sau này/mai sau|t
日复一日=ngày qua ngày|t
日夕=ngày đêm|t
日夜=ngày đêm/một ngày một đêm|t
日天=nhật thiên|t
日日=ngày ngày/mỗi ngày|t
日暮=hoàng hôn|t
日更=ngày thêm|t
日月=nhật nguyệt/những năm tháng|t
日期=ngày/thời kì/ngày tháng/nhật kỳ|t
日间=ngày ở giữa/ban đêm/ban ngày|t
旦夕=sớm tối/sớm chiều/một sớm một chiều/đán tịch|t
旦日=ngày mai/mai/ban ngày|t
旦旦=mỗi ngày/thành khẩn/chân thành|t
旦昔=đán tích|t
旧代=cựu đại|t
旧历=lịch cũ|t
旧天=cựu thiên|t
旧年=năm cũ|t
旧日=ngày cũ/ngày xưa/ngày qua|t
旧时=trước đây/thời trước/ngày trước|t
旧时代=thời đại trước|t
旧石器时代=thời đại đồ đá|t
早上=buổi sáng/sáng sớm/sớm hơn|t
早中晚=sáng trưa tối|t
早前=trước sớm|t
早午晚=sáng trưa chiều|t
早去=đi sớm|t
早回=về sớm|t
早天=chết yểu|t
早年=trước kia/năm mới/trước đó/hồi đó/thời trẻ/thời niên thiếu/từ nhỏ/năm xưa|t
早年间=thời gian trước/thời trẻ|t
早日=sớm ngày/sớm/từ lâu/trước kia|t
早早=sớm/thật sớm/rất sớm|t
早春=đầu xuân/xuân sớm|t
早晚=sớm tối/sớm muộn/sớm muộn gì/chẳng chóng thì chày/lúc/khi/lúc nào đó/khi nào|t
早晨=sáng sớm/buổi sáng/sáng/sớm|t
早更=sớm hơn|t
早朝=tảo triều/lâm triều|t
早期=lúc đầu/giai đoạn đầu/thời kỳ đầu|t
早秋=thu sớm/đầu thu|t
早间=sáng sớm|t
旱天=trời hạn/trời hanh/trời nóng|t
旱季=mùa khô|t
旱年=năm hạn hán|t
时旬=thời tuần/thời gian|t
时晨=giờ|t
时近=sắp tới|t
明个=ngày mai|t
明代=Đại Minh/đời Minh|t
明儿=đến mai/Minh Nhi/ngày mai/mai đây/mai sau/tương lai/Minh nhi|t
明元=Minh Nguyên|t
明初=đầu thời Minh/đầu minh/đầu nhà Minh|t
明前=trà Minh Tiền|t
明后天=mai kia/mai mốt/ngày mai hoặc ngày mốt/sáng ngày mốt|t
明夏=minh hạ|t
明夜=tối mai/đêm mai|t
明天=ngày mai/mai đây/mai kia/tương lai/minh thiên|t
明岁=năm tới|t
明年=sang năm/năm tới|t
明年初=đầu năm nay/đầu năm sau|t
明日=ngày mai|t
明早=sáng mai/ngày mai|t
明明=rõ ràng|t
明春=xuân tới|t
明晓=hiểu rõ|t
明晚=đêm mai/tối mai/biết rõ|t
明晨=sáng mai|t
明月=minh nguyệt/trăng sáng/Minh Nguyệt|t
明朝=Minh triều|t
明末=Minh mạt|t
明末清初=cuối Minh và đầu Thanh/cuối trạch minh và đầu nhà Thanh/khoảng giữa thế kỷ 17|t
明武=Minh Võ|t
明治=Minh Trị|t
明清=minh thanh|t
明穗=Minh Tuệ|t
明里=ngoài sáng|t
昔年=năm đó/tích niên/năm xưa|t
昔日=ngày xưa/tích nhật/ngày trước/thời trước|t
昔时=ngày trước|t
星历=Lịch Tinh Tú/tinh lịch|t
星夜=đêm tối/đêm/màn đêm|t
星晨=tinh thần|t
星月=trăng sao/tinh nguyệt|t
星期=tuần lễ/ngày thứ/chủ nhật|t
星期一=thứ hai/ngày thứ Hai|t
星期三=Thứ tư/thứ tư|t
星期二=thứ ba|t
星期五=thứ sáu|t
星期六=thứ bảy|t
星期四=thứ năm|t
星期天=chủ nhật|t
星期日=Chủ Nhật|t
星汉=tinh hà/tinh hán|t
星纪=tinh kỷ|t
春上=mùa xuân|t
春假=nghỉ xuân/nghỉ tết|t
春儿=Xuân nhi|t
春初=đầu xuân|t
春夏=xuân hạ|t
春夜=đêm xuân|t
春天=mùa xuân/thời kỳ mùa xuân/xuân kỳ|t
春季=mùa xuân/xuân kỳ/thời kỳ mùa xuân|t
春宵=đêm xuân/xuân dạ|t
春宵一刻=xuân tiêu một khắc/đêm xuân đáng giá nghìn vàng|t
春寒=xuân hàn/tiết lạnh mùa xuân|t
春日=ngày xuân|t
春晓=Xuân Hiểu|t
春晚=tiết mục cuối năm|t
春末=cuối mùa xuân|t
春来=xuân tới|t
春秋=Xuân Thu|t
春秋时代=thời Xuân Thu|t
春秋时期=thời kỳ Xuân Thu|t
春节=tết xuân/tết âm lịch/tết ta/mùa xuân/tết xuân|t
春阳=nắng xuân/xuân dương/Xuân Dương|t
春露=Xuân Lộ|t
昨个=hôm qua|t
昨儿=hôm qua/ngày hôm qua|t
昨儿个=hôm qua|t
昨夜=đêm qua|t
昨夜里=trong đêm qua|t
昨天=hôm qua/ngày hôm qua/đã qua/trước kia/trước đây|t
昨天下午=chiều hôm qua|t
昨天夜里=tối hôm qua/đêm hôm qua|t
昨天晚上=đêm qua/tối qua/tối ngày hôm qua|t
昨日=hôm qua/ngày hôm qua|t
昨晚=tối hôm qua|t
是夜=ban đêm/đó là đêm|t
昼夜=ngày đêm/ban ngày và ban đêm|t
晋代=triều Tấn|t
晋朝=triều Tấn/Tấn triều|t
晋阶时=khi lên cấp|t
晌久=khoảng một chặp lâu|t
晌午=buổi trưa/xế trưa|t
晚上=ban đêm/đêm tối/buổi tối/muộn|t
晚不来=muộn không tới|t
晚些=chậm chút|t
晚些时候=chờ chút sau này/sau đó|t
晚夕=vãn tịch|t
晚夜=đêm khuya|t
晚年=tuổi già/lúc tuổi già/cuối đời|t
晚时=đêm đến|t
晚期=màn cuối/thời kì cuối/cuối đời/thời kỳ cuối|t
晚来=muộn|t
晚清=cuối thanh/muộn nhà Thanh/cuối thế kỷ 19 và đầu thế kỷ 20 Trung Quốc|t
晚秋=Vãn Thu|t
晚秋时节=cuối mùa thu|t
晚节=khí tiết tuổi già/tuổi già/cuối đời/vãn tiết|t
晚近=gần đây|t
晚间=buổi chiều/buổi tối/ban đêm/tối|t
晦朔=hối sóc/từ cuối tháng đến đầu tháng/từ tối đến sáng|t
晨早=sáng sớm|t
晨时=lúc sáng sớm|t
晨昏=sớm chiều/thần hôn/chăm chút/phụng dưỡng|t
晨晨=Thần Thần|t
暑假=nghỉ hè/thử giả|t
暑天=ngày nóng|t
暑期=kỳ nghỉ hè/ba tháng hè|t
暮后=mộ hậu|t
暮年=tuổi già/về già/tuổi xế chiều|t
暮时=lúc hoàng hôn|t
暮春=cuối xuân/tháng ba âm lịch|t
暮秋=tàn thu/cuối thu|t
更年期=thời mãn kinh/tuổi mãn kinh/thời kỳ mãn kinh|t
最丑=xấu nhất|t
最初=ban sơ/lúc ban đầu/lúc đầu/ban đầu|t
最多才=tối đa mới/đa tài nhất|t
最末=cuối cùng/chót nhất|t
月初=đầu tháng|t
月历=lịch tháng/âm lịch|t
月圆夜=đêm trăng tròn|t
月夜=đêm trăng|t
月季=nguyệt quý/cây hoa hồng/bông hồng/hoa hồng|t
月底=cuối tháng|t
月末=cuối tháng|t
月清=trăng thanh|t
月终=cuối tháng|t
朔夜=Sakuya|t
朔日=mồng một/ngày mồng một|t
朔月=trăng non/trăng mồng một/trăng lưỡi trai|t
朔望=mồng một và ngày rằm|t
期天=kỳ thiên|t
期末=cuối kỳ|t
未了=chưa hết/chưa xong/chưa thực hiện được/làm dở/chưa dứt|t
未时=giờ Mùi|t
未来=tương lai/chưa tới/thời gian tới/sau này/mai sau/ngày sau|t
未羊=Vị Dương|t
末了=cuối cùng/sau hết/sau cùng|t
末代=mạt đại|t
末伏=mạt phục|t
末叶=cuối|t
末年=những năm cuối/cuối thời/năm cuối|t
末日=tận thế/ngày diệt vong/ngày tận thế/ngày cuối cùng|t
末节=nhánh cuối/mạt tiết|t
本世纪=thế kỷ này|t
本世纪初=đầu thế kỷ này|t
本代=đời này|t
本初=bản sơ|t
本周=tuần này|t
本年=năm này|t
本底=nền/hậu cảnh|t
本明=bản minh|t
本月=tháng này|t
本朝=bản triều/triều đại/triều vua/vương triều này/bổn triều|t
本期=bản kỳ/vấn đề này/giai đoạn hiện tại|t
本末=đầu đuôi/gốc ngọn/từ đầu đến cuối/đỉnh chân/ví với trải qua sự tình từ đầu đến cuối/chính phụ/yếu trọng|t
本来=lúc đầu/vốn là/vốn có/vốn/ban đầu/khởi thuỷ/trước đây/lúc trước/lẽ ra/đáng nhẽ/đáng lẽ|t
本纪=bản kỷ|t
术后=thuật hậu/sau phẫu thuật|t
来天=ngày nữa/ngày qua/nữa|t
来年=năm sau/sang năm/năm tới|t
来时=lúc đến/lúc tới/khi đến|t
来晚=tới chậm|t
来月=tháng sau/tháng tới|t
来朝=triều bái/đến bái|t
来齐=đến đủ/đến đủ|t
枯叶=lá khô/Khô Diệp|t
枯水期=mùa khô/mùa hạn/mùa nước cạn/khô thủy kỳ|t
根茎叶=rễ lá cây|t
次上=lần tới|t
次世代=thế hệ tiếp theo|t
次之=thứ hai/kém hơn|t
次了=lần|t
次年=năm sau|t
次日=ngày kế tiếp/ngày kế|t
次晨=sáng sớm hôm sau|t
次次=nhiều lần|t
正内=ở giữa|t
正午=giữa trưa/chính ngọ/đúng ngọ|t
正在=ngay tại/đang/đang tại/đang ở/đương/chính đang|t
正德=Chính Đức|t
正日=ngày chính|t
正月=tháng giêng/tháng 1/tháng một|t
正月初一=ngày đầu tháng giêng|t
正月初七=mùng bảy tháng giêng|t
正月初十=ngày mùng mười tháng riêng|t
正里=ở giữa|t
此世=thế này/đời này|t
此关=cái này liên quan/cửa này|t
此前=trước đây|t
此去=lần này đi/lần đi|t
此生=đời này/cuộc đời này|t
此番=lần này|t
此盆=chậu này|t
此节=đoạn mấu chốt này|t
此间=nơi đây/ở đây/nơi này/chỗ này|t
此阵=trận này|t
残年=cuối đời/những năm tháng còn lại/những năm cuối đời/hoàng hôn/cuối năm|t
残月=tàn nguyệt/trăng tàn/cuối kỳ/cuối tháng/trăng khuyết/trăng sắp lặn/trăng tàn / cuối kỳ / cuối tháng/trăng tàn,cuối kỳ,cuối tháng|t
殷朝=Ân triều|t
永年=Vĩnh Niên|t
汉代=Hán đại/thời Hán|t
汉晋=Hán Tấn|t
汉朝=Hán triều|t
汉末=Hán mạt/cuối thời nhà Hán|t
汛期=kỳ nước lên/lũ định kỳ|t
泥古=nệ cổ/khư khư giữ cái cũ|t
泼上=giội lên|t
泼下=giội xuống|t
泼下来=đổ xuống|t
泼天=đầy trời|t
淡月=Đạm Nguyệt/tháng ế ẩm/tháng vắng khách|t
深冬=mùa đông|t
深夜=đêm khuya|t
深夜里=trong đêm khuya|t
深秋=cuối thu/cuối mùa thu|t
清一清=thanh lọc một chút|t
清世=thanh thế/thanh bình|t
清代=đời nhà Thanh/đời Thanh|t
清初=Thanh sơ|t
清古=Thanh Cổ|t
清夜=đêm khuya tĩnh lặng/đêm khuya thanh vắng|t
清年=thanh niên|t
清早=sáng sớm/tảng sáng/sáng tinh mơ|t
清明节=tết thanh minh/tiết thanh minh/lễ tảo mộ/thanh minh|t
清晨=sáng sớm/tảng sáng/sáng tinh mơ|t
清月=thanh nguyệt|t
清朝=Thanh triều|t
清末=Thanh mạt|t
清清=thanh thanh|t
清秋=thanh thu/Qingqiu/Seishū/Thanh Thu|t
满天=đầy trời|t
满月=trăng tròn/đầy tháng/trăng rằm|t
满朝=cả triều|t
漏夜=đêm khuya/khuya|t
潜伏期=thời kỳ ủ bệnh|t
潜在=tiềm ẩn/giữ tại/ẩn bên trong/tiềm tàng/ẩn ở/ẩn tại|t
潜近=tiềm gần/lẻn vào|t
猛汉=mãnh hán|t
现丑=lộ cái xấu|t
现世=hiện thế/kiếp này/đời này/mất mặt/xấu mặt/nhục nhã|t
现今=hiện nay/ngày nay/bây giờ/hiện giờ|t
现代=hiện đại/thời đại hiện nay/thời đại ngày nay/thời đại xã hội chủ nghĩa|t
现在=hiện tại/hiện nay/bây giờ|t
现如今=hiện nay|t
现年=năm nay|t
现时=hiện thời/hiện nay|t
现阶段=giai đoạn hiện tại/ở giai đoạn hiện tại|t
生前=khi còn sống/sinh tiền/lúc còn sống|t
生日=sinh nhật/ngày sinh/ngày ra đời/ngày thành lập|t
生番=sinh phiên/tộc mọi/bọn mọi rợ/mọi rợ|t
甲午=giáp ngọ|t
畴日=ngày trước/ngày xưa/trước kia|t
畴昔=ngày trước/trước kia/xưa kia/trước đây/ngày xưa|t
白前=bạch tiền|t
白去=đi không/đi làm công toi|t
白夜=đêm trắng/bạch dạ|t
白天=ban ngày|t
白底=nền trắng/đế trắng|t
白日=ban ngày/ban ngày ban mặt/mặt trời/thái dương/thời gian/thì giờ|t
白来=đến không|t
盛唐=Thịnh Đường|t
盛年=thịnh niên|t
目下=trước mắt/hiện nay/hiện giờ|t
目不瞬=không chớp mắt|t
目今=hiện nay/trước mắt/hiện thời|t
目内=trong mắt|t
目前=trước mắt/hiện nay|t
目明=mắt sáng|t
目次=mục lục/thứ tự|t
目里=trong mắt|t
眼下=dưới mắt/lúc này/trước mắt/trước mắt|t
眼前=trước mắt/trước mặt/hiện nay|t
眼周=vành mắt|t
眼底=đáy mắt/tầm mắt/trong mắt|t
眼时=trước mắt|t
瞬中=trong nháy mắt|t
瞬回=hồi phục lập tức|t
瞬子=thuấn tử|t
瞬息=chớp mắt/ngay lập tức/phút chốc/trong nháy mắt/trong chớp mắt|t
瞬息间=trong chớp mắt/trong thời gian ngắn|t
瞬时=tức thời/trong nháy mắt|t
瞬时间=trong nháy mắt|t
瞬眼间=trong nháy mắt/trong chớp mắt|t
瞬里=trong nháy mắt|t
瞬间=nháy mắt/trong nháy mắt/lập tức|t
石器时代=thời kì đồ đá|t
礼拜一=thứ hai|t
礼拜三=thứ tư/thứ Tư|t
礼拜二=thứ ba/Thứ ba|t
礼拜五=thứ sáu|t
礼拜六=thứ bảy/Thứ bảy|t
礼拜四=thứ năm/Thứ năm|t
礼拜天=ngày chủ nhật/lễ bái thiên/chủ nhật|t
礼拜日=lễ bái mặt trời|t
秋儿=Thu nhi|t
秋叶=Thu Diệp|t
秋夜=đêm thu|t
秋天=mùa thu/trời thu/thu|t
秋季=mùa thu/thu|t
秋日=ngày mùa thu|t
秋晨=Thu Thần|t
秋月=Thu Nguyệt|t
秋末=cuối thu|t
秦五=Tần Ngũ|t
秦天=Tần Thiên|t
秦晋=Tần Tấn|t
秦月=Tần Nguyệt|t
秦朝=Tần triều|t
秦末=cuối Tần/Tần Mạt/cuối triều đại nhà Tần năm 207 trước Công nguyên|t
立冬=lập đông|t
童年=tuổi thơ/thời thơ ấu/lúc nhỏ/tuổi thơ ấu/thời niên thiếu/tuổi ấu thơ|t
端上来=bưng lên|t
端午=Đoan Ngọ|t
端午节=tiết Đoan Ngọ|t
端底=cuối cùng/rốt cuộc/nguyên nhân/tình hình cụ thể/tình hình chi tiết|t
端月=tháng giêng|t
端末=device|t
端节=tết Đoan Ngọ|t
端靖=Đoan Tĩnh|t
第一晚=đêm đầu/buổi chiều đầu tiên|t
第一阶段=giai đoạn thứ nhất|t
第三阶段=giai đoạn thứ ba|t
第二阶段=giai đoạn thứ hai|t
第四纪=kỷ đệ tứ/kỷ thứ tư|t
第四阶段=giai đoạn thứ tư|t
翌=dực|t
翌年=năm tới|t
翌日=hôm sau/ngày mai/ngày hôm sau|t
翌晨=sớm mai/sáng sớm ngày mai/sáng hôm sau|t
老一代=đời cũ|t
老半天=cả buổi/cả buổi trời/rất lâu/thật lâu|t
老去=già đi|t
老周=lão Chu|t
老四=lão tứ/lão Tứ|t
老天=lão thiên/lão Thiên/ông trời|t
老宋=lão Tống|t
老年=lão niên/già nua/người già|t
老底=nội tình/gốc gác/nguồn cơn/của gia bảo/vốn liếng/lão để|t
老早=sớm/trước/lâu/đã sớm|t
而今=bây giờ/ngày nay/mà nay/hiện nay/lúc này|t
而去=mà đi/đi|t
腊八=ngày mồng tám tháng chạp|t
腊八节=tết mồng tám tháng chạp|t
腊日=mồng tám tháng chạp;/mồng tám tháng chạp|t
腊月=tháng chạp|t
节下=tết nhất/trong ngày tết/ba ngày tết/những ngày gần tết|t
节假日=ngày nghỉ lễ|t
节庆=tiết khánh/festival|t
节日=ngày lễ/ngày hội/ngày tết|t
节节=liên tiếp/kế tiếp/lần lượt/duy trì ổn định/ổn định/tiết tiết|t
花季=hoa quý|t
虎年=năm cọp/năm hổ|t
西历=dương lịch/lịch tây/công lịch|t
西去=đi tây phương/đi hướng tây|t
西周=Tây Chu/tây chu|t
西天=Tây Thiên/trời tây/thế giới cực lạc/cõi cực lạc/tây thiên|t
西晋=Tây Tấn|t
西秦=Tây Tần|t
西魏=Tây Ngụy/Tây Nguỵ|t
解放前=trước giải phóng|t
解放后=sau giải phóng|t
课时=giờ dạy học/tiết dạy/giờ lên lớp|t
谷底=đáy cốc/thấp nhất/mức thấp nhất/đáy vực|t
赛前=lúc trước|t
赛后=sau trận đấu|t
赛季=trận đấu mùa giải/mùa giải|t
转眼间=trong nháy mắt/trong nháy/chớp mắt|t
转瞬=thoáng qua/nháy mắt/chớp mắt/chẳng mấy chốc/giây lát/chốc lát|t
转瞬间=qua trong giây lát|t
辰时=giờ Thìn|t
辽朝=Liêu triều|t
过不去=không qua được/gây khó dễ/trở ngại/cản trở/không đi qua được/làm khó dễ/gây khó khăn/áy náy/băn khoăn|t
过不来=không qua được|t
过世=qua đời/mất/tạ thế|t
过个年=tết nhất/ăn tết|t
过五旬=quá ngũ tuần|t
过些日子=qua ít ngày/qua mấy ngày|t
过儿=Quá nhi/lần|t
过冬=qua mùa đông/sống qua mùa đông/trú đông|t
过午=quá trưa/quá ngọ/buổi chiều|t
过半=hơn phân nửa/quá bán/quá nửa/hơn nửa|t
过去=quá khứ/trôi qua/đi qua/đã qua/qua/đi/tới|t
过后=qua đi/sau này/mai sau/sau đó/sau/đi qua|t
过夜=qua đêm/ngủ qua đêm/cách đêm|t
过大年=qua tết/qua đại niên|t
过年=ăn tết/lễ mừng năm mới/tết/sau tết/qua tết/sang năm/năm tới/tết đến|t
过往=quá khứ/qua lại/đã qua/đi lại/vãng lai/đi lại với nhau/tới lui|t
过早=quá sớm/sớm/non/trước|t
过时=quá hạn/quá kỳ/quá thời gian/quá thời gian qui định/lỗi thời/cổ lỗ sĩ/không hợp thời|t
过晌=quá trưa/quá ngọ|t
过晚=quá muộn|t
过期=quá thời hạn/quá hạn/hết hạn|t
过来=tới/nhiều/đủ/quá/về/đến/qua/sang đây/qua đây/lại đây/đối mặt/đối diện/trở lại/trở về/lại|t
过生日=sinh nhật/ăn sinh nhật/ngày sinh nhật|t
过节=nghỉ lễ/khúc mắc/chơi hội/quá tiết/ăn tết/đụng chạm/ăn tết (quá tiết)/quan hệ|t
近一半=gần một nửa|t
近三年=gần ba năm|t
近世=cận đại|t
近些年=những năm gần đây|t
近些年来=những năm gần đây/mấy năm gần đây|t
近代=cận đại/thời đại tư bản chủ nghĩa|t
近前=phụ cận/trước mắt|t
近半=gần nửa|t
近古=cận cổ/thời cận cổ đại|t
近古时代=Cận Cổ thời đại|t
近年=năm gần đây|t
近年来=năm gần đây|t
近日=gần đây/ngày gần đây/mấy ngày qua/dạo này/mới đây|t
近期=gần đây/sắp tới/cận kỳ|t
近来=gần đây/dạo này/vừa qua|t
这些年来=những năm gần đây/những năm gần đây này|t
远去=đi xa|t
远古时代=thời đại viễn cổ/viễn cổ thời đại|t
远近=xa gần/chừng/khoảng cách xa gần/gần xa|t
逾常=quá chừng/quá đỗi/quá mức|t
逾期=quá hạn/quá kỳ hạn|t
道天=đạo thiên|t
那今=cái kia|t
那前=trước đó/cái kia trước|t
那瞬=giây lát kia|t
酉时=giờ Dậu|t
酒后=say rượu|t
重九=trùng dương/trùng cửu/lễ mùng 9 tháng 9|t
重午=trùng ngọ/tết đoan ngọ/tết mùng 5 tháng năm|t
闰年=năm nhuận/năm nhuần|t
闰日=ngày nhuận/ngày nhuần|t
闰月=tháng nhuận/tháng nhuần|t
闲年=năm nhàn nhã|t
闲时=nhàn rỗi|t
闲汉=nhàn hán/đầu gấu/người nhàn rỗi|t
除去=trừ bỏ/bỏ/từ bỏ/trừ khi/chỉ có/trừ phi/trừ đi/ngoại trừ|t
除夕=giao thừa/trừ tịch|t
除夕夜=đêm trừ tịch/đêm trừ tịch - đêm 30|t
除夜=đêm giao thừa/tối trừ tịch|t
隆中=Long Trung|t
隆元年=long nguyên niên|t
隆冬=rét đậm|t
隆庆=Long Khánh|t
隋代=đời Tùy|t
隋初=Tuỳ Sơ|t
隋唐=Tùy Đường|t
隋朝=Tùy triều/nhà Tùy|t
隋末=Tùy mạt/cuối đời Tùy/cuối thời nhà Tùy|t
雨前=trước khi mưa/chè xuân|t
雨后=sau cơn mưa|t
雨夜=đêm mưa|t
雨天=trời mưa/ngày mưa|t
雨季=mùa mưa|t
雨月=Vũ Nguyệt|t
雪夜=tuyết dạ/đêm tuyết/tuyết đêm|t
雪月=tuyết nguyệt|t
震天=chấn thiên/rung trời|t
震旦=Chấn Đán/tên Ấn Độ cổ đại cho Trung Quốc|t
霎时=thoáng chốc|t
霎时间=chỉ một thoáng/trong nháy mắt/trong chốc lát|t
霎那=sát na/chốc lát|t
霎那间=trong chốc lát/trong giây lát đó|t
霎里=giữa  một thoáng|t
霎霎=chớp chớp|t
霜天=mù sương/trời sương|t
霜晨=buổi sớm đầy sương|t
霜露=nước sương|t
青唐=Thanh Đường|t
青天=thanh thiên/trời xanh/Thanh Thiên/quan thanh liêm|t
青年=thanh niên/tuổi trẻ/tuổi xuân|t
青年一代=thế hệ thanh niên|t
青年节=ngày thanh niên|t
青春期=tuổi dậy thì/thời kỳ trưởng thành/thời kỳ dậy thì|t
青铜器时代=thời đại đồ đồng/thời kỳ đồng thiếc|t
顷刻间=trong khoảnh khắc|t
顺天=thuận thiên/thuận lòng trời|t
顺朝=thuận triều|t
顺治=Thuận Trị|t
须往=phải hướng|t
须臾=giây lát/chốc lát|t
饭前=trước khi ăn cơm/phạn tiền/trước khi dùng cơm/trước khi ăn|t
饭后=sau bữa ăn/sau khi ăn xong|t
饭时=giờ cơm|t
首代=đời đầu|t
首日=ngày đầu/ngày đầu tiên|t
黄上=hoàng thượng|t
黄初=hoàng sơ|t
黄昏=hoàng hôn/xế chiều/lúc mặt trời lặn|t
黄金时代=thời đại hoàng kim/thời hoàng kim/thời vàng son|t
黎明前=trước tờ mờ sáng|t
黎晨=Lê Thần|t
黎朝=Lê triều|t
