峻=tuấn|ag
忤=ngang ngược|ag
悫=khác|ag
燠=úc|ag
睦=hòa thuận|ag
笃=đốc/soạt|ag
莠=xấu|ag
褊=biển|ag
邃=thúy|ag
醇=thuần|ag
黢=xuất|ag
踊=dũng|ad
盥=quán|b
绛=giáng/đỏ thẫm|b
並=tịnh|c
但=nhưng/vậy|c
倘=thảng/nhưng|c
傥=thảng|c
及=cùng/và/cập/kịp/tới|c
和=cùng/và/hòa/như|c
并=cũng/đồng thời/tịnh|c
或=hoặc/có lẽ/có thể|c
而=mà|c
雖=tuy|c
呦=u/ôi|e
呸=phi|e
咦=a/ồ/di|e
哎=ai|e
嗨=này/hải/high|e
嗬=ôi|e
嗯=ân/ừ/ừm/ân/dạ|undefined
嗳=ai|e
噫=y|e
噯=ai|e
嚯=hoắc/ồ|e
诶=ài/ấy/ôi chao|e
久=lâu/cửu|a
倔=bướng bỉnh|a
傲=ngạo|a
兇=hung|a
嘹=liệu|a
孱=mềm yếu|a
尴=lúng túng khó xử|a
強=cường|a
忿=phẫn|a
惆=trù|a
惡=ác|a
憔=tiều|a
暖=ấm/noãn/ấm áp|a
涩=chát chát|a
滂=bàng|a
潦=lạo|a
煳=hồ|a
犟=cưỡng|a
犷=hung ác|a
猖=xương|a
痒=ngứa/nhột/dương/ốm|a
瘪=xẹp/quắt|a
矍=quắc|a
禳=nhương|a
稠=nhiều|a
窄=hẹp/chật vật|a
粲=sán|a
綺=khỉ|a
缥=phiêu|a
肮=khảng|a
胀=trướng|a
脆=giòn|a
腼=điến|a
臟=tạng|a
艳=diễm/tươi đẹp|a
诧=sá/kinh ngạc|a
蹊=hề|a
蹩=biệt|a
遲=trì|a
酽=nghiệm|a
险=hiểm|a
颟=man|a
馊=thiu|a
馋=thèm/tham|a
龌=ác|a
也=cũng/vậy/cũng/thì|d
乱=loạn/bậy|d
亦=cũng/diệc|d
仅=vẻn vẹn/chỉ|d
便=liền/dễ/lại/tiện|d
再=lại/tái/nữa/sẽ|d
勿=chớ/vật|d
却=lại/nhưng|d
又=lại/hựu/vừa|d
囫=hốt|d
均=đồng đều/quân/cùng/đều/đều|d
將=tương|d
尤=càng|d
就=liền/thì/tựu/ắt/thành/chính|d
屡=nhiều lần|d
已=đã/thôi/dĩ|d
必=tất/nhất định/tất nhiên|d
忒=quá|d
恰=vừa/đúng/vừa lúc|d
悻=hãnh|d
才=mới/tài|d
更=càng/canh/đổi/lại thêm/hơn|d
曾=từng/tằng/bèn|d
渐=dần/dần dần/tiệm|d
甫=vừa/phủ|d
皆=đều/đều là/giai/toàn là/cũng/tất cả|d
竟=lại/mà/cánh/ắt/rốt cuộc/nhất định/cuối cùng/càng|d
蓦=đột nhiên|d
詎=cự|d
讵=cự|d
還=hoàn|d
都=đều/cũng/đô/thủ đô|d
颇=có phần/khá|d
旁=bên cạnh/bàng/cạnh/bên|f
丐=cái|g
丕=phi|g
仑=luân|g
佗=đà|g
佥=thiêm|g
佶=cát|g
佻=điệu|g
佾=dật|g
侑=hựu|g
侔=mâu|g
侩=quái|g
侪=sài|g
侬=nông/anh|g
俪=lệ|g
倌=quan|g
倬=trác|g
倮=khỏa|g
偾=phẫn|g
傩=na|g
僖=hi|g
僦=tựu|g
僭=tiếm|g
儆=cảnh|g
儇=uyên|g
兕=tê giác|g
冽=liệt|g
凼=đãng|g
刎=vẫn|g
刖=ngoạt|g
刳=khô|g
劢=mại|g
劬=cù|g
劭=thiệu|g
劾=hặc|g
勖=úc|g
勗=úc|g
勰=hiệp|g
匦=quỹ|g
卣=dữu|g
卺=cẩn|g
厍=xá|g
厣=áp|g
厶=khư|g
叟=tẩu|g
叻=lặc|g
吒=tra|g
呶=nao|g
哙=khoái|g
哜=tễ|g
哿=cả|g
唪=phủng|g
唳=lệ/Lê-eeee-eezz~!|g
啕=đào|g
啭=chuyển|g
啻=chỉ|g
喁=ngung|g
喟=vị|g
喾=khốc|g
嗌=ách|g
嗪=tần|g
嗾=thốc|g
嘏=hỗ|g
圉=ngữ|g
圊=thanh|g
圬=ô|g
圯=di|g
圻=kỳ|g
坌=bộn|g
坫=điếm|g
坭=nê|g
坳=thung lũng|g
坻=trì|g
垌=lan/động|g
垓=cai|g
垡=phạt|g
垤=điệt|g
垩=ác|g
垴=não|g
埏=duyên|g
埒=liệt|g
埔=bộ|g
埕=trình|g
埯=yểm|g
埴=thực|g
埸=dịch|g
埽=tảo|g
堋=bằng|g
堞=điệp|g
堠=hậu|g
塄=lăng|g
塍=thăng|g
塥=cách|g
墀=trì|g
墉=dung|g
墚=lương|g
夼=khoảng|g
奁=liêm|g
奐=hoán|g
奘=trang|g
妗=cấm|g
妪=ẩu|g
妫=quy|g
妲=đát|g
姒=tự|g
姝=thù|g
娠=thần|g
娣=đệ|g
婧=tịnh/nhu|g
媪=ảo|g
媵=thiếp|g
媸=xuy|g
嫘=luy|g
嫜=chương|g
嫠=ly|g
嫫=mô|g
嫱=tường|g
嬖=bế|g
嬲=điểu|g
宕=đãng|g
宥=hựu|g
宸=thần|g
尻=khào|g
屙=a|g
屣=tỷ|g
屦=lũ|g
岈=nha|g
岍=khiên|g
岙=Áo|g
岜=bát|g
岢=khả|g
岣=cẩu/câu|g
岵=hỗ|g
岽=đông|g
峁=mão/Mão|g
峄=dịch|g
峒=động|g
峤=kiệu|g
峦=loan|g
峪=dụ|g
崃=lai|g
崞=quách|g
崤=hào|g
崮=cố|g
嵊=thặng|g
嵋=mi|g
嵛=du|g
嵝=lũ/Lũ|g
嵬=ngôi|g
嶝=đặng|g
嶠=kiệu|g
嶷=nghi|g
巯=khưu|g
巽=tốn|g
帑=nô|g
帔=bí|g
帻=trách|g
幄=ác|g
幞=phốc|g
庀=phỉ|g
庋=kỹ|g
庠=tường|g
庳=bí|g
廑=cần|g
廒=ngao|g
廛=triền|g
廨=giải|g
廪=lẫm|g
廷=đình/triều đình|g
弁=biện|g
弼=bật|g
彖=thoán|g
彘=trệ|g
彥=ngạn|g
徂=tồ|g
徼=kiếu|g
忭=biện|g
忮=kỹ|g
忾=hi|g
怊=siêu|g
怙=hỗ|g
怫=phật|g
怼=đỗi/oán/đánh/đập/chọc|g
怿=dịch|g
恂=tuân/Tuân|g
恚=khuể|g
恧=nục|g
恺=khải|g
悃=khổn|g
悌=đễ/kính|g
悛=thuân|g
悝=khôi|g
悯=mẫn|g
惕=kính sợ|g
愆=khiên|g
愍=mẫn|g
愎=phức|g
愫=tố|g
慊=khiểm|g
慝=thắc|g
憝=đỗi|g
憷=sợ hãi|g
懋=mậu|g
懑=muộn|g
懔=lẫm|g
懟=đỗi|g
戤=ngái|g
戬=tiển|g
扃=quynh|g
拊=phụ|g
拶=tạt|g
挈=khiết|g
挞=thát|g
捃=quấn|g
捩=liệt|g
掇=xuyết|g
掊=bồi|g
掎=kỷ|g
掾=duyện|g
揄=du|g
揲=thiệt|g
搦=nạch|g
搴=khiên|g
搿=cách|g
摅=sư|g
摭=trích|g
撄=anh|g
撖=hàn|g
擐=hoàn|g
擘=phách/ngón cái|g
擢=trạc|g
敉=mị|g
敫=kiểu|g
旃=chiên|g
旄=mao|g
旆=bái|g
旒=lưu|g
旰=cán|g
昀=quân/vân|g
昃=trắc|g
昕=hân|g
昱=dục|g
昴=mão/Subaru|g
昶=sưởng|g
晔=diệp|g
晗=hàm|g
晟=thịnh|g
晡=giờ Thân|g
晰=tích/rõ ràng|g
晷=quỹ|g
暇=rảnh|g
暾=thôn|g
曛=huân|g
曩=nẵng|g
曷=hạt|g
朊=nguyễn|g
朐=cù|g
朕=trẫm|g
杌=ngột|g
杼=trữ|g
枋=phương|g
枘=nhuế|g
枥=lịch|g
枧=kiển|g
枨=tranh|g
枵=hiêu|g
柁=đả|g
柢=để|g
柰=nại|g
栉=trất|g
栊=long|g
桊=quyên|g
桢=trinh/Trinh|g
桤=khởi|g
桴=phù|g
桷=giác|g
梏=cùm|g
棂=linh|g
椁=quách|g
椐=cư|g
椠=tạm|g
楗=kiện|g
楣=mi|g
楸=thu|g
榄=lãm|g
榇=sấn|g
榭=tạ|g
榱=suy|g
榷=các|g
槁=khô héo|g
槊=sóc/giáo|g
樗=xư|g
樾=việt|g
橇=khiêu|g
橥=trư|g
檫=sát|g
櫛=trất|g
歆=hâm|g
殂=chết|g
殄=điễn|g
殛=cức|g
殪=ế|g
毖=bí|g
毪=mâu|g
毳=thuế|g
氅=áo  khoác/áo cừu/áo khoác|g
氐=để|g
氕=ách|g
氘=đao|g
氚=xuyên|g
氡=đông|g
氪=khắc|g
汐=tịch/Tịch|g
汔=khất|g
沩=Viên|g
泐=lặc|g
泖=mão|g
泞=nính|g
洌=liệt|g
洎=kịp|g
洙=thù|g
洧=vị|g
洫=hức|g
洵=tuân|g
洹=hoàn|g
浃=tiếp|g
浈=trinh|g
浍=quái|g
浠=hy|g
浯=ngô|g
涑=tốc|g
涔=sầm|g
涞=lai|g
涫=loan|g
淇=kỳ|g
淖=náo|g
淝=phì|g
淞=tùng|g
淠=tụy|g
渌=lục|g
渫=tiết|g
湓=bồn|g
湔=tiên|g
湫=tưu/thấp trũng hồ nước|g
溆=tự|g
溏=đường|g
溟=minh|g
溧=lật|g
溱=trăn|g
滏=phũ|g
滓=cặn|g
滠=nhiếp|g
滢=oánh|g
潁=toánh|g
澈=triệt|g
澉=cảm|g
澌=ti|g
澍=chú|g
澶=thiền|g
濂=liêm|g
濉=tuy|g
濠=hào|g
瀵=phẫn|g
瀹=thược|g
灏=hạo|g
灸=cứu|g
炅=cảnh|g
炬=bó đuốc|g
烬=tẫn|g
焓=hàm|g
焱=diễm|g
熵=entropy|g
燔=phần|g
燮=tiếp|g
燹=tiển|g
爰=viên|g
牒=điệp|g
牮=tiến|g
狃=nữu|g
猃=hiểm|g
猬=vị|g
猱=nhu|g
獍=kính|g
獒=ngao|g
獭=rái cá|g
獾=chồn|g
玑=cơ|g
珈=già|g
珏=giác|g
珙=củng|g
珧=diêu|g
琊=gia|g
琏=liễn|g
琛=sâm|g
琨=côn|g
琬=uyển|g
琮=tông|g
琰=diễm|g
瑗=viện|g
瑛=anh|g
瑭=đường|g
璁=thông|g
璇=tuyền|g
璋=chương|g
璨=xán|g
瓴=linh|g
瓿=bẫu/vò/bình|g
甍=manh|g
甓=bích|g
甙=đại|g
甾=tai|g
畀=tí|g
畎=quyến|g
畛=chẩn|g
畴=trù/dự định|g
疃=thoản|g
疋=sơ|g
疚=day dứt|g
疠=lệ|g
疡=dương|g
疣=vưu|g
疴=a|g
疽=thư|g
痍=di|g
痖=á|g
瘀=ứ|g
瘕=hà|g
瘗=ế|g
瘘=lũ|g
瘵=ốm|g
瘼=mạc|g
瘿=anh|g
癜=điến|g
癯=cù|g
皋=cao|g
皙=tích|g
皤=bà|g
盂=vu|g
盍=hạp|g
眇=mù|g
眢=oan|g
眦=khóe mắt|g
眵=si|g
睐=liếc/lãi|g
睑=kiểm|g
睽=khuê|g
瞀=mậu|g
瞍=tẩu|g
瞢=măng|g
瞰=khám|g
瞽=cổ|g
矶=ki/mỏm đá/ki|g
砀=nãng|g
砑=nhạ|g
砜=phong|g
砦=trại|g
砬=lạp/đá|g
砹=Astatine|g
硎=hình|g
硐=đồng|g
硖=giáp|g
硪=ngã|g
碇=đĩnh|g
碓=đối|g
碚=bối|g
碛=thích|g
碥=biển|g
碲=đế|g
磔=trách|g
礅=đôn|g
祀=tự|g
祓=phất|g
祗=chi|g
祚=tộ|g
祜=hỗ|g
祟=túy/ma|g
祧=thiêu|g
祯=trinh/Trinh|g
祺=kỳ/Kỳ|g
禊=hễ|g
禧=hi|g
禺=ngu|g
秣=mạt|g
稂=lang|g
稃=phù|g
稣=tô|g
稷=tắc|g
穰=nhương|g
窆=biếm|g
窬=du|g
窭=cũ|g
竦=tủng|g
竽=vu|g
笄=kê|g
笈=tráp/cấp|g
笕=kiển|g
笫=chỉ|g
笮=trách|g
笳=già|g
笾=biên|g
筌=thuyên|g
筮=thệ|g
筱=tiêu|g
筲=sao|g
筻=cánh|g
箐=tinh/thiến|g
箕=ki|g
箦=trách|g
箨=thác|g
篁=hoàng|g
篚=phỉ|g
篪=trì|g
簏=lộc|g
簖=đoán|g
簟=điệm|g
籀=trứu|g
粑=ba|g
粕=phách|g
粝=lệ|g
粞=tê|g
粢=tư|g
糇=hầu|g
糈=tư|g
紆=hu|g
絷=trập|g
縻=mi|g
纡=quanh co|g
纩=khoáng|g
纫=nhân|g
纾=thư|g
绀=cám|g
绁=tiết|g
绂=phất|g
绋=phất|g
绌=truất|g
绎=dịch|g
绐=đãi|g
绠=cảnh|g
绡=tiêu|g
绨=đề|g
缁=truy|g
缃=tương|g
缇=đề|g
缋=hội|g
缌=ti|g
缏=biền|g
缑=câu|g
缛=nhục|g
缟=cảo|g
缡=ly|g
缢=treo cổ|g
缣=kiêm|g
缬=hiệt|g
缯=tăng|g
缳=hoán|g
缵=toản|g
罔=võng|g
罘=chúng|g
罟=cổ|g
罨=yểm|g
罴=bi|g
罾=tăng|g
羝=đê|g
羲=hi|g
羼=sạn|g
翊=dực|g
翮=cách|g
翳=ế|g
耋=điệt|g
耧=máy gieo hạt|g
耨=nậu|g
耩=giảng|g
耱=ma|g
聃=đam|g
聩=hội|g
肜=dung|g
肟=ốc|g
肫=truân|g
肴=đồ ăn|g
肷=hàm|g
肼=tỉnh|g
胂=thân|g
胄=trụ|g
胍=qua|g
胗=truân|g
胙=tạc|g
胤=dận|g
胨=đống|g
胩=ca|g
胪=lư|g
脎=thỏa|g
脒=mễ|g
脔=luyến|g
脘=quản|g
脞=thỏa|g
脯=mứt|g
脲=niệu|g
腑=phủ|g
腙=tông|g
膊=cánh tay|g
膑=tẫn|g
膦=hợp chất hữu cơ|g
臁=liêm|g
舜=thuấn|g
舡=hang|g
舣=nghĩ|g
舸=khả|g
舻=lô|g
艉=vĩ|g
艏=thủ|g
艚=tào|g
艮=cấn|g
芑=khỉ|g
芰=kỵ|g
芴=vật|g
苊=ách|g
苡=dĩ|g
茑=điểu|g
茚=ấn|g
荃=thuyên|g
荑=đề|g
荛=nhiêu|g
荦=lạc|g
荩=tẫn|g
莓=dâu|g
莛=đình|g
莰=khảm|g
莸=du|g
菘=tùng|g
菰=cô|g
菹=trư|g
萁=ki|g
萑=hoàn|g
萘=đồ|g
萜=thiếp|g
葑=phong|g
葭=gia|g
葸=tỷ|g
葺=tập|g
蒇=siển|g
蒈=khải|g
蒎=phái|g
蒗=lang|g
蒴=sóc|g
蒹=kiêm|g
蓍=thi|g
蓐=nhục|g
蔼=ái|g
蕈=khuẩn|g
薇=vi|g
薤=giới|g
薨=hoăng|g
薮=tẩu|g
藜=lê|g
蘩=phiền|g
虮=kỷ|g
虻=manh|g
虿=sái|g
蚋=nhuế|g
蚤=bọ chét/tảo|g
蚴=ấu|g
蛎=lệ|g
蛘=dạng|g
蛩=cung|g
蛭=đỉa/điệt|g
蛹=kén|g
蜩=điêu|g
蜮=vực|g
蜱=tỳ|g
蝽=xuân|g
螗=đường|g
螨=mãn|g
螭=ly|g
蟊=mâu|g
衄=nục|g
衮=cổn|g
衲=nạp|g
衿=khâm|g
袄=áo|g
袤=mậu|g
袱=phục|g
裉=khẳng|g
裒=bầu|g
裰=chuyết|g
裼=tích|g
褙=bối|g
褰=khiên|g
褵=ly|g
襞=bích|g
襦=nhu|g
觇=siêm|g
觋=hích|g
觌=địch|g
觯=chí|g
訶=ha|g
詈=lỵ|g
詒=di|g
謇=kiển|g
讦=kiết|g
讧=hồng|g
讫=cật|g
诂=cổ|g
诃=ha|g
诒=di|g
诖=quái|g
诩=hủ|g
诮=tiếu|g
诼=trác|g
谀=du|g
谂=thẩm|g
谇=tối|g
谑=hước|g
谖=huyên|g
谘=ti|g
谝=biển|g
谟=mô|g
谠=đảng|g
谡=tắc|g
谧=mật|g
谫=tiễn|g
谮=trấm|g
谳=nghiện|g
豳=bân|g
豸=trĩ|g
貊=mạch|g
貘=heo vòi|g
贶=huống|g
贽=chí|g
赀=ti|g
赆=tẫn|g
赍=tê|g
赜=trách|g
趱=toản|g
趺=phu|g
趼=nghiễn|g
跖=chích|g
跣=tiển|g
跬=khuể|g
跸=tất|g
跽=kỵ|g
踔=trác|g
踣=té ngã|g
踵=chủng|g
蹯=phiền|g
蹴=xúc|g
蹶=quyết|g
躐=liệp|g
躔=triền|g
躜=toàn|g
轫=nhận|g
轭=ách|g
轵=chỉ|g
轸=chẩn|g
轺=diêu|g
轼=thức|g
辂=lộ|g
辇=liễn/xe kéo|g
辋=võng|g
迓=nhạ|g
迕=ngỗ|g
迨=đãi|g
迩=nhĩ|g
逑=cầu|g
逖=địch|g
逵=quỳ|g
遄=thuyên|g
遘=cấu|g
邡=phương|g
邶=bội|g
邺=nghiệp|g
邾=chu|g
郅=chất|g
郐=cối|g
郛=phu|g
郢=dĩnh|g
郧=vân|g
郾=yển|g
鄄=quyên|g
鄣=chướng|g
鄹=châu|g
酃=linh|g
酎=trữu|g
酐=can|g
酢=tạc|g
酤=cô|g
酮=đồng|g
酲=trình|g
酴=đồ|g
醑=tữ|g
醢=hải|g
醮=tiếu|g
醯=dấm/ê|g
醵=cự|g
醺=say/say rượu|g
鉅=cự|g
銎=khung|g
鋈=ốc|g
钆=ca|g
钇=ất|g
钊=chiêu|g
钐=cắt|g
钕=nữ|g
钜=cự|g
钣=bản|g
钪=cang|g
钫=phương|g
钯=ba|g
钰=ngọc|g
钲=chinh|g
钷=phả|g
钿=điền|g
铉=huyễn|g
铊=tha|g
铋=bí|g
铍=phi|g
铑=lão|g
铒=nhĩ|g
铖=thành|g
铗=kiệp|g
铨=thuyên|g
铩=sát|g
铪=ha/cáp|g
铫=diêu|g
铯=sắc|g
铷=như|g
铼=lai|g
铽=thác|g
锇=nga|g
锎=khai|g
锏=giản|g
锓=tẩm|g
锔=cư|g
锕=a|g
锘=nặc|g
锝=đắc|g
锞=quả|g
锟=côn|g
锢=cố|g
锫=bầu|g
锬=đàm|g
锴=khải|g
锷=ngạc|g
镄=phí|g
镅=Americium|g
镓=gia|g
镘=man|g
镛=dung|g
镝=đích|g
镤=mộc|g
镥=lỗ|g
镦=đối|g
镨=phổ|g
镩=thoản|g
镫=đăng|g
镱=ý|g
镳=tiêu|g
闱=vi|g
闼=thát|g
阃=khổn|g
阋=huých|g
阌=văn|g
阒=khuých|g
阱=tịnh|g
阼=tộ|g
阽=diêm|g
陉=hình|g
陔=cai|g
陬=tưu|g
陲=thùy|g
陴=bì|g
隈=ôi|g
隍=hoàng|g
隰=thấp|g
隳=huy|g
隹=chuy|g
隼=chuẩn/chim cắt/lỗ/Chim Cắt|g
雎=sư|g
雠=thù|g
雩=vu|g
霆=đình|g
霈=bái|g
霾=mai|g
靥=má lúm đồng tiền/lúm đồng tiền|g
靨=yếp|g
鞒=kiều|g
鞫=cúc|g
韫=uẩn|g
顰=tần|g
顼=húc|g
颡=tảng|g
颢=hạo/run|g
颦=tần/nhăn mày|g
飑=tiêu/đua|g
飧=sôn|g
餍=yếm|g
饔=ung|g
饩=hí|g
饪=nhẫm|g
饫=ứ|g
饬=sức|g
馀=dư|g
馐=tu|g
馔=soạn|g
馕=hướng|g
馗=quỳ|g
馘=quắc|g
驵=tảng|g
驺=sô|g
骐=kỳ|g
骓=chuy|g
骘=chất|g
骛=theo đuổi|g
骜=ngao|g
骝=lưu|g
骞=khiên|g
骢=thông|g
骣=sản|g
骱=giới|g
髀=bễ|g
髁=khỏa|g
髓=tủy|g
髡=khôn|g
髦=mao|g
髫=thiều|g
髹=hưu|g
髻=búi tóc|g
鬈=quyền|g
鬏=thu|g
鬟=hoàn|g
鬯=sưởng|g
魑=Si|g
鮪=vị|g
鲂=phường|g
鲆=bình|g
鲈=lư|g
鲋=phụ|g
鲎=hấu|g
鲐=thai|g
鲔=vị|g
鲚=tễ|g
鲛=giao|g
鲞=tưởng|g
鲟=tầm|g
鲧=Cổn|g
鲩=cán|g
鲭=chinh|g
鲰=tưu|g
鲴=cố|g
鲵=nghê|g
鲷=điêu|g
鲺=sắt|g
鲻=tri|g
鲼=phẫn|g
鲽=điệp|g
鳌=ngao|g
鳎=tháp|g
鳐=diêu|g
鳓=lặc|g
鳘=mẫn|g
鳢=lễ|g
鸫=đông|g
鸱=si|g
鸲=cù|g
鹎=chim tu ti|g
鹛=mi|g
鹣=kiêm|g
鹨=lưu|g
鹾=ta|g
麇=quân|g
麈=chủ|g
黉=huỳnh|g
黥=kình|g
黹=chỉ|g
黻=phất|g
黼=phủ|g
鼍=đà|g
鼐=nãi|g
鼗=đào|g
齎=tê|g
龀=sấn|g
龆=điều|g
龈=ngân|g
龠=dược|g
寅=dần|mg
巳=tị|mg
们=nhóm/môn/các/cửa/bọn họ|k
者=người/giả/cái|k
寧=ninh|j
斐=phỉ|j
沪=hỗ|j
沽=cô|j
渝=du/Du - Tứ Xuyên|j
滇=điền|j
滦=loan|j
畲=xa|j
粤=Quảng Đông/Việt(quảng đông)|j
蓉=dung|j
黔=kiềm|j
嗲=ỏn ẻn/điệu|l
一=một/một khi/nhất/vừa|m
万=vạn|m
两=hai/lượng/lưỡng|m
亿=ức/trăm triệu|m
仟=thiên|m
仨=ba|m
佰=bách|m
俩=hai/lưỡng|m
六=sáu/lục/ngưu|m
几=mấy/hầu như/vài|m
叁=tam/ba|m
垧=thưởng|m
壬=nhâm|m
多=nhiều/thêm/cỡ nào/đa|m
廿=hai mươi|m
捌=bát|m
柒=thất|m
玖=cửu|m
贰=nhị|m
佬=lão|ng
俑=tượng/tượng (chôn chung với người chết)|ng
俳=bài|ng
冢=mộ|ng
刃=lưỡi đao/nhận|ng
勳=huân|ng
卉=hủy|ng
嗣=tự|ng
圃=phố|ng
圹=khoáng|ng
坞=ổ|ng
垠=ngần|ng
垣=viên|ng
垸=viện|ng
埂=canh|ng
埙=huân|ng
埠=phụ|ng
塬=nguyên|ng
墟=khư|ng
壑=khe|ng
夷=di|ng
婿=tế/con rể|ng
寨=trại|ng
屿=tự|ng
巾=khăn|ng
帚=cây chổi|ng
幡=cờ/lá cờ/phiên|ng
庑=vũ|ng
庖=bào|ng
庵=am|ng
役=dịch|ng
忱=thầm|ng
戟=kích|ng
斋=trai/chay|ng
杖=trượng|ng
栎=lịch|ng
梢=sao/ngọn|ng
椒=tiêu/ớt|ng
楦=tuyên|ng
楫=tiếp|ng
槌=chùy|ng
槎=tra|ng
槽=rãnh/cái rãnh|ng
樯=tường|ng
樽=tôn|ng
橹=mái chèo/lỗ/thuẫn|ng
檐=mái hiên nhà|ng
涧=khe|ng
涯=nhai|ng
溴=xú|ng
犊=nghé/độc|ng
玺=tỉ/tỉ (ngọc tỉ)|ng
甏=bảnh|ng
畔=bờ/bên|ng
痹=tý|ng
痺=tí|ng
眚=sảnh|ng
眶=vành mắt|ng
础=sở|ng
磬=khánh|ng
祉=chỉ/Chỉ|ng
秆=thân/cán|ng
稗=bại|ng
竿=can|ng
筏=bè/phiệt|ng
箫=tiêu|ng
篙=cao|ng
簋=quỹ|ng
籁=lại|ng
籍=tịch|ng
粹=túy|ng
繭=kiển|ng
绪=tự|ng
绶=thụ|ng
缨=anh|ng
羹=canh|ng
脛=hĩnh|ng
腠=thấu|ng
膛=thân/lồng ngực/thang/ngực|ng
舶=thuyền đi biển|ng
茔=oanh/phần|ng
茗=minh/trà|ng
莺=oanh|ng
菇=nấm|ng
葩=ba/hoa|ng
蓮=liên|ng
蕊=nhị|ng
蕙=huệ|ng
虏=bắt/bắt làm nô lệ|ng
蝇=ruồi/dăng|ng
蠍=hiết|ng
衫=áo|ng
袂=tay áo/mệ|ng
裳=váy/Thường|ng
觚=cô|ng
讯=tin tức/nhanh/tin|ng
谊=nghị|ng
貉=con chồn|ng
赂=lộ|ng
跤=giao|ng
辏=thấu|ng
辰=thần/Thìn|ng
邑=ấp|ng
邦=bang|ng
酯=chỉ|ng
錘=chuy|ng
钋=polonium|ng
钍=thổ|ng
钗=trâm/sai/thoa cài tóc/trâm (cài tóc)|ng
钬=hoả|ng
钴=cỗ|ng
钺=việt|ng
钽=đán|ng
铌=ni|ng
铳=súng|ng
锑=đễ|ng
锶=tư|ng
镞=thốc|ng
阄=cưu/cái thăm|ng
阍=hôn|ng
隅=góc|ng
隙=khe hở|ng
雉=trĩ|ng
雹=bạc|ng
霭=ai/sương|ng
韁=cương|ng
颊=gò má|ng
颏=hài|ng
馓=tản|ng
驹=câu|ng
髯=râu|ng
鬢=tấn|ng
鬲=cách|ng
鳇=hoàng|ng
鸥=âu/hải âu|ng
鹄=hộc|ng
鹊=chim khách/thước|ng
鹗=ngạc|ng
鹜=vụ|ng
麓=lộc|ng
麟=lân|ng
黍=thử|ng
龛=bàn thờ|ng
婺=vụ|ns
尕=ca|ns
杞=kỷ|ns
沱=đà|ns
洮=thao|ns
洱=nhị|ns
浏=lưu|ns
涪=phù|ns
淄=truy|ns
渭=vị|ns
滁=trừ|ns
滹=hô|ns
漯=tháp|ns
潍=duy|ns
濑=lại|ns
畹=uyển|ns
盱=hu|ns
硇=nao|ns
耒=lỗi|ns
莆=phủ|ns
邯=hàm|ns
郫=bì|ns
郸=đan|ns
鄱=bà|ns
阜=phụ|ns
阪=dốc núi|ns
鲅=cá thu|ns
乓=bang/pằng|o
叭=bá|o
呖=kíu/lịch|o
咚=đông|o
咝=ti/ư|o
咣=cạch|o
咿=y|o
哞=mu/bò....ò.../tiếng bò rống/ò/Ùm...ụm bò....ò...tiếng bò rống|o
哧=xoẹt/xoạt|o
喵=meo/meo ô/meo meo/Meow/miêu|o
嗒=cạch|o
嗖=sưu/vèo/vù|o
嗵=oành|o
嘁=hứ|o
嘣=băng|o
嘭=bành/thình thịch/oành|o
噼=tích|o
嚓=xoạt|o
嚶=anh|o
怦=phanh/thịch|o
橐=bễ thổi lửa|o
汩=cốt|o
淙=tông|o
砉=hoạch|o
砰=phanh/ầm/bịch/phịch|o
芈=mị|o
铛=keng/đang|o
锵=bang/thương/cheng/keng/BOANG...|o
飕=sưu/vù/vèo|o
与=cùng/dữ/và/giống như/cho|p
为=vì/làm/là/vi/vì là/thành|p
于=tại/cho/vu/với/hơn|p
从=từ/theo/tòng|p
向=hướng/hướng về phía/hướng về/xưa đến nay|p
在=tại/đang/ở/再/lại
對=đối|p
把=đem/thanh/bả/ván|p
按=theo/theo như/án/vỗ/ấn/chứng cứ/theo : đè|p
為=vi|p
繇=diêu|p
给=cho/cấp/bị|p
與=dữ|p
被=bị/được/chăn|p
除=trừ|p
乇=thác|q
些=chút/ta/chút ít/những/nhiều|q
仞=trượng|q
句=câu/cú|q
帙=trật|q
帧=tấm/tránh|q
斛=hộc|q
桿=que|q
棵=khỏa/cây/gốc cây|q
楹=doanh|q
樘=đường|q
泓=hoằng/dòng|q
炷=trụ|q
爿=tường|q
犋=cụ|q
畈=phán|q
盎=áng|q
盏=ngọn/chén nhỏ/ngọn đèn|q
磴=đặng|q
級=cấp|q
绺=túm|q
缗=xâu|q
茬=gốc rạ/mảnh vụn (gốc)|q
蔸=đâu|q
锭=thỏi/đĩnh|q
锾=hoàn|q
镒=dật|q
阕=khuyết|q
頁=hiệt|q
他=hắn/nó/khác/她|r
你=ngươi/cậu|r
俺=ta/yêm/ta đây/ore|r
其=nó/nàng/kỳ/hắn/ngoài/của nó/|r
厥=quyết|r
各=các/tất cả/đều/mỗi/mỗi người|r
吾=ngô/ta|r
咋=thế nào/động/người/sao|r
咱=ta|r
啥=cái gì/gì/cái đó|r
她=nàng/mụ/nàng/他|r
孰=ai|r
它=nó/tha/khác|r
怎=sao/chẩm|r
敝=tệ|r
某=nào đó/mỗ//một|r
该=nên/cai/cái kia|r
谁=ai/người đó/người nào/thùy/đó/kẻ đó|r
这=cái này/giá/này/vậy/đây|r
這=giá|r
那=kia/cái kia/vậy/cái nào/đâu/nào/đó|r
等=chờ/các/các loại/mấy người/mấy/bằng/mấy cái/vân vân|u
般=bàn/giống như/vậy|u
的=đích|uj
翌=dực|t
佚=dật/ẩn|vg
侈=xỉ|vg
償=thường|vg
刈=ngải|vg
吠=sủa/phệ|vg
哂=mỉm cười/cười|vg
噍=tiếu|vg
囿=câu nệ/hữu|vg
娩=vãn|vg
弃=vứt bỏ|vg
弒=thí|vg
徙=tỷ|vg
忝=thẹn|vg
怖=sợ|vg
悱=phỉ|vg
惮=đan/sợ|vg
慑=nhiếp|vg
戡=kham|vg
揖=vái chào/ấp|vg
攘=cướp/bài trừ|vg
斂=liễm|vg
斫=chước|vg
晤=ngộ|vg
暌=khuê|vg
枉=uổng|vg
析=tích|vg
殇=thương/chết non|vg
殓=liễm|vg
汰=bỏ/thái|vg
泯=mẫn|vg
浣=hoán|vg
溉=khái|vg
滯=trệ|vg
濯=rửa/trạc|vg
牾=ngộ|vg
異=dị|vg
瘁=tụy|vg
眄=miện|vg
眠=ngủ|vg
睇=liếc/thê|vg
睨=nghễ|vg
瞵=lân|vg
禦=ngữ|vg
窃=trộm|vg
笞=quất/si|vg
缚=trói/trói buộc|vg
罄=khánh|vg
耘=vân|vg
膺=ưng|vg
舐=liếm|vg
荐=tiến|vg
葆=bảo|vg
虑=lo|vg
蚀=thực|vg
觏=cấu|vg
訴=tố|vg
諍=tránh|vg
讼=tụng|vg
诌=sưu|vg
诙=khôi|vg
诤=tránh|vg
诲=hối|vg
诿=ủy|vg
谏=gián|vg
谒=yết|vg
豢=nuôi|vg
赅=cai|vg
赙=phụ|vg
赡=thiệm|vg
趸=độn|vg
踞=ngồi/cứ|vg
踬=chí|vg
蹈=đạo|vg
蹙=nhàu|vg
輟=xuyết|vg
述=thuật|vg
逭=hoán|vg
逾=hơn/vượt qua|vg
酡=đà|vg
酹=lỗi|vg
酾=si|vg
钤=kiềm|vg
阂=ngại|vg
霁=tễ/nguôi|vg
靡=mị|vg
飨=hưởng|vg
馁=nỗi|vg
骋=sính|vg
骧=cất cao|vg
鬻=dục|vg
唔=ngô/A.../đừng/a|y
滋=tư/két|undefined
腟=âm đạo
腔=khoang/hốc
呢=đâu/đây/đây này/ni/mà/mất/chứ|undefined
喂=uy/cho ăn/này/đút|v
穿=xuyên/mặc|undefined
乩=kê|x
亍=xúc|x
仃=đình|x
仫=mu|x
仳=tỷ|x
伧=sinh|x
侻=thoái|x
俅=cầu|x
俐=lợi|x
俜=binh|x
俣=vũ|x
偬=tổng|x
偻=lũ|x
傺=sế|x
僬=tiêu|x
僳=túc|x
儡=lỗi|x
凇=tùng|x
凾=hàm|x
刲=khuê|x
剀=cai|x
剙=sang|x
剞=kỷ|x
劂=quyết|x
匏=bào|x
匐=bò xổm|x
匳=liêm|x
卟=bổ|x
卹=tuất|x
厾=đốc|x
吖=a/úi chà|x
吲=oành|x
呤=lánh/đinh|x
咐=phó|x
咙=lung|x
咛=ninh|x
咤=trá|x
咴=hí|x
哝=nông|x
哳=triết|x
唑=tọa|x
唓=xa|x
唣=tao|x
唷=hừm|x
唼=xiệp|x
啈=hanh|x
啉=lâm|x
啡=phê|x
啶=định|x
啷=lang|x
啾=thu/chụt|x
喈=dê|x
喌=châu|x
喒=tàm|x
喱=li|x
嗁=đề|x
嘍=lâu|x
嘖=sách|x
嘧=mật|x
噒=liên|x
嚀=ninh|x
嚅=nhu|x
嚆=hao|x
囱=song|x
囵=luân|x
圄=ngữ|x
圾=ngập|x
坶=mẫu|x
垾=hàn|x
埤=bì|x
墅=thự|x
墼=kích|x
妤=dư|x
姆=mẫu/mu|x
娅=á|x
娆=nhiêu|x
娌=lý|x
娲=oa|x
婕=tiệp|x
婪=lam|x
婷=đình|x
媕=am|x
嫒=ái|x
嫿=họa|x
嬡=ái|x
宄=quĩ|x
尜=giát|x
尬=giới/ngượng|x
岖=khu|x
峋=tuân|x
峳=du|x
崄=hiểm|x
崦=yêm|x
嵘=vanh|x
嵫=tư|x
嵯=tha|x
嵷=tung|x
彳=xích|x
徉=dương|x
徕=lai|x
忑=lo lắng|x
忡=xung|x
忪=chung|x
怓=nao|x
怩=ngượng nghịu/ny|x
恡=lận|x
恿=dũng|x
惚=hốt|x
惝=thảng|x
愀=thiểu|x
慞=chương|x
戋=tiên|x
扊=diễm|x
挝=qua|x
挲=vuốt/sa|x
摴=sư|x
擞=tẩu|x
斓=lan|x
旎=nỉ|x
旐=triệu|x
旯=xó|x
暹=xiêm|x
杩=mã|x
杷=ba|x
柃=linh|x
柹=thị|x
栌=lô|x
栳=lão|x
梐=bệ|x
椋=lương|x
椤=la|x
椹=châm|x
楂=tra|x
榈=lư|x
榍=xiè|x
槔=cao|x
槿=cẩn/cẩn (hoa dâm bụt)|x
樨=tê|x
橤=nhị|x
橼=duyên|x
檎=cầm|x
檬=mông|x
櫜=cao|x
欷=hi|x
殍=biễu|x
毂=cốc|x
毵=tam|x
毹=du|x
氇=lỗ|x
氓=manh|x
氲=uân|x
沌=độn|x
洳=như|x
淟=điến|x
湃=phái|x
湎=miện|x
滟=diễm|x
漭=mãng|x
漶=hoán|x
潆=oanh|x
濞=tị|x
灞=bá|x
炻=thạch|x
烊=dương|x
烯=ankin|x
熇=hốc|x
熳=mạn|x
爝=tước|x
犏=thiên|x
犴=ngạn|x
犸=voi ma mút|x
狁=duẫn|x
狈=bái|x
狲=tôn|x
狳=dư|x
狷=quyến|x
狺=ngân|x
狻=toan|x
猁=lỵ|x
猊=sư tử|x
獗=quyết|x
獬=giải|x
獯=huân|x
玢=phân|x
珑=lung|x
瑁=mạo|x
瑚=hô|x
瑮=lật|x
瑷=ái|x
璃=ly|x
疬=lịch|x
疰=chú|x
疸=đản|x
痪=hoán|x
痫=giản|x
瘃=chúc|x
瘅=đản|x
瘐=dũ|x
瘛=xiết|x
瘩=đáp|x
癀=hoàng|x
皿=mãnh/bồn|x
眈=đam|x
硗=khao|x
硭=mang|x
碜=sầm|x
確=xác|x
磲=cừ|x
礓=cương|x
礞=mông|x
礤=sát|x
礴=bạc|x
祆=hiên|x
禠=ti|x
秊=niên|x
稺=trĩ|x
穑=sắc|x
穸=tịch|x
窀=truân|x
窕=điệu|x
筅=tiển|x
箢=uyên|x
篌=hầu|x
篯=tiên|x
籧=cừ|x
粰=phu|x
絫=lũy|x
綣=quyển|x
繾=khiển|x
纥=hột|x
纶=luân|x
绔=khố|x
绻=quyển|x
缈=miểu|x
缧=luy|x
罋=úng|x
罡=cương|x
罿=đồng|x
羧=các-bô-xít cooh|x
耥=thang|x
耵=đinh|x
聍=ninh|x
肓=hoang|x
肪=phương|x
肭=nạp|x
胝=chi|x
胧=lung|x
胱=quang|x
脬=phao|x
腩=nạm|x
膪=troại|x
臾=du|x
舨=bản|x
舭=tỉ|x
舳=trục|x
舴=trách|x
艋=mãnh|x
艎=hoàng|x
艟=đồng|x
艿=nãi|x
芊=thiên|x
芎=khung|x
芏=đỗ|x
芘=tỷ|x
芪=kỳ|x
芾=phất|x
苁=thung|x
苄=biện|x
苈=lịch|x
苒=nhiễm|x
苓=linh|x
苣=rau diếp|x
苷=đại|x
茏=lung|x
茛=cấn|x
茺=sung|x
荇=hạnh|x
荘=trang|x
荜=tất|x
荬=mại|x
荽=tuy|x
莩=phu|x
莳=thì|x
莶=hiêm|x
菀=uyển|x
菔=bặc|x
菪=đãng|x
萄=đào|x
萆=tỳ|x
萋=thê|x
萏=đạm|x
萸=du|x
葙=tương|x
蒌=lâu|x
蓁=trăn|x
蓠=ly|x
蓣=dự|x
蓿=túc|x
蔹=liêm|x
蔻=khấu|x
蕖=cừ|x
蕞=tối|x
蕤=nhuy|x
蕺=trấp|x
薁=áo|x
薷=nhu|x
蘅=hành|x
蘧=cừ|x
虺=hủy|x
虼=khát|x
蚓=dẫn|x
蚣=công|x
蚧=giới|x
蚨=phù|x
蚪=đẩu|x
蚺=trăn|x
蛄=cô|x
蛉=linh|x
蛑=mâu|x
蛞=khoát|x
蛱=kiệp|x
蛳=si|x
蛴=tề|x
蛸=sao|x
蜊=lỵ|x
蜍=thừ|x
蜒=diên|x
蜓=đình|x
蜞=kỳ|x
蜢=châu chấu/mãnh|x
蜴=dịch|x
蝠=bức/dơi|x
蝣=du|x
蝤=tù|x
蝥=mâu|x
螂=lang|x
螅=tức|x
螈=nguyên|x
螋=sưu|x
螬=tào|x
螵=phiêu|x
螽=chung|x
蟀=xuất|x
蟁=văn|x
蟆=mô|x
蟛=bành|x
蟥=đỉa|x
蟪=huệ|x
蟭=tiêu|x
蟮=thiện|x
蠃=lỏa|x
蠊=liêm|x
蠖=oách|x
蠛=miệt|x
蠼=quặc|x
袯=tơi nón|x
袷=giáp|x
袼=cách|x
裟=sa|x
裢=hầu bao|x
裣=liêm|x
褛=lũ|x
褦=nại|x
襁=cưỡng|x
見=kiến|x
觎=du|x
觳=hộc|x
訇=oanh/hoanh|x
詖=bí|x
謎=mê|x
謦=khánh|x
诜=sân|x
谔=ngạc|x
貅=hưu|x
贔=bí|x
赱=tẩu|x
赳=củ|x
跄=loạng choạng|x
跎=đà|x
跏=già|x
跚=san|x
跞=lịch|x
跫=cung|x
跹=tiên|x
蹰=trù|x
躅=trục|x
躇=trừ|x
躏=lận|x
輘=lăng|x
轲=kha|x
轳=lô|x
轾=chí|x
辚=lân|x
辿=siêm|x
逅=cấu|x
逦=lệ|x
遢=tháp|x
鍪=mâu|x
鑢=lự|x
铞=điếu|x
锖=thương|x
镆=mạc|x
镚=băng|x
闶=khang|x
阊=xương|x
阏=át|x
阢=ngột|x
陧=niết|x
隩=áo|x
靼=đát|x
鞅=ưởng|x
鞯=tiên|x
鞲=câu|x
鞴=bị|x
鞾=ngoa|x
韪=vĩ|x
颃=hàng|x
餮=thiết|x
餹=đường|x
饨=đồn|x
馇=tra|x
馑=cận|x
骀=đài|x
骺=hậu|x
骼=cách|x
髅=lâu|x
鬇=tranh|x
魃=bạt|x
魈=tiêu|x
魉=lượng|x
鮟=an|x
鲡=ly|x
鲦=điều|x
鳅=thu|x
鳆=phục|x
鸑=nhạc|x
鸪=cô|x
鸯=ương|x
鸶=tư|x
鸹=quát|x
鸺=hưu|x
鹃=quyên|x
鹆=dục|x
鹇=nhàn|x
鹉=vũ|x
鹑=chim cút|x
鹔=túc|x
鹕=hồ|x
鹘=cốt|x
鹩=liêu|x
麽=sao|x
黮=thảm|x
黾=mãnh|x
鼅=tri|x
鼒=tỷ|x
鼙=bề|x
龉=ngữ|x
龊=bẩn thỉu|x
恫=đỗng|vn
痉=kinh|vn
佖=tất|y
俍=lương|y
傞=ta|y
儊=sở|y
兮=này|y
冖=mịch|y
劐=hoạch|y
劻=khuông|y
勯=dan|y
匼=hạp|y
卄=nhập|y
吗=sao/ư/mạ/không/chưa/à|y
呀=nha/à/ạ|y
呗=thôi/quá|y
咢=ngạc|y
哉=ư/quá thay|y
啗=đạm|y
啦=rồi/nữa/lạp/rồi|y
啵=ba|y
喭=ngạn|y
嘛=mà/ma/thôi/đây/đi/được/nha/sao|y
嘞=lặc|y
噣=trác|y
嚔=đế|y
圐=khố|y
圛=dịch|y
坋=phận|y
垝=quỷ|y
垟=dương|y
垯=đáp|y
墈=khám|y
夣=mộng|y
娀=tung|y
峧=giao|y
廴=dẫn|y
弸=bằng|y
忺=hiêm|y
恌=khiêu|y
恔=hiệu|y
惀=luân|y
慆=thao|y
憍=kiêu|y
扢=cột|y
抷=cụ|y
挓=tra|y
捭=bãi|y
暕=giản|y
曡=long|y
柷=chúc|y
栔=cắt|y
棫=vực|y
楘=mộc|y
槤=liên|y
橅=mô|y
櫼=tiêm|y
欂=đấu cùng|y
欤=dư|y
汫=tỉnh|y
湩=chúng|y
湽=truy|y
溣=luân|y
濎=đỉnh|y
灒=tiễn|y
焮=hân|y
熯=hãn|y
狓=phi|y
猘=chế|y
玅=diệu|y
玍=ca|y
玡=nha|y
玼=tần|y
珷=vũ|y
瑉=mân|y
瑲=thương|y
疐=chí|y
皊=linh|y
盉=hoà|y
睂=mi|y
睠=quyến|y
瞶=quý|y
矙=khám|y
祃=mã|y
祊=banh|y
祲=tẩm|y
稌=đồ|y
竂=lều|y
竝=tịnh|y
簑=thoa|y
簜=đáng|y
糱=nghiệt|y
絜=kiết|y
繙=phiên|y
纇=lỗi|y
纚=sỉ|y
羂=quyển|y
耔=tỷ|y
腲=uỷ|y
膞=thuần|y
臢=châm|y
舃=tích|y
舘=quán|y
芼=mạo|y
茖=các|y
菤=quyển|y
薧=hảo|y
薶=mai|y
蜦=luân|y
蟺=thiện|y
蠂=châu chấu|y
蠭=phong|y
衋=hực|y
衕=đồng|y
衺=tà|y
袺=kết|y
褎=tụ|y
褻=tiết|y
諔=xúc|y
謷=ngao|y
譛=trấm|y
豮=phần|y
跅=thác|y
跔=câu|y
跧=thuyên|y
躃=tích|y
輀=nhi|y
轓=phiên|y
逈=huýnh|y
鄋=sưu|y
醆=trản|y
鋭=duệ|y
鑴=huề|y
閺=văn|y
闘=đấu|y
闚=khuy|y
隤=đồi|y
霨=uý|y
頫=phủ|y
飃=phiêu|y
馞=nồng đượm|y
騺=chí|y
驘=loa|y
骍=tuynh|y
髐=hiêu|y
鬄=thế|y
鬛=liệp|y
鬪=đấu|y
鱻=tiên|y
鱽=đao|y
鲌=cá thiểu|y
鲯=kỳ|y
鶒=xích|y
鷰=yến|y
鹠=lưu|y
鼚=xương|y
丗=thế|yg
丣=dậu|yg
乄=ngũ|yg
乢=cái|yg
仌=băng|yg
侭=tận|yg
倄=giáo|yg
僇=lục|yg
儤=bạo|yg
冐=mạo|yg
冹=phu|yg
凷=khối|yg
剒=thố|yg
卭=ngang|yg
卼=ngột|yg
呉=ngô|yg
唕=tạo|yg
嘐=hao|yg
噇=trảng|yg
嚚=ngân|yg
圢=đinh|yg
堧=nhuyên|yg
堩=hằng|yg
塟=táng|yg
壃=cương|yg
妌=tịnh|yg
娰=nữ|yg
孻=nai|yg
孼=nghiệt|yg
宂=nhũng|yg
寀=thái|yg
尀=phả|yg
尒=nhĩ|yg
峃=học|yg
嵕=tông|yg
嶓=Bá Trùng|yg
巂=tây|yg
庅=người|yg
庿=miếu|yg
弌=nhất|yg
徧=biến|yg
戭=diễn|yg
拝=bái|yg
挜=á|yg
揌=tai|yg
摠=tổng|yg
攗=quấn|yg
敚=đoạt|yg
斄=ly|yg
斠=dác|yg
旣=ký|yg
晛=hiện|yg
暵=hán|yg
枌=phần|yg
枲=tỷ|yg
枻=duệ|yg
柲=bí|yg
梠=lữ|yg
棐=phỉ|yg
棬=khuyên|yg
椶=tông|yg
樛=cù|yg
橧=tăng|yg
檮=đào|yg
毌=quán|yg
氄=nhũng|yg
汍=hoàn|yg
汎=phiếm|yg
汳=biện|yg
沘=tỉ|yg
泲=tể|yg
洏=nhi|yg
溁=oanh|yg
溓=liễm|yg
潓=huệ|yg
澼=phích|yg
濆=phần|yg
灜=doanh|yg
牷=toàn|yg
牿=cố|yg
犂=lê|yg
狾=chế|yg
猲=yết|yg
獧=quyến|yg
瑯=lang|yg
璪=tảo|yg
畆=mẫu|yg
痀=câu|yg
痌=thông|yg
瘥=ta|yg
皦=kiểu|yg
睍=hiển|yg
瞚=thuấn|yg
碶=thế|yg
磎=khê|yg
礀=tư thế|yg
礮=pháo|yg
禑=Từ|yg
穉=trĩ|yg
窊=oa|yg
窎=điếu|yg
筀=quế|yg
籝=doanh|yg
粃=chủy|yg
絏=tiết|yg
絻=miễn|yg
総=tổng|yg
緑=lục|yg
縰=sỉ|yg
繐=huệ|yg
耑=chuyên|yg
肈=triệu|yg
胠=khư|yg
胹=nhi|yg
胾=chí|yg
脗=vẫn|yg
脝=hanh|yg
脶=loa|yg
舩=thuyền|yg
藂=tùng|yg
蜰=phì|yg
蠨=tiêu|yg
衒=huyễn|yg
褧=quýnh|yg
襍=tập|yg
覉=ki|yg
訢=hân|yg
詟=triệp|yg
誖=bội|yg
譈=đỗi|yg
豻=ngan|yg
贋=nhạn|yg
赒=chu|yg
赬=xanh|yg
躩=khước|yg
軏=nguyệt|yg
輈=chu|yg
輙=triếp|yg
逷=địch|yg
逿=đáng|yg
遆=đề|yg
遹=duật|yg
鄗=hạo|yg
醱=bát|yg
釽=tịch|yg
鉏=sừ|yg
銶=cầu|yg
錡=kỹ|yg
閦=súc|yg
阨=ách|yg
隖=ổ|yg
霅=tráp|yg
靦=điến|yg
靮=đích|yg
韔=sướng|yg
韮=phỉ|yg
飂=liêu|yg
餈=tư|yg
驩=hoan|yg
鬨=hống|yg
魭=tra|yg
鳡=cảm|yg
鳣=chiên|yg
鴞=hào|yg
鹮=hoàn|yg
鼪=sinh|yg
齞=nhe răng|yg
乸=nả|zg
亱=dạ/ban đêm|zg
仐=tán/kim|zg
伃=dư|zg
伾=phi|zg
侂=thác|zg
侚=tuẫn|zg
侹=đĩnh|zg
俉=ngộ|zg
俤=đệ|zg
倓=đàm|zg
傎=điên|zg
傔=khiểm|zg
僃=bị|zg
僎=soạn|zg
僙=quang|zg
僽=sậu|zg
僾=ái|zg
儅=đang|zg
儓=đài|zg
儛=vũ|zg
儴=nhương|zg
兎=thố|zg
兛=thiên|zg
兩=lưỡng|zg
凟=độc|zg
刄=lạng|zg
刌=thổn|zg
刓=ngoan|zg
刱=sáng|zg
刵=nhĩ|zg
剅=lâu|zg
剹=lục|zg
剺=ly|zg
劀=qua|zg
劥=khanh|zg
勚=duệ|zg
勣=tích|zg
勼=cưu|zg
匄=cái|zg
匚=phương|zg
厀=tất|zg
厔=chất|zg
厳=nghiêm|zg
叚=giả|zg
吢=khấm|zg
咷=đào|zg
唊=giáp|zg
唫=ngậm|zg
啑=xiệp|zg
啴=xiển|zg
喍=sài|zg
嘦=chiếu|zg
噐=khí|zg
噚=tầm|zg
噭=khiếu|zg
嚃=đạp|zg
嚱=hi|zg
圁=ngân|zg
圌=thùy|zg
圞=loan|zg
圵=đáng|zg
坺=bạt|zg
垍=ký|zg
埜=dã|zg
堌=cố|zg
堽=canh|zg
塕=ổng|zg
塮=tạ|zg
壎=huân|zg
壔=đảo|zg
夆=phùng|zg
夌=lăng|zg
夬=quái|zg
奡=ngạo|zg
姞=cật|zg
媢=mạo|zg
媥=piān|zg
嫕=ế|zg
宨=tiǎo|zg
屟=tiệp|zg
峝=đỗng|zg
崪=tụy|zg
嶅=ngao|zg
嶒=tằng|zg
嶲=tây|zg
嶽=nhạc|zg
巠=kinh|zg
帊=bạc|zg
帡=bình|zg
帵=oan|zg
幰=hiển|zg
廆=hội|zg
廏=cứu|zg
弍=nhị|zg
徫=vĩ|zg
忈=đao|zg
忋=cái|zg
恑=ngụy|zg
悕=hy|zg
悰=tông|zg
惄=nịch|zg
惼=biển|zg
愯=song|zg
慱=đoàn|zg
憸=tiêm|zg
懽=hoàn|zg
扅=di|zg
抃=biến|zg
捼=noa|zg
摥=thương|zg
撦=xả|zg
擣=đảo|zg
擫=áp|zg
攷=khảo|zg
敧=khi|zg
斈=học|zg
斝=giả|zg
斸=trọc|zg
斾=bái|zg
旂=kỳ|zg
旉=phu|zg
旓=sao|zg
旟=dư|zg
昡=huyền|zg
暠=cảo|zg
杅=vu|zg
枑=hộ|zg
枴=quải|zg
柂=đà|zg
栱=củng|zg
桲=dụng cụ đập lúa|zg
梲=chuyết|zg
椓=trạc|zg
椷=giam|zg
楢=do|zg
楶=tiết|zg
榑=phù|zg
榼=khạp|zg
槥=tuệ|zg
槱=dửu|zg
櫍=chất|zg
欃=sàm|zg
欋=cù|zg
欝=uất|zg
欿=khảm|zg
歜=xúc|zg
歰=sáp|zg
歾=một|zg
殠=xú|zg
殻=xác|zg
毦=nhĩ|zg
沴=lệ|zg
泑=ửu|zg
泒=cô|zg
涘=sĩ|zg
湑=tư|zg
湦=sinh|zg
滘=khiếu|zg
滪=dự|zg
滶=ngao|zg
滺=du|zg
漑=cái|zg
澑=lựu|zg
澯=xán|zg
澽=cự|zg
濺=tiên|zg
灂=tiếu|zg
灳=linh|zg
煇=huy|zg
煔=thiểm|zg
煚=cảnh|zg
爟=quán|zg
牂=tang|zg
牋=tiên|zg
狖=dứu|zg
狥=tuẫn|zg
猨=viên|zg
猺=dao|zg
獮=tiển|zg
玹=xuân|zg
甎=chuyên|zg
畯=tuấn|zg
畽=thoản|zg
疌=tiệp|zg
疎=sơ|zg
疭=túng|zg
痏=vị|zg
瘏=đồ|zg
瘚=quyết|zg
癎=giản|zg
盬=cổ|zg
眎=thị|zg
眘=thận|zg
矒=mông|zg
矰=tăng|zg
矼=cang|zg
砃=đá trắng|zg
砫=trụ|zg
砮=nỗ|zg
碯=não|zg
祹=Tạo|zg
禋=nhân|zg
稆=lữ|zg
稟=bẩm|zg
穊=ký|zg
窰=diêu|zg
窵=điếu|zg
竚=trữ|zg
竫=tĩnh|zg
笴=cảm|zg
筈=quát|zg
箇=cá|zg
箎=trì|zg
箑=tiệp|zg
箚=tráp|zg
箾=sao|zg
篛=nhược|zg
篨=trừ|zg
篲=tuệ|zg
簠=phủ|zg
籖=thiêm|zg
籰=dược|zg
紅=hồng|zg
絁=thi|zg
絓=quái|zg
綪=khiếm|zg
緈=trực|zg
緎=vực|zg
緪=căng|zg
繂=luật|zg
繈=cưỡng|zg
繖=tản|zg
繨=đáp|zg
繵=triền|zg
繻=nhu|zg
纁=huân|zg
绹=đào|zg
罛=cô|zg
罳=ty|zg
羇=ki|zg
羱=nguyên|zg
翣=sáp|zg
翫=ngoạn|zg
耇=cẩu|zg
耈=cẩu|zg
聧=khuê|zg
肧=phôi|zg
胏=chỉ|zg
腁=biền|zg
膓=tràng|zg
膙=cưỡng|zg
臛=hoắc|zg
舓=chỉ|zg
苖=địch|zg
苙=lập|zg
苽=cô|zg
荓=bình|zg
荙=đạt|zg
菴=am|zg
菼=thảm|zg
蒍=thân cây súng|zg
蒱=bồ|zg
蓨=điệu|zg
蔨=quyển|zg
蔪=tiêm|zg
蕋=nhị|zg
蕠=như|zg
蕥=nhã|zg
薖=oa|zg
薢=giải|zg
藷=thự|zg
蘤=hoa|zg
虖=hô|zg
虙=mật|zg
蚖=ngoan|zg
蜋=lang|zg
蝝=duyên|zg
蟕=chủy|zg
袠=trật|zg
袵=nhẫm|zg
褉=hạt|zg
襃=bao|zg
襆=bộc|zg
覻=thứ|zg
誌=chí|zg
誰=thùy|zg
謡=dao|zg
謯=trớ|zg
讙=hoan|zg
讟=độc|zg
貆=hoan|zg
貙=sơ|zg
貭=chất|zg
賵=phúng|zg
贠=viên|zg
赮=hạp|zg
赸=sán|zg
跮=sí|zg
躧=sỉ|zg
軆=thể|zg
軨=linh|zg
輋=xa|zg
辀=chu|zg
辌=lương|zg
辡=biện|zg
迍=truân|zg
邟=kháng|zg
郩=hào|zg
酺=bô|zg
醁=lục|zg
醊=chuyết|zg
醡=trá|zg
釄=mi|zg
鋆=vân|zg
鍑=phúc|zg
鍱=diệp|zg
鏕=ao|zg
鏣=tên dụng cụ|zg
鐏=tỗn|zg
鐩=tùy|zg
鑞=lạp|zg
鑨=lung|zg
鑪=lô|zg
铘=gia|zg
铻=ngữ|zg
锧=chất|zg
镕=dung|zg
閛=phanh|zg
阛=hoàn|zg
陼=chử|zg
隞=ngao|zg
隟=khích|zg
隲=chất|zg
雘=hoạch|zg
霙=anh|zg
霫=tập|zg
霱=duật|zg
靬=kiền|zg
鞡=lạp|zg
鞬=kiện|zg
韂=xiếm|zg
韘=thiếp|zg
頵=quần|zg
顑=khảm|zg
颣=loại|zg
飜=phiên|zg
饎=sí|zg
駞=đà|zg
駻=hãn|zg
騑=phi|zg
骔=tông|zg
骽=thối|zg
髃=ngung|zg
髢=thế|zg
髴=phất|zg
鬐=kỳ|zg
鬡=ninh|zg
魛=đao|zg
魟=hồng|zg
鮿=triếp|zg
鰂=tặc|zg
鱇=khang|zg
鱍=cá quẫy đuôi nhảy|zg
鱬=mặt người thân cá|zg
鱲=liệp|zg
鲀=đồn|zg
鳒=kiêm|zg
鳸=hỗ|zg
鴈=nhạn|zg
鴒=linh|zg
鴽=như|zg
鵻=giai|zg
鶊=canh|zg
鶗=đề|zg
鷁=nghịch|zg
鷞=sương|zg
鸀=hắc|zg
麙=hàm|zg
麹=đến nỗi|zg
黓=dặc|zg
黡=yểm|zg
黤=yểm|zg
鼄=chu|zg
鼑=đỉnh|zg
齆=úng|zg
匆=thông|z
姣=giảo/tướng mạo|z
怏=ưởng|z
悒=ấp|z
潺=sàn|z
璀=thôi|z
皑=ngai|z
簌=tốc|z
粼=lân|z
缤=tân|z
羸=luy|z
袅=niểu|z
褴=rách tả tơi|z
迢=điều|z
逶=uy|z
锃=sáng loáng|z
颀=kỳ|z
飒=táp|z
黝=đen thui|z
黧=lê|z
兢=căng|i
咄=đốt/ô hay|i
喋=điệp|i
姹=xá|i
岌=ngập|i
岿=vị|i
扪=môn|i
揠=yết|i
栩=hủ|i
潸=san|i
蚍=tỳ|i
酩=mính|i
铤=đĩnh|i
锲=khiết|i
丟=đâu|v
买=mua/mãi/bán|v
伛=ủ|v
伴=bạn|v
伸=duỗi với|v
佯=dương/giả vờ|v
使=làm/dùng/khiến/sử/làm cho/khiến cho/sử (khiến cho)/sứ|v
來=lai|v
促=gấp rút|v
俨=nghiễm|v
修=tu/xây/sửa|v
俯=cúi/phủ/cúi xuống|v
倒=ngược lại/ngã/đảo/đổ/lộn/ngược/cũng/rót|v
偎=tựa/ôi|v
做=làm/tố|v
停=ngừng/đình/dừng|v
偷=trộm/thâu/lén|v
備=bị|v
像=giống/tượng/giống như|v
免=miễn|v
兑=đổi/đoái/đoài|v
入=nhập/vào/đi vào|v
兼=kiêm|v
冒=bốc lên/mạo|v
写=viết/tả/ghi|v
减=giảm|v
凑=góp/đụng/tập hợp/gom góp/thấu/họp/tiếp cận|v
出=ra/xuất|v
凿=đục|v
切=cắt|v
划=vạch/hoạch/vẽ/hoa/họa|v
删=xóa/xóa|v
刮=cạo/phá/quát|v
到=đến/đáo/được|v
剐=róc thịt/quả|v
剜=khoét|v
剡=diệm|v
剥=lột/bóc/tróc/bóc lột/bác|v
割=cắt/cát|v
剿=diệt/tiêu diệt|v
劁=tiêu|v
劝=khuyên/khuyến/khích lệ|v
勒=siết/lặc/cương/đè nén/ghìm cương|v
包=bao/túi|v
匍=bồ|v
匱=quỹ|v
卖=bán/mại|v
占=chiếm/chiêm|v
卸=gỡ/đẩy/cởi/tá/tháo|v
去=đi/khứ|v
取=lấy/thủ|v
受=thụ/chịu/bị/được|v
叠=chồng/xếp|v
叫=gọi/để/bảo/làm/khiếu/kêu|v
可=nhưng/có thể/cũng/khả/đáng/thể|v
叵=phả|v
吃=ăn/cật/đồ ăn|v
吆=yêu/hét|v
吓=dọa/hách/hù dọa/sợ/doạ|v
吟=ngâm|v
吣=tẩm|v
听=nghe/thính|v
吮=mút|v
启=khải|v
吵=ầm ĩ/nhao nhao/sảo/ồn ào|v
吸=hút/hấp/hít|v
吹=thổi/xuy|v
吻=hôn/vẫn/mép/môi|v
吼=rống|v
呈=hiện/hiện lên/trình|v
告=cáo/kiện/nói với|v
呛=sặc/sang/hắc|v
呲=thử|v
呷=uống|v
呻=thân|v
咂=chép miệng|v
咆=bào|v
咧=liệt/rồi/nhếch|v
哄=hống/dỗ/lừa/dỗ dành|v
哆=run|v
哭=khóc/khốc|v
啃=gặm/khẳng|v
喊=hô/hảm/quát/gọi/kêu|v
喘=thở/thở gấp|v
嗍=sóc|v
嗑=gặm|v
嗔=giận|v
嗟=ta|v
嘬=mút/toát|v
噘=quyết/cong|v
噙=chứa|v
嚇=hách|v
嚷=trách móc/nhượng/cho/kêu gào|v
嚼=nhai|v
回=về/hồi/quay về/lần/trả lời|v
囤=độn|v
坐=ngồi/tọa|v
坠=rơi|v
垒=lũy|v
垮=đổ/suy sụp/sụp đổ|v
埋=chôn/mai/vùi|v
培=bồi|v
堆=chồng/đống/chồng chất/đôi/đắp|v
堕=đọa/rơi rụng|v
堵=chắn/chận|v
塌=sập/lõm xuống/sụp/giường/榻~|v
填=lấp/điền|v
墁=mạn|v
增=tăng|v
备=chuẩn bị/bị|v
夺=đoạt|v
夾=giáp|v
妒=ghen|v
娶=cưới/lấy/thú/lấy|v
媲=bễ|v
媾=cấu|v
嫁=gả/giá|v
存=tồn|v
孵=ấp trứng/ấp|v
审=thẩm|v
害=hại|v
尝=nếm/từng/thường|v
尥=liệu|v
属=thuộc|v
崩=sập/băng/sụp đổ/vỡ|v
崴=uy|v
嵌=khảm|v
带=mang/đái/đeo/kéo/vùng/đai/lẫn|v
帮=giúp/bang/đám/mép|v
帶=đái|v
廝=tư|v
开=mở/lái/khai/nở/sôi/nổ/chạy|v
弄=làm/làm cho/kiếm/lộng/chuẩn bị/chơi|v
引=dẫn/rút/rời xa/thên|v
归=về/thì/thuộc về/quy|v
彷=bàng|v
征=chinh/trưng thu|v
徘=bồi|v
徜=thảng|v
忌=kị|v
忏=sám|v
忖=nghĩ kĩ|v
忘=quên|v
忙=bận bịu/vội vàng/bề bộn/mang|v
怄=âu|v
怕=sợ/phạ|v
恨=hận|v
惦=nghĩ về/nhớ|v
惧=sợ|v
想=nghĩ/muốn/nhớ/tưởng|v
惹=gây/nhạ/làm cho/rước lấy/chọc|v
愛=ái|v
愣=sững sờ/cứ thế/lỗ mãng|v
愿=nguyện/nguyện vọng|v
憬=cảnh|v
懂=hiểu/đổng/u mê/bối rối|v
懊=áo|v
戗=thương|v
戥=đẳng|v
截=đoạn/chặn/tiệt|v
戳=đâm/trạc/dãy|v
扒=đào/bới ra|v
打=đánh/đả|v
扔=ném/nhưng/vứt|v
扣=trừ/chụp/khấu trừ/cài|v
执=chấp|v
扫=quét|v
扭=xoay/uốn éo/nữu/quay tay|v
扮=đóng vai/đóng/giả trang/phẫn/quấy/nhào đều|v
扯=kéo/xé/xả|v
找=tìm/hoa|v
抓=bắt/trảo/trảo/gãi/|v
抟=đoàn|v
抠=móc/gảy/keo kiệt|v
抡=vung mạnh/kén/chọn/xoay|v
抢=đoạt/thưởng/cướp|v
抨=phanh|v
披=khoác/khoác trên vai|v
抬=nhấc/khiêng/giơ lên/sĩ/đánh/mang|v
抱=ôm/bão|v
抹=bôi/xóa/mạt/vệt|v
抻=thân|v
抽=rút/quất/trừu/nảy/lấy ra/nhổ/đánh/hút|v
拄=trụ|v
担=gánh|v
拆=phá/hủy đi/sách|v
拈=nhặt|v
拌=trộn lẫn|v
拍=đập/đấu/quay/chụp/phách/đánh|v
拎=xách|v
拔=nhổ/bạt/rút/nhổ/rút ra|v
拜=bái/lạy/bye|v
拟=mô phỏng/nghĩ/nghĩ ra|v
拣=lấy/chọn/kiếm|v
拥=ủng/cầm giữ|v
拦=cản/ngăn đón/lan/ngăn|v
拧=vặn/nhéo/vắt/ninh|v
拨=phát/gẩy|v
择=chọn/chọn|v
拱=ủi/cúi lưng/nhú|v
拴=buộc|v
拽=túm/chảnh/túm|v
拾=nhặt/mười|v
拿=cầm/nã/nắm|v
挂=treo/hack|v
挟=mang/hiệp/cầm/kẹp|v
挠=cào/gãi/quấy nhiễu/cong|v
挣=kiếm/giãy/tranh/tránh/giãy (kiếm được)|v
挤=chen/lách vào|v
挥=vung|v
挨=chịu/lần lượt/ai/kề bên|v
挽=kéo/xắn/vãn|v
捂=che/ô/bưng bít|v
捅=đâm/chọc/thống/thọt|v
捆=trói/khổn/buộc/bó|v
捉=bắt/hái/tróc/nắm bắt|v
捋=vuốt/gỡ|v
捍=hãn|v
捎=mang hộ|v
捏=bóp/nắm/niết/nặn|v
捐=quyên|v
捕=bắt/bổ|v
捞=vớt/kiếm/lao/mò|v
捡=nhặt/kiểm/kiếm|v
捣=đảo|v
捧=nâng/phủng/thổi phồng|v
掀=vén/nhấc lên/nhấc|v
掂=ước lượng|v
掐=bóp/véo/kháp/bấm|v
掖=dịch|v
掘=đào/móc|v
掛=quải|v
掠=cướp/lướt|v
掣=xiết|v
控=khống|v
推=đẩy/thôi|v
掩=che đậy/ dấu/yểm/che/đậy/dấu|v
掬=cúc|v
掭=thiệm|v
掰=tách ra|v
掴=tát|v
掷=ném/trịch/quăng|v
掸=phủi|v
揉=vò/văn vê/nhu/thuận/vân vê/nhào nặn|v
揍=đánh/tấu|v
揎=tuyên|v
描=tô lại/copy|v
提=xách/nói/lấy/nâng/đề/dẫn/nhắc đến|v
握=nắm/ác/cầm|v
揣=thăm dò/ước lượng/sủy/đo|v
揩=lau|v
揪=nắm chặt/tóm/nhéo|v
揽=ôm/ôm đồm|v
搁=đặt|v
搂=ôm/lâu/vơ/quơ/kéo|v
搅=quấy/khuấy|v
搋=trĩ|v
搓=xoa/chà xát|v
搔=gãi|v
搛=kiêm|v
搞=làm/kiếm/trị/cảo/làm cho|v
搠=sóc|v
搡=đẩy/táng|v
搬=chuyển/đem/bàn/dọn sạch/mang/dời|v
搭=dựng/đáp/đi|v
携=mang theo/dắt|v
搽=bôi|v
摁=nhấn|v
摆=bày/bãi/mở|v
摔=quẳng/ngã/suất/đánh ngã/té|v
摹=mô|v
撂=đặt xuống|v
撑=chống đỡ/căng cứng/xanh/no/đủ/chống|v
撕=xé/tê/nhắc/kéo|v
撞=đụng/chàng/khua/va|v
撤=rút/rút lui/triệt|v
撩=vẩy/trêu chọc|v
撺=thoán|v
撼=lay|v
擂=lôi|v
操=thao/sử dụng|v
擎=giơ cao|v
擒=cầm/bắt/tóm|v
擤=lau|v
擦=xát/lau/xoa/sát/cọ xát lấy|v
擬=nghĩ|v
攉=hoắc|v
攥=nắm|v
放=thả/phóng/để/đuổi/bỏ/chiếu|v
敘=tự|v
敞=mở|v
敲=gõ/xao/đập|v
敷=thoa|v
斟=châm|v
斡=oát|v
映=chiếu/ánh|v
昧=giấu/muội|v
是=là/thị/đúng/vâng/phải|v
显=hiển/lộ ra/lộ vẻ/hiện ra|v
晃=lắc/hoảng/lay động/sáng ngời|v
晒=phơi/phơi nắng|v
晕=choáng/chóng mặt/vựng/vầng sáng/ngất/choáng váng|v
有=có/hữu|v
杀=giết/sát|v
来=đến/tới/lai|v
梗=ngạnh|v
梳=chải/chải đầu/sơ|v
棰=trùy|v
欠=thiếu/thiếu nợ/khiếm/ngáp/nợ|v
歇=nghỉ|v
歪=lệch nghiêng|v
殒=vẫn|v
毁=hủy|v
毙=đánh chết/giết|v
求=cầu/tìm/trách/xin/ngang/van|v
汆=thộn|v
沏=pha/ngâm vào nước|v
沤=ngâm ủ|v
治=trị/quản lý|v
泅=tù|v
泛=hiện/hiện lên/hiện ra|v
注=chú/rót|v
洇=nhân|v
洗=tẩy/tắm/rửa/giặt rửa/giặt|v
派=phái|v
浇=tưới/giội/dội|v
浞=trác|v
浸=thấm/ngâm|v
涌=tuôn ra/trào|v
涣=hoán|v
淌=trôi/chảy|v
淘=đãi/vo/nghịch|v
淹=chìm|v
渍=nước đọng|v
渗=thấm|v
湊=thấu|v
溅=tung tóe/tiên/bắn tung tóe|v
溜=trượt/lưu/chuồn mất/dải/chạy|v
滗=tiết|v
滾=cổn|v
漉=lộc|v
漤=lãm|v
漱=thấu|v
潴=trư|v
灭=diệt|v
炒=xào/rang|v
炖=hầm/hầm cách thủy/đôn/cách thủy|v
炝=sang|v
烀=luộc|v
烫=bỏng/nóng/sấy/hâm/bị phỏng|v
烹=nấu|v
焊=hàn/hạn|v
焐=ngộ|v
焖=hầm/muộn|v
焙=bồi|v
焯=trác|v
煅=nung|v
煎=sắc/rán/pha/sắc thuốc|v
煨=nướng/nướng (lò nóng)|v
煮=nấu/chử/đun/luộc|v
煺=thoái|v
煽=phiến|v
熄=tắt|v
熘=lựu|v
熬=chịu/nấu/ngao/rang khô|v
燉=đôn|v
爆=bạo|v
爬=bò/ba/gãi/cào|v
牵=dắt/khiên|v
牺=hi|v
献=hiến|v
率=suất/tỷ số/dẫn đầu/suất (*tỉ lệ)|v
琢=mài/dũa|v
甩=vung/súy/vứt/vẫy/bỏ rơi|v
申=thân|v
留=lưu|v
痊=hết bệnh|v
瘫=co quắp/than/tê liệt|v
發=phát|v
皈=quy|v
皲=quân|v
盯=chằm chằm/trành/nhìn chăm chú/nhìn chòng chọc|v
看=nhìn/khán/xem|v
眍=khu|v
眯=híp mắt|v
睁=trợn|v
睃=thoa|v
睜=tĩnh|v
睡=ngủ/thụy|v
睬=không hỏi|v
瞅=nhìn|v
瞌=khạp|v
瞒=giấu/giấu diếm/man/lừa gạt/dấu diếm|v
瞟=nghiêng mắt nhìn|v
瞧=nhìn/tiều/trông trộm/coi|v
瞪=trừng|v
瞭=liệu|v
矇=mông|v
矗=súc|v
砍=chặt/khảm/chém|v
砘=đôn|v
砣=đà|v
破=phá|v
砸=nện/tạp/đập bể/đập|v
砻=xay lúa|v
硌=cấn|v
碰=đụng/bính/va/chọi/chạm/phanh|v
磕=đập/dập đầu|v
禀=bẩm|v
离=cách/rời/ly|v
称=xưng/hiệu/danh hiệu/cân|v
稱=xưng|v
窒=tắc nghẽn|v
窨=ấm|v
站=đứng/trạm|v
筑=trúc/xây|v
签=ký/lá thăm|v
箍=quấn/đai/siết/cô|v
算=tính/toán/tính toán/coi là|v
籴=địch|v
粜=thiếu|v
繃=banh|v
绕=quấn/nhiễu/cuộn/ôm trọn/lượn quanh|v
绗=hàng|v
绱=thượng|v
绲=cổn|v
绾=quán|v
缀=xuyết|v
缉=tập|v
缒=trúy|v
缠=quấn/triền/dây dưa|v
缩=co lại/lui|v
缭=quấn|v
缮=thiện|v
缲=sào|v
缴=giao nộp|v
罩=che đậy/tráo/cái lồng|v
翕=hấp|v
翘=vểnh/vểnh lên/kiều|v
翱=cao|v
翻=lật/trở mình|v
耍=đùa nghịch/đùa giỡn/đùa bỡn|v
耠=hoát|v
耪=bảnh|v
聘=mời/sính|v
肄=dị|v
脫=thoát|v
腆=ưỡn|v
腻=dính/ngán/chán|v
膨=bành|v
致=gây nên/gửi tới/dồn|v
舀=múc/cầm|v
舂=giã|v
舔=liếm|v
芟=sam|v
苫=thiêm|v
荡=đãng|v
获=lấy được|v
萎=héo|v
蔓=mạn|v
蔽=che|v
薅=kéo/hao|v
薰=huân/hun|v
蘸=chấm/trám|v
蜇=đốt/triết|v
蜚=phỉ|v
螫=nọc độc|v
衔=ngậm/hàm/liên tiếp|v
袢=phán|v
袭=tập/tập (kích)|v
裝=trang|v
裱=phiếu|v
裹=khỏa|v
褪=cởi|v
襻=phán|v
要=muốn/yếu/phải/quan trọng/nếu/sắp|v
親=thân|v
见=thấy/gặp/kiến/xem|v
觉=cảm giác/giấc|v
觊=mong muốn|v
觑=dò xét/nhìn trộm|v
觞=thương/chén|v
解=giải/hiểu/am hiểu/mổ|v
請=thỉnh|v
謄=đằng|v
譬=thí|v
讀=độc|v
讨=lấy/đòi|v
让=để/nhường/bảo|v
讪=ngượng/ngượng ngập|v
讴=âu|v
讶=quái lạ|v
访=thăm/tìm hiểu|v
诅=rủa/trớ|v
识=biết/thức|v
诓=lừa gạt/gạt/lừa|v
诘=cật|v
诛=tru/giết|v
诠=thuyên|v
诣=nghệ|v
说=nói/thuyết|v
请=mời/xin/thỉnh/xin mời|v
诽=phỉ|v
谄=siểm/nịnh|v
谅=lượng|v
豎=thụ|v
賞=thưởng|v
賭=đổ|v
賺=trám|v
贬=biếm/giáng chức/cách chức|v
贮=trữ|v
赁=nhẫm|v
赊=nợ/xa|v
赐=ban thưởng/ban cho/thưởng|v
赔=bồi|v
赚=kiếm/lừa/kiếm lời/lợi nhuận|v
赠=tặng|v
赢=thắng/doanh|v
赴=phó|v
起=lên/khởi/dậy/cái|v
趄=nghiêng|v
超=siêu/cực kỳ/Chao|v
趑=tư|v
趔=liệt|v
趿=mang|v
跑=chạy/bào|v
跪=quỳ/quỵ|v
跳=nhảy/khiêu/đập|v
跺=đập mạnh/giẫm|v
跻=tễ|v
踅=tuyệt|v
踌=trù|v
踏=đạp|v
踟=trì|v
踢=đá/thích|v
踮=điểm/nhón chân|v
踯=trịch|v
踱=bước đi thong thả|v
踹=đạp/đoán/đuổi|v
蹂=chà đạp|v
蹉=tha|v
蹋=đạp|v
蹒=bàn|v
蹦=nhảy|v
蹬=đạp/đặng|v
蹭=cọ/chà xát/đi từ từ/chùi/sượt|v
蹲=ngồi xổm/ngồi chồm hổm/tồn|v
蹺=khiêu|v
蹿=nhảy lên|v
躲=tránh/trốn/đóa|v
躺=nằm/thảng|v
转=chuyển|v
辗=triển|v
辞=từ|v
辟=tích|v
辦=bạn|v
达=đạt|v
迁=dời/thiên|v
迎=nghênh|v
返=trở lại/phản|v
进=tiến/vào/tiến vào|v
追=truy/đuổi/theo đuổi|v
退=lui/thoái/thối/lùi|v
送=đưa/tặng/tiễn/tiễn đưa/tống|v
逃=trốn/đào|v
透=thấu|v
递=đưa/lần lượt|v
逗=đùa/đậu/trêu chọc/buồn cười/đậu|v
逛=đi dạo/cuống|v
造=tạo|v
逼=bức/ép|v
遇=gặp/ngộ|v
遛=lưu/dắt|v
遮=che/chận|v
遴=lân|v
避=tránh|v
邀=mời/yêu cầu/yêu|v
邁=mại|v
酗=hú|v
酝=ủ|v
醒=tỉnh|v
采=hái/khai thác/ngắt/thải|v
銜=hàm|v
錾=tạm|v
鏖=ao|v
铐=còng tay|v
铡=trát/trảm|v
铰=giảo|v
锁=khóa/tỏa|v
锛=bôn|v
锩=quyển|v
镶=khảm/nạm|v
闢=tịch|v
闭=bế/đóng/nhắm|v
闹=náo|v
限=hạn|v
陷=hãm/vùi lấp|v
雜=tạp|v
震=chấn|v
靠=dựa vào/sát lại/kháo/cập/dựa vào|v
鞣=thuộc da|v
顫=chiến|v
飘=phiêu/tung bay/thổi/nhẹ nhàng|v
饧=đường|v
饿=đói/ngạ/đói bụng|v
驮=cõng/đà|v
骂=mắng/chửi/mạ|v
骖=tham/ngựa kéo|v
骟=phiến|v
黜=truất|v
黩=độc|v
黴=mi|v
乡=hương/thôn quê|n
书=sách/thư/viết|n
事=sự tình/sự/chuyện|n
人=người/nhân|n
仕=sĩ|n
价=giá/giới/giá cả|n
伞=dù/cái dù/tán/ô|n
伢=trẻ con|n
伥=trành|n
侄=điệt/chất|n
侉=khoa|n
债=nợ/khoản nợ/trái|n
傀=khôi|n
傧=tấn|n
僚=liêu|n
僮=đồng|n
光=quang/chỉ riêng/ánh sáng/sạch/chỉ|n
党=đảng|n
兵=binh|n
军=quân|n
函=văn kiện/hàm|n
刽=quái|n
功=công/công lao|n
匕=dao găm/chủy|n
匾=biển|n
卵=trứng/noãn|n
厅=sảnh|n
厩=cứu|n
叔=thúc|n
吡=ti|n
呋=phu|n
呓=nghệ|n
咫=chỉ|n
哌=phái|n
哔=tất|n
唢=tỏa|n
啤=bia|n
喹=khuê|n
嗉=tố|n
器=khí/ (cụ)|n
噱=cược|n
噻=tắc|n
嚏=hắt xì/hắt hơi/đế|n
囟=tín|n
囹=linh|n
国=nước/quốc|n
图=đồ/hình/cầu|n
圪=khất|n
坝=đập/bá|n
坟=mộ phần/phần/phần mộ|n
坡=sườn núi|n
坯=phôi|n
垃=rác|n
埘=thì|n
堇=cận|n
堤=đê|n
塾=thục|n
墓=mộ|n
夢=mộng|n
头=đầu|n
奖=thưởng/tưởng/khen|n
妈=mẹ/mụ|n
妯=trục|n
妹=muội|n
姊=tỷ|n
姐=tỷ/tả|n
姘=phanh|n
姨=di|n
娘=nương/mẹ/mẹ|n
婊=biểu|n
婢=tỳ|n
婵=thiền|n
婶=thẩm|n
媽=mụ|n
嫦=thường|n
嬷=ma|n
字=chữ/tự|n
孢=bào|n
孬=nhút nhát|n
孺=trẻ con/nhụ|n
官=quan|n
局=cục/(ván) cục|n
屁=cái rắm|n
屉=thế|n
屎=phân/cứt/thỉ|n
岗=cương vị/tốp|n
岛=đảo|n
崽=con/tể|n
州=châu|n
币=tệ/tiền|n
市=thành phố/thị/chợ/mua/thị trường|n
帆=buồm|n
帏=vi|n
幂=mịch|n
幔=màn/mạn|n
床=giường/sàng|n
序=tự|n
店=cửa hàng|n
庙=miếu|n
庶=thứ|n
弟=đệ|n
弧=cung/hình cung/cầu vòng|n
彗=tuệ|n
徭=dao|n
志=chí|n
恥=sỉ|n
情=tình|n
戏=hí/hí kịch/kịch|n
扉=phi|n
拇=mẫu/ngón cái|n
掮=kiên|n
撸=lột/tuốt/cách chức/triệt/vén|n
斑=ban/lốm đốm/Madara|n
旌=tinh|n
旗=cờ/flag/kỳ|n
旮=ca/mọi ngóc ngách|n
曙=thự|n
書=thư|n
权=quyền|n
杈=chạc/xoa|n
枇=tỳ|n
枢=trụ cột/khu|n
枣=táo/tảo/cây táo|n
枪=thương/súng/phát đạn/đạn|n
枷=gông/cái gông|n
枸=cẩu|n
栏=cột/thanh/lan|n
栲=khảo|n
桄=quáng|n
桉=án|n
桎=chất|n
桠=nha|n
桡=nạo|n
桥=cầu/kiều|n
桨=mái chèo|n
梃=đĩnh|n
梨=lê|n
棋=cờ/quân cờ|n
棚=lều/rạp|n
椎=chùy|n
椭=thỏa|n
椴=đoạn|n
楝=luyện|n
楼=lâu/lầu|n
榔=lang|n
榜=bảng|n
榫=chuẩn|n
榻=giường/giường|n
槍=thương|n
槟=tân|n
槲=sồi|n
橄=cảm|n
橘=quýt/quất|n
橛=cọc/quyết|n
橡=cao su|n
權=quyền|n
毽=kiến|n
氆=phổ|n
氍=cù|n
气=khí/chọc tức/tức giận/tức/giận|n
氖=nãi|n
氛=phân|n
氢=hydro|n
氤=nhân|n
氦=heli|n
氨=an|n
氩=á|n
氮=nitơ/nitrogen|n
氯=lục|n
水=nước/thủy|n
汊=xá|n
汞=thủy ngân|n
汽=hơi/khí|n
沫=mạt/bọt|n
油=dầu/du/mỡ|n
泔=cam|n
洞=động/lỗ|n
涡=cơn xoáy|n
渠=mương/kênh mương|n
溽=nhục|n
漩=tuyền|n
潭=đầm|n
灯=đèn|n
灶=lò|n
灾=tai/tai họa|n
炔=khuyết|n
炕=giường/kháng/khô ráo/nướng/sấy/hé ra/mở ra|n
炭=than|n
烃=hĩnh|n
烟=khói/thuốc/yên/thuốc lá|n
烷=hoàn|n
煤=than đá|n
燧=toại|n
爸=cha/ba|n
爹=cha/đa|n
版=bản/hãy|n
牌=bài/nhãn hiệu|n
牙=răng/nha|n
牝=tẫn|n
牦=ly|n
牯=cổ|n
犄=cơ|n
狍=bào|n
狒=phí|n
狗=chó/cẩu/con chó|n
猞=xá|n
猢=hồ|n
猪=heo/lợn/trư|n
獠=liêu|n
玫=hồng/đẹp|n
玳=đại|n
珐=pháp|n
球=cầu/bóng|n
琴=đàn/cầm/Gin|n
琵=tỳ|n
璎=anh|n
瓶=bình|n
甕=úng|n
產=sản|n
甥=sinh/cháu trai|n
电=điện|n
畚=bổn|n
疔=đinh|n
疖=tiết|n
疙=ngật|n
疟=ngược|n
疤=sẹo|n
疥=giới|n
疮=đau nhức/loét|n
疱=pháo|n
疳=cam|n
疵=tỳ|n
痂=vảy|n
痄=chá|n
痈=ung|n
痔=trĩ|n
痞=du côn|n
痢=lỵ|n
痣=nốt ruồi|n
痤=tọa|n
痨=lao|n
痰=đàm|n
痱=phi|n
痼=cố|n
瘢=ban|n
瘰=lỗi|n
瘴=chướng|n
瘾=nghiện|n
癔=ý|n
癞=lại|n
癣=tiển|n
皮=da/lì lợm/vỏ/lì|n
盐=muối|n
盔=nón trụ|n
省=bớt/tỉnh/tiết kiệm|n
睫=tiệp|n
睾=cao|n
矬=tọa|n
矸=canh|n
矿=mỏ|n
砂=cát/sa|n
砖=gạch/cục gạch|n
砝=kiếp|n
砷=thân|n
砼=đồng|n
硒=tây|n
硝=tiêu|n
硫=lưu huỳnh/lưu|n
硼=bằng|n
碉=điêu|n
碑=bia|n
碘=i-ốt|n
磙=quả lăn|n
磷=lân|n
礁=đá ngầm san hô|n
礼=lễ|n
社=xã|n
票=phiếu/vé/phiếu vé|n
祸=họa|n
秕=bỉ|n
秤=cái cân/cân|n
秫=thuật|n
秸=cành cây|n
税=thuế|n
稞=khoa|n
穹=khung|n
窖=hầm|n
窠=khoa|n
窪=oa|n
笆=ba|n
笊=tráo|n
笙=sênh/sinh|n
笤=điều|n
筋=gân|n
筍=duẩn|n
筝=tranh|n
筵=tiệc lễ|n
箔=bạc|n
箝=kiềm|n
箬=nhược|n
箭=tiễn/mũi tên/tiến|n
篦=bề|n
篾=miệt|n
簧=lò xo|n
籼=tiên|n
粥=cháo|n
粪=phân/cứt/phẩn|n
粮=lương/lương thực|n
粳=canh|n
糌=ta|n
糍=từ|n
絛=thao|n
纲=cương|n
纸=giấy/chỉ/tử|n
线=tuyến/dây/đường/sợi dây|n
绉=trứu|n
绒=nhung|n
绢=lụa|n
绦=thao|n
缸=vạc/vại|n
罂=anh|n
羊=dê|n
羚=linh|n
羟=thưởng|n
翡=phỉ|n
耖=sao|n
肉=thịt|n
肋=sườn/(sườn) lôi thôi|n
肛=giang/chống/hậu môn|n
肠=ruột/tràng|n
肱=quăng/cánh tay|n
肺=phổi|n
胃=dạ dày|n
胚=phôi|n
胛=giáp|n
胞=bào|n
胭=son|n
胴=thân mình|n
胺=án|n
胼=biền|n
脑=não|n
脓=mủ/nùng: mủ|n
脚=chân/cước|n
脩=tu|n
脾=tỳ|n
腧=thú|n
腭=ngạc|n
腮=má/mang/quai hàm|n
腰=eo/thắt lưng|n
腱=kiện|n
腺=tuyến|n
腿=chân|n
膂=lữ|n
膜=màng|n
舌=lưỡi|n
舱=khoang thuyền/khoang|n
舵=đà/tay lái|n
船=thuyền|n
舾=tây|n
艄=sao|n
芍=thược|n
芡=khiếm|n
芨=cập|n
芫=nguyên|n
芽=mầm/mầm mỏ|n
苋=hiện|n
苎=trữ|n
苕=điều|n
苜=mục|n
苤=phiết|n
苯=bổn|n
茉=mạt|n
茎=thân/hành|n
茭=giao|n
茯=phục|n
茱=thù|n
茴=hồi|n
茶=trà|n
茼=đồng|n
草=cỏ/cây cỏ/thảo|n
荨=tầm|n
药=thuốc/dược|n
莜=du|n
菌=khuẩn|n
菖=xương|n
菜=đồ ăn/rau/món ăn/thái|n
菟=thố|n
菠=cải bó xôi|n
菩=bồ|n
萤=huỳnh|n
萱=huyên|n
葖=đột|n
蒜=tỏi|n
蒺=tật|n
蓑=thoa|n
蓖=tỳ|n
蔷=tường|n
薹=đài|n
藓=tiển|n
藿=hoắc|n
蘘=nhương|n
處=xử|n
虫=trùng|n
虬=cầu|n
虱=rận/sắt|n
虾=tôm/hà|n
蚂=mã|n
蚜=nha|n
蚝=hào|n
蚯=khâu|n
蚰=du|n
蚱=con ve|n
蚶=ham|n
蛆=giòi/thư|n
蛇=rắn/xà|n
蛋=trứng/đản|n
蛐=con dế|n
蛔=hồi|n
蛲=nhiêu|n
蛾=nga|n
蜃=thận/thận (*con trai)|n
蜈=ngô|n
蜉=phù|n
蜗=oa|n
蜘=tri/nhện|n
蜜=mật|n
蜡=sáp/đèn cầy|n
蜥=thằn lằn/rắn mối|n
蜻=tinh|n
蜾=quả|n
蝈=quắc|n
蝌=khoa|n
蝙=biên|n
蝮=phúc/rắn hổ mang|n
蝰=khuê|n
蝲=lạt|n
蝴=hồ|n
蝻=nam|n
蝼=lâu|n
螃=bàng|n
螟=minh|n
螳=đường|n
蟋=tất|n
蟑=chương|n
蠓=mông|n
蠹=mọt/con mọt|n
血=máu/huyết|n
衙=nha|n
袈=ca|n
裆=háng/đang/đũng quần|n
裥=cán|n
裨=tì/bì|n
褡=đáp|n
襟=vạt áo|n
讣=phó|n
词=từ|n
诗=thơ/thi|n
话=lời nói/nói|n
课=khóa|n
谍=điệp|n
谚=ngạn|n
谜=mê/câu đố|n
谰=lan|n
谵=chiêm|n
谶=sấm|n
豆=đậu|n
豌=oản|n
豚=đồn|n
豨=hi|n
貂=chồn/điêu|n
貔=tỳ|n
賊=tặc|n
财=tài|n
账=sổ sách/món nợ|n
货=hàng/hóa|n
贼=tặc/trộm/kẻ trộm|n
赭=giả|n
跆=đài|n
跗=phụ|n
踝=mắt cá chân/mắt cá|n
踺=kiện|n
蹠=chích|n
蹼=màng|n
車=xa|n
轱=cô|n
轶=dật|n
辈=bối|n
辊=cổn|n
辎=truy|n
辙=triệt|n
郡=quận|n
酒=rượu/tửu|n
酵=diếu|n
酶=môi|n
醋=dấm/dấm chua/thố|n
醚=ê-te|n
醛=thuyên|n
醪=lao|n
釉=men/men (gốm, sứ)|n
量=lượng/đo|n
鏊=ngao|n
鑰=thược|n
钒=phàm|n
钙=canxi|n
钚=Plutonium/bất|n
钠=Natri|n
钡=bối|n
钨=vonfram/ô/|n
钹=chũm chọe/cái nón úp|n
钾=kali/giáp (Ka)|n
铀=Uranium/Urani|n
铂=bạch kim|n
铅=chì|n
铈=thị|n
铜=đồng|n
铝=nhôm|n
铟=nhân|n
铠=khải|n
铬=crôm|n
锅=nồi/oa|n
锌=kẽm|n
锗=Germanium|n
锣=la/cái chiêng|n
锨=hân/xẻng|n
锰=mangan|n
锸=tráp|n
锹=cái xẻng/thiêu|n
镁=Magiê|n
镉=Cadmium Cd|n
镍=niken|n
镏=lưu|n
镔=tấn|n
镖=tiêu|n
镢=quắc|n
镣=xích chân|n
镧=lan|n
镭=Radium|n
镯=vòng tay|n
镲=sát|n
闺=khuê/khuê phòng|n
阀=phiệt|n
阇=đồ|n
阈=quắc|n
队=đội|n
陛=bệ|n
院=viện/sân|n
雙=song|n
雨=mưa/vũ|n
雾=sương mù/vụ|n
霓=nghê|n
霜=sương|n
霰=tản|n
霹=sấm sét|n
鞋=giày|n
韭=hẹ/cửu|n
音=âm|n
韵=vận|n
頭=đầu|n
顏=nhan|n
颌=quai hàm|n
颚=hàm|n
颞=nhiếp|n
颧=quyền|n
飓=cụ|n
饦=thác|n
饭=cơm/phạn|n
饴=di|n
饼=bánh/bính|n
饽=bánh ngọt điểm tâm|n
馄=hồn|n
馒=man|n
驴=con lừa/lừa|n
驸=phụ|n
骈=biền|n
骰=xúc xắc/con xúc xắc|n
骶=đế|n
骷=khô|n
骸=xương cốt|n
髂=khá|n
髋=xương hông|n
髌=bận|n
鱼=cá/ngư|n
鱿=vưu|n
鲇=niêm|n
鲑=khuê|n
鲢=liên|n
鲣=kiên|n
鲥=thì|n
鲫=tức|n
鲮=lăng|n
鲱=phi|n
鲲=côn|n
鲳=xương|n
鲶=niêm|n
鳃=mang|n
鳊=biên|n
鳍=vây cá|n
鳔=phiêu|n
鳕=tuyết|n
鳖=ba ba/rùa/con ba ba|n
鳙=dung|n
鳜=quyết|n
鳝=thiện/lươn|n
鳞=vảy/lân|n
鳟=tỗn|n
鸨=bảo|n
鸬=lô|n
鸳=uyên|n
鸵=đà|n
鸸=nhi|n
鹁=bồ câu nhà|n
鹅=ngỗng/nga/ngan|n
鹈=đề|n
鹌=am|n
鹦=anh|n
鹧=chá|n
鹪=tiêu|n
鹰=ưng/Ưng|n
麂=kỷ|n
麋=nai|n
麒=kỳ|n
麝=xạ|n
麸=phu|n
麾=huy|n
鼬=chồn sóc/Itachi|n
鼯=ngô|n
齿=răng|n
龃=trở|n
龅=bao|n
笼=cái lồng|x
￥=$|x
〥=8|x
ぁ=a|x
ア=a|x
あ=a|x
ィ=i|x
ぃ=i|x
イ=i|x
い=i|x
ウ=u|x
う=u|x
エ=e|x
え=e|x
オ=o|x
お=o|x
カ=ka|x
か=ka|x
ガ=ga|x
が=ga|x
キ=ki|x
き=ki|x
ぎ=gi|x
ク=ku|x
く=ku|x
グ=gu|x
ぐ=gu|x
ケ=ke|x
け=ke|x
げ=ge|x
コ=ko|x
こ=ko|x
ご=go|x
サ=sa|x
さ=sa|x
ざ=za|x
シ=shi|x
し=shi|x
ジ=ji|x
じ=ji|x
ス=su|x
す=su|x
ズ=zu|x
ず=zu|x
せ=se|x
ゼ=ze|x
ぜ=ze|x
そ=so|x
ぞ=zo|x
タ=ta|x
た=ta|x
ダ=da|x
だ=da|x
チ=chi|x
ち=chi|x
ツ=tsu|x
つ=tsu|x
づ=du|x
テ=te|x
て=te|x
デ=de|x
で=de|x
ト=to|x
と=to|x
ド=do|x
ど=do|x
ナ=na|x
な=na|x
ニ=ni|x
に=ni|x
ヌ=nu|x
ぬ=nu|x
ネ=ne|x
ね=ne|x
ノ=no|x
の=no|x
ハ=ha|x
は=ha|x
バ=ba|x
ば=ba|x
パ=pa|x
ぱ=ba|x
ヒ=hi|x
ひ=hi|x
ビ=bi|x
び=bi|x
ぴ=pi|x
フ=fu|x
ふ=fu|x
ブ=bu|x
ぶ=bu|x
ぷ=pu|x
へ=he|x
ベ=be|x
べ=be|x
ペ=pe|x
ぺ=pe|x
ホ=ho|x
ほ=ho|x
ぼ=bo|x
ポ=po|x
ぽ=po|x
マ=ma|x
ま=ma|x
ミ=mi|x
み=mi|x
ム=mu|x
む=mu|x
メ=me|x
め=me|x
モ=mo|x
も=mo|x
ャ=ya|x
や=ya|x
ゆ=yu|x
ョ=yo|x
ヨ=you|x
よ=yo|x
ラ=ra|x
ら=ra|x
リ=ri|x
り=ri|x
ル=ru|x
る=ru|x
レ=re|x
れ=re|x
ロ=ro|x
ろ=ro|x
ワ=wa|x
わ=wa|x
を=wo|x
ン=n|x
ん=n|x
ㄅ=bao/ba|x
ㄇ=sao|x
ㄉ=đích|x
ㄊ=đột|x
ㄋ=nãi/ni|x
ㄌ=lực|x
ㄍ=cá|x
ㄎ=khốc|x
ㄏ=phu|x
ㄐ=cưu|x
ㄚ=nha/a|x
ㄛ=ồ|x
ㄜ=ách|x
ㄝ=dã/đích|x
ㄟ=đích|x
ㄡ=u|x
ㄣ=ân|x
ㄧ=một|x
ㄨ=W|x
丁=đinh|x
七=bảy/thất|x
丈=trượng|x
三=ba/tam|x
上=bên trên/lên/trên/trước/thượng|x
下=hạ/dưới/xuống/lần|x
不=không/bất|x
丏=miễn|x
丑=xấu/Sửu|x
专=chuyên|x
且=lại/mà lại/tạm/thả/mà|x
世=thế/đời|x
丘=đồi|x
丙=bính|x
业=nghiệp/nghề|x
丛=bụi/tùng/bụi rậm/hợp/bụi rậm|x
东=đông/nghĩa vụ chủ nhà|x
丝=tơ/sợi/ti/tia|x
丞=thừa|x
両=lạng|x
丢=ném/mất|x
严=nghiêm|x
丧=tang|x
个=cái/người/quả/cá|x
丫=nha|x
中=bên trong/trúng/trung/giữa/trong|x
丯=phong|x
丰=phong|x
丱=quán|x
串=xuyên/xuyến/chuỗi|x
临=lâm/gặp/trước khi|x
丶=,|x
丸=hoàn|x
主=chủ/chúa|x
丽=lệ|x
举=nâng/cử/giơ/cử động|x
丿=phiệt|x
乀=phật|x
乂=nghệ|x
乃=chính là/nãi/là|x
乆=cửu|x
么=a/sao|x
义=nghĩa|x
乌=ô|x
乍=chợt/sạ|x
乎=hồ/tử|x
乏=mệt/thiếu/phạp|x
乐=vui/mừng/nhạc|x
乒=binh|x
乔=kiều|x
乖=ngoan/nghe lời/quai/láu lỉnh/thông minh|x
乘=thừa/lợi dụng/thừa lúc/ngồi/cưỡi/nhân/x|x
乙=Ất/B|x
乜=liếc|x
九=chín/cửu|x
乞=xin|x
习=tập/quen|x
乳=sữa/nhũ|x
乾=càn|x
亅=quyết|x
予=cho/dư|x
争=tranh/tranh giành|x
亊=sự|x
二=hai/nhị|x
亏=thua thiệt/lỗ/thiếu/khuy/mệt/thiếu (thiệt thòi)/thiệt thòi|x
亐=tại|x
云=mây/vân/nói|x
互=lẫn nhau/hỗ|x
亓=kỳ|x
五=năm/ngũ|x
井=giếng/tỉnh/井|x
亘=triền miên|x
亚=á/kém|x
亜=á|x
亟=cấp bách|x
亠=đầu|x
亡=vong/mất|x
亢=cang|x
交=giao/nộp/đóng|x
亥=hợi|x
产=sinh/sản|x
亨=hừ/hanh|x
亩=mẫu|x
享=hưởng|x
京=kinh|x
亭=đình|x
亮=sáng/lượng/sáng lên/phát sáng/rộng mở/lên giọng/to tiếng/bày ra/hiện ra|x
亯=hanh|x
亲=thân/hôn|x
亳=Bặc|x
亵=khinh nhờn/dâm loạn/tiết|x
亶=đản|x
亸=đả|x
亹=vỉ|x
亻=nhân|x
什=thập/cái|x
仁=nhân|x
仂=lặc|x
仄=trắc|x
仆=bộc|x
仇=thù|x
仉=chưởng|x
今=nay/bây giờ/kim|x
介=giới/trung gian|x
仍=vẫn/dựa theo/nhưng|x
仓=kho/thương/cabin/chiếm giữ/kho thóc|x
仔=tử|x
仗=cầm/trận|x
付=giao|x
仝=đồng|x
仡=ngật|x
代=thay mặt/đời/thay/đại|x
令=khiến/lệnh/làm/làm cho|x
以=lấy/dùng/dĩ/với|x
仪=nghi/dụng cụ/(dụng cụ)|x
仰=ngửa/ngưỡng|x
仲=trọng|x
仵=ngỗ|x
件=kiện/món|x
任=mặc cho/đảm nhiệm/lần/nhiệm/cho dù/Nhậm/nhiệm kỳ|x
份=phần/phân/phận|x
仿=phảng phất/mô phỏng|x
企=mong đợi|x
伈=tầm|x
伉=kháng|x
伊=y|x
伋=cấp|x
伍=ngũ|x
伎=kỹ|x
伏=nằm/ẩn náu/phục/nằm sấp|x
伐=phạt/chặt|x
休=đừng/nghỉ/hưu/thôi|x
伕=phu|x
众=chúng|x
优=ưu|x
伙=băng/hỏa|x
会=sẽ/biết/lại/hội/chút//回|x
伝=vân|x
伟=vĩ|x
传=truyền/truyện|x
伡=xa|x
伤=tổn thương/thương|x
伦=luân|x
伪=ngụy|x
伫=đứng im lặng hồi lâu|x
伯=bá|x
估=đánh giá|x
伱=ngươi|x
伲=ní|x
伶=linh|x
伷=khúc|x
伺=tứ|x
伻=bình|x
似=như/giống như/tự/dường như/tựa như/hình như|x
伽=già|x
佀=tự|x
佃=điền|x
佅=mại|x
佈=bố|x
佉=khư|x
佊=bỉ|x
佋=thiệu|x
低=thấp|x
住=ở/được/lại|x
佐=tá|x
佑=phù hộ/hữu|x
体=thể|x
佔=chiếm|x
何=gì|x
佘=xa/xà|x
余=dư/hơn|x
佛=Phật/phật|x
作=làm/tác|x
佝=câu|x
佞=nịnh|x
佟=đông|x
佣=dung|x
佧=kha|x
佩=đeo/bội|x
佫=hạc|x
佳=tốt|x
佴=nhị|x
併=gồm/đều|x
佷=chất|x
佹=quỷ|x
佺=thuyên|x
佼=giảo|x
佽=thứ|x
侁=sân|x
侃=tán gẫu/khản|x
例=lệ|x
侌=âm|x
侍=hầu/tùy tùng|x
侏=chu|x
侗=đồng|x
侘=sá|x
供=cung cấp/cúng|x
侜=chu|x
依=theo/y theo/dựa vào|x
侞=Ru|x
侠=hiệp|x
侣=lữ|x
侥=gặp may mắn|x
侦=trinh thám|x
侧=bên cạnh/trắc/sườn/bên/chếch/phe/nghiêng|x
侨=kiều|x
侫=nịnh|x
侮=khinh/khinh miệt|x
侯=hầu|x
侴=sửu|x
侵=xâm|x
侷=cục|x
俄=nga|x
俊=tuấn|x
俎=trở|x
俏=xinh đẹp|x
俗=tục|x
俘=bắt được/bắt được (tù binh)|x
俚=lý|x
俛=phủ|x
保=bảo đảm/bảo/bảo vệ|x
俞=du|x
俟=chờ|x
信=tin/thư/tín|x
俦=trù|x
俫=lai|x
俬=cụ|x
俭=kiệm/cần kiệm|x
俱=đều|x
俵=biểu|x
俶=thục|x
俸=bổng|x
俾=tỷ|x
倂=tính|x
倅=thối|x
倈=lai|x
倍=lần/bội|x
倏=chợt|x
倐=chợt|x
倕=thùy|x
倖=may|x
候=đợi|x
倚=dựa/ỷ|x
倜=thích|x
倞=kình|x
借=mượn/cho mượn/tá|x
倡=xướng|x
倢=tiệp|x
倣=phỏng|x
値=trị|x
倥=không|x
倦=mệt mỏi|x
倨=ngạo mạn|x
倩=thiến/xinh đẹp|x
倪=nghê|x
倭=Uy|x
倯=tùng|x
倷=nãi|x
倻=da|x
值=giá trị/gặp/trị giá/trực|x
倾=nghiêng/khuynh|x
偁=xưng|x
偃=ngã/dừng lại/ngã ngựa|x
假=giả/nghỉ|x
偈=kệ|x
偊=vũ|x
偋=bình|x
偌=như vậy|x
偏=lệch/lại/thiên|x
偓=ác|x
偕=giai/cùng|x
偟=hoàng|x
偢=thu|x
健=kiện|x
偪=bức|x
偭=mạn|x
偲=ti|x
偶=ngẫu/ta/chợt/ngẫu nhiên/thỉnh thoảng/tượng/rối|x
偸=thâu|x
偹=bị|x
偺=cha|x
偿=thường/bồi thường|x
傅=phó|x
傈=lật|x
傉=nộc|x
傍=bàng/bên cạnh|x
傒=hề|x
傕=giác|x
傚=hiệu|x
傛=dung|x
傣=thái|x
傤=tái|x
储=trữ|x
傫=trói|x
催=thúc/thôi/thúc dục/thúc giục|x
傻=ngốc/sỏa/ngu|x
僄=phiêu|x
僈=mạn|x
僊=tiên|x
僌=tái|x
働=động|x
僝=sạn|x
僞=ngụy|x
僡=huệ|x
僣=thiết|x
僧=tăng|x
僩=giản|x
僰=Bặc|x
僱=mướn|x
僲=tiên|x
僴=giản|x
僵=cương|x
僶=mẫn|x
僻=tịch/tích|x
僿=tái|x
儁=tuấn|x
儋=đam|x
儌=kiêu|x
儍=sọa|x
儎=tái|x
儒=nho|x
儗=nghĩ|x
儩=tứ|x
儭=sấn|x
儱=lung|x
儳=sàm|x
儵=thúc|x
儸=la|x
儽=lỗi|x
儿=nhi/con|x
兀=ngột|x
允=đồng ý|x
元=nguyên/đồng|x
兄=huynh|x
充=mạo xưng/sung/nạp|x
兆=điềm báo/triệu/điềm/triệu (*ngàn tỷ)/triệu (*mười triệu tỷ)/ngàn tỷ|x
先=trước/tiên/trước tiên|x
兊=đoài|x
克=khắc/gram|x
兔=thỏ|x
兖=duyện|x
兙=thập|x
兜=túi/vòng/lượn|x
全=toàn/toàn bộ|x
兪=du|x
八=tám/bát|x
公=công/đực|x
兰=lan|x
共=chung/tổng|x
关=quan/đóng/nhốt/cửa ải|x
具=cỗ/cụ/có/bày đủ/đủ/đồ/(chiếc) có|x
兹=tư|x
养=nuôi/dưỡng|x
冀=ký|x
冁=xiên|x
冂=quynh|x
冄=nhiễm|x
内=bên trong/nội|x
円=viên/yên|x
冇=mão|x
冈=cương|x
冉=nhiễm|x
册=sách|x
冏=sáng|x
冑=trụ|x
冓=cấu|x
冔=hu|x
冕=miện|x
冗=nhũng|x
农=nông|x
冠=quan|x
冣=tối|x
冤=oan/oán|x
冥=minh|x
冦=khấu|x
冩=tả|x
冫=băng|x
冬=đông|x
冮=giang|x
冯=phùng|x
冰=băng/rét/đá|x
冱=hộ|x
冲=xông/trùng/hướng/xung|x
决=quyết/vỡ|x
况=huống/huống hồ|x
冶=dã|x
冷=lạnh/lãnh|x
冻=đông lạnh/đông|x
冼=tiển|x
净=chỉ toàn/sạch|x
凂=mỗi|x
凄=thê|x
准=chuẩn/đúng/chính xác/cho phép|x
凈=tịnh|x
凉=lạnh/mát|x
凊=sảnh|x
凋=điêu|x
凌=lăng|x
凓=lật|x
凔=sương|x
凖=chuẩn|x
凘=tư|x
凙=đạc|x
凛=lẫm/run sợ|x
凝=ngưng|x
凤=phượng|x
凫=phù|x
凭=bằng|x
凰=hoàng|x
凳=băng ghế/đắng/ghế|x
凴=bằng|x
凵=khảm|x
凶=hung/ác/hung ác|x
凸=lồi|x
凹=lõm/ao|x
击=kích|x
刁=kén ăn/xảo quyệt|x
刂=đao|x
刅=sang|x
分=phân/điểm/phần/phút|x
刊=san|x
刍=sô|x
刑=hình|x
列=liệt/nhóm/đoàn/hàng|x
刘=lưu|x
则=thì/tắc thì/tắc/lại/là/bản|x
刚=vừa/cương/mới vừa/cứng/cương|x
创=sáng tạo/sáng lập/chế/thương|x
刜=phất|x
初=sơ/ban đầu|x
判=phán/xử|x
刦=kiếp|x
刧=kiếp|x
刨=đào/(đào) bào|x
利=lợi/sắc|x
别=đừng/khác/chia ly/biệt/chớ/giắt|x
刬=sản|x
刭=hĩnh|x
刴=đóa|x
制=chế|x
刷=xoát/cà/xoạt|x
券=khoán|x
刹=sát|x
刺=đâm/gai/thứ/thích|x
刼=kiếp|x
刾=thích|x
刿=quế|x
剁=chặt/băm|x
剂=tề|x
剃=cạo|x
剉=tỏa|x
削=gọt|x
剌=ngượng nghịu|x
前=trước/tiền|x
剎=sát|x
剏=sáng|x
剔=loại bỏ/cạo|x
剕=phí|x
剖=mổ/phẫu|x
剗=sản|x
剚=chí|x
剟=xuyết|x
剠=kình|x
剣=kiếm|x
剧=kịch/phim|x
剨=lưu|x
剩=thừa/thặng/thừa lại/còn dư lại/còn lại|x
剪=cắt/kéo/cắt bỏ|x
副=phó/thứ/bộ|x
剰=thừa|x
剱=kiếm|x
剳=tráp|x
剷=sản|x
剸=chuyển|x
剽=phiếu|x
劄=tráp|x
劈=bổ/phách/chẻ/chém|x
劋=giảo|x
劎=kiếm|x
劒=kiếm|x
劓=nhị|x
劖=thiền|x
劘=mi|x
劚=chủ|x
办=xử lý/làm/bạn/đủ|x
加=thêm/gia|x
务=vụ|x
劣=kém|x
动=động/di chuyển|x
助=trợ/giúp|x
努=nỗ|x
劫=cướp/kiếp|x
励=lệ|x
劲=kình/sức lực|x
劳=cực khổ/lao|x
劵=khoán|x
効=hiệu|x
劼=cật|x
势=thế/xu thế|x
勃=đột nhiên|x
勅=sắc|x
勇=dũng|x
勉=miễn/nỗ lực|x
勋=huân/công lao|x
勌=quyện|x
勍=kình|x
勐=mãnh|x
勑=lai|x
勔=miễn|x
勘=khám|x
募=quyên/mộ|x
勠=lục|x
勤=cần/chuyên cần|x
勦=tiễu|x
勩=duệ|x
勲=huân|x
勷=nhương|x
勹=bao|x
勺=muôi/chước/muỗng|x
勽=câu|x
匀=vân/đều đặn|x
匃=cái|x
匈=hung|x
匉=phanh|x
匊=cúc|x
匋=đào|x
化=hóa/tan|x
北=bắc|x
匙=chìa/thìa|x
匜=di|x
匝=vòng/táp|x
匟=kháng|x
匠=tượng|x
匡=cứu/khuông|x
匪=phỉ|x
匮=quỹ|x
匰=đơn|x
匵=độc|x
匸=hệ|x
匹=thớt/thất|x
区=khu|x
医=y/chữa|x
匽=yển|x
匿=nặc|x
十=mười/thập/mươi/chục|x
千=ngàn/thiên/nghìn/ngàn|x
卅=tạp|x
升=thăng/lên chức|x
午=trưa/buổi trưa/Ngọ|x
半=nửa/bán/rưỡi|x
卋=thế|x
卌=tấp|x
卍=vạn|x
华=hoa|x
协=hiệp|x
卐=vạn|x
卑=ti/thấp hèn|x
卒=tốt/chết|x
卓=trác|x
单=đơn/đan|x
南=nam/Minami|x
博=bác|x
卜=bốc/bói|x
卞=biện|x
卡=thẻ/kẹt/tạp/phiếu|x
卢=lư|x
卤=kho/lỗ|x
卦=quẻ|x
卧=nằm/ngọa|x
卨=tiết|x
卩=tiết|x
卫=vệ/Vệ|x
卬=ngang|x
卮=chi|x
卯=mão|x
印=ấn/in|x
危=nguy|x
卲=thiệu|x
即=tức/là|x
卷=quyển/cuốn/quăn|x
卽=tức|x
卿=khanh|x
厂=nhà máy/hán/xưởng/cửa hàng|x
厄=ách|x
历=lịch|x
厉=lệ/nghiêm khắc|x
压=ép/áp/đè|x
厌=ghét/chán ghét/yếm|x
厎=chỉ|x
厐=lớn|x
厓=nhai|x
厕=xí/vệ sinh|x
厖=mang|x
厘=ly|x
厚=dày/hậu/dầy|x
厛=sảnh|x
厝=thố|x
原=nguyên|x
厠=xí|x
厢=toa/mái hiên|x
厤=lịch|x
厦=hạ|x
厨=trù|x
厪=cận|x
厫=ngao|x
厮=tư|x
厯=lịch|x
厰=xưởng|x
厺=khứ|x
县=huyện/nếu là địa danh Nhật thì là tỉnh|x
参=tham gia/vạch tội/sâm/tố/tham|x
叅=xam|x
叆=ái/mờ mịt|x
叇=đãi|x
叉=xiên|x
友=bạn/hữu|x
反=phản/ngược|x
发=phát/tóc/|x
变=biến/thay đổi|x
叙=tự/nói|x
叛=phản/phản bội|x
叡=duệ|x
口=miệng/ngụm/khẩu/thanh|x
古=cổ|x
另=khác/lánh|x
叧=lánh|x
叨=lẩm bẩm/nhận|x
叩=gõ/khấu|x
只=chỉ/con/cái/chích|x
召=triệu/cho đòi|x
叮=đinh/đốt/keng|x
台=đài/thai/bàn|x
叱=quát|x
右=phải/bên phải|x
叶=lá/diệp|x
号=hào/số/hiệu/kêu/số hiệu/gào|x
司=ti/tư/ty|x
叹=thán|x
叼=điêu/tha/ngậm/ngậm trong mồm|x
叽=chít/kít/chít chít/chít chít (zhitsss)|x
吁=ô/thở dài|x
吇=tử|x
合=hợp|x
吉=cát|x
吊=xâu/treo/câu|x
吋=tấc|x
同=cùng/đồng|x
名=tên/danh|x
后=sau/hậu/sau khi/phía sau|x
吏=lại|x
吐=nôn/nhả/thổ/ói|x
吕=Lữ|x
吚=nha|x
君=quân/-kun|x
吜=chǒu|x
吝=keo kiệt|x
吞=nuốt|x
吥=bất|x
否=không/hay không/phủ/phủ định|x
吧=đi/a/ba/sao/không/chứ/nữa|x
吨=tấn/đốn|x
吩=phân|x
吪=ngoa|x
含=ngậm/nén/chứa/hàm|x
吭=lên tiếng/cổ họng|x
吰=hồng|x
吱=kít|x
吴=ngô|x
吶=nột|x
吽=hồng|x
吿=cáo|x
呃=ách/ạch|x
呅=miệng nói|x
呆=ngốc/nán lại/ở|x
呌=khiếu|x
呎=thước|x
呐=a/nột/...(nột-nói chậm!!!)|x
呑=thôn|x
呒=mô|x
呔=này/oanh|x
呕=ọe/nôn/mữa|x
员=viên/đủ/thành viên|x
呙=oa|x
呜=ô|x
呝=ách|x
呡=môi|x
呣=mô|x
呧=để|x
周=tuần/chu/xung quanh/vòng|x
呪=chú|x
呫=chiếp|x
呯=bình|x
呰=tử|x
呱=oa|x
味=vị|x
呴=ha|x
呵=a|x
呼=hô|x
命=mệnh/mạng/lệnh/mệnh lệnh|x
呿=khư|x
咀=nhai|x
咁=như vậy|x
咅=phôi|x
咈=phất|x
咊=hòa|x
咍=hai|x
咎=tội trạng|x
咏=vịnh|x
咑=đát|x
咒=chú/rủa/nguyền rủa|x
咔=két|x
咕=cô/cục cục|x
咖=cà/già|x
咡=nhị|x
咥=hí|x
咨=tư|x
咩=be/be be|x
咪=meo/mễ|x
咬=cắn/giảo|x
咭=cười|x
咮=trụ|x
咯=lạc/rồi/roài|x
咲=tiếu|x
咳=khục/khái/khụ/ho khan/khặc|x
咵=khoa trương|x
咶=thở gấp|x
咸=mặn|x
咺=tuyên|x
咻=hưu/XÍU...UU!/xèo|x
咽=nuốt|x
哀=ai/buồn bã|x
品=phẩm/phẩm (品)|x
哇=oa|x
哈=a/cáp/hắc/ha|x
响=vang/tiếng nổ/hưởng/vang dội|x
哏=ngân|x
哐=bang/loảng xoảng|x
哑=câm/ách/khàn|x
哒=đát/đi|x
哓=hiêu|x
哕=uyết|x
哗=hoa/xôn xao/ồn ào/rào|x
哚=đoá/ pặc/pặc|x
哟=nha/ơ|x
哢=lộng/kêu|x
哥=ca|x
哦=a/nga/ah/nha|x
哨=trạm canh gác/còi|x
哩=đấy/lý/dặm|x
哪=cái kia/cái nào/đâu/na/chưa/kia/đó/chỗ nào/nào|x
哮=gào/hao|x
哱=hao|x
哲=triết|x
哴=bởi vì thống khổ quá độ mà nghẹn ngào|x
哺=mớm|x
哼=hừ/hanh/a|x
哽=ngạnh|x
唁=nghiễn|x
唅=hám|x
唆=toa/xui khiến|x
唇=môi/thần|x
唈=ấp|x
唉=ai/ôi|x
唌=đản|x
唎=li|x
唏=hí|x
唐=Đường/nhà Đường/đường|x
唗=đâu|x
唘=khải|x
唛=mạ|x
唝=cống|x
唠=lảm nhảm/lao|x
唡=lưỡng|x
唤=gọi/hoán/kêu|x
唦=a|x
唧=tức|x
唬=hù/hù dọa/doạ|x
唭=cức|x
售=bán|x
唯=duy|x
唰=bá/vù|x
唱=hát|x
唲=AAAAA|x
唴=bởi vì thống khổ quá độ mà nghẹn ngào|x
唵=úm|x
唶=giới|x
唸=niệm|x
唻=lai|x
唾=nhổ/thóa|x
唿=hô|x
啀=nhai|x
啁=trù|x
啄=mổ|x
啊=a/hả/ah|x
啋=thái/để ý tới|x
啍=đôn|x
啐=xì/phun|x
啓=khải|x
啖=đạm/ăn|x
啙=tử|x
啚=bỉ|x
啜=xuyết/uống|x
啣=hàm|x
啧=sách|x
啪=ba/BA~/đùng|x
啫=điệp|x
啬=sắc|x
啮=gặm/gặm|x
啯=quắc|x
啰=lải nhải|x
啲=đích|x
啸=khiếu/rít gào|x
啼=gáy|x
喀=rắc|x
喃=lẩm bẩm|x
善=thiện/tốt|x
喇=còi/lạt|x
喉=hầu/cổ họng|x
喎=oa|x
喏=ầy/dạ/ừ|x
喑=âm|x
喓=yêu|x
喔=ờ|x
喙=mỏ|x
喜=vui/mừng/thích/hỉ|x
喝=uống/quát/hây|x
喞=tức|x
喣=xǔ|x
喤=hoàng|x
喧=huyên/tiếng động lớn|x
喨=lượng|x
喫=khiết|x
喰=xan/Ghoul|x
喳=tra|x
喷=phun|x
喺=dính vào|x
喻=dụ/ví|x
喽=đi/rồi|x
嗃=hạc|x
嗄=sá|x
嗅=ngửi|x
嗈=ung|x
嗏=chà|x
嗐=hại|x
嗓=tiếng nói|x
嗙=khoác lác/khoe khoang|x
嗛=hàm|x
嗜=thích/thị|x
嗝=nấc|x
嗞=chi|x
嗡=ông/vù vù/vù|x
嗢=ốt|x
嗤=xùy/xuy/cười/giễu cợt/cười khúc khích/Xùy~~/xì|x
嗥=gào/grraaào|x
嗦=lắm điều|x
嗫=chiếp|x
嗮=sài|x
嗷=ngao/NGAO/gào|x
嗸=ngao|x
嗻=già|x
嗽=thấu|x
嘀=đích/nói thầm/thầm thì/nghi ngờ/nghi hoặc|x
嘅=khái|x
嘈=rầm rĩ/ồn ào|x
嘉=gia|x
嘌=nhanh chóng|x
嘎=dát/Ự...c|x
嘑=hô|x
嘒=uế|x
嘓=quắc|x
嘘=xuỵt/hư|x
嘚=đắc|x
嘝=hộc|x
嘟=bĩu/tít/bĩu môi/bíp|x
嘠=dát|x
嘡=boong boong|x
嘢=cũng|x
嘤=anh|x
嘱=chúc/dặn bảo|x
嘲=trào/giễu cợt|x
嘴=miệng/chủy|x
嘶=tê/hí/híz-khà-zzz|x
嘷=hào|x
嘻=ha ha/hi/ôi/hì hì/ha hả|x
嘿=hắc/này|x
噀=tốn|x
噂=tổn|x
噆=thảm|x
噉=đạm|x
噌=vụt|x
噎=nghẹn/ế|x
噏=hấp|x
噔=đăng/thịch|x
噗=phốc/hơi thở phù/hút bập bập/hút từng hơn ngắn|x
噜=lỗ/vò/líu ríu/nói nhiều|x
噢=úc/oh/ừ|x
噤=cấm|x
噩=ác mộng/ngạc|x
噪=táo/kêu|x
噶=cát|x
噷=hâm|x
嚄=hoát|x
嚎=gào/gào thét|x
嚐=thường|x
嚒=sao|x
嚖=huệ|x
嚛=hộ|x
嚜=muội|x
嚣=rầm rĩ/ồn ào|x
嚥=nuốt|x
嚬=tần|x
嚭=dĩ|x
嚲=đả|x
囊=túi|x
囍=hỷ|x
囏=gian|x
囓=khiết|x
囔=thì thầm|x
囗=vi|x
囘=hồi|x
囚=tù|x
四=bốn/tứ|x
囝=kiển|x
因=bởi vì/nhân/nguyên nhân/dựa vào|x
囡=niếp|x
团=đoàn/vo|x
囧=quýnh/quýnh :-( 囧|x
囬=hồi|x
园=vườn/viên|x
囮=ngoa|x
囯=quốc|x
困=khốn/buồn ngủ/khốn/vây/vây khốn|x
围=vây|x
囷=khuân|x
圂=hoạn|x
圅=hàm|x
圆=tròn|x
圈=vòng/quyển/giới|x
圏=vòng|x
圕=đồ|x
圜=viên|x
圝=loan|x
土=thổ/đất|x
圩=vu|x
圭=khuê|x
圮=tổn thương|x
地=địa|x
圳=quyến|x
场=trận/tràng/trường/cuộc/cơn/đợt/màn|x
址=chỉ|x
坂=phản|x
坉=độn|x
坊=phường|x
坍=than|x
坎=khảm|x
坏=xấu/hỏng/hư/phôi/phá hư|x
坑=hố/lừa/hãm hại/cái hố/lừa bịp/vũng hố|x
坚=kiên|x
坛=đàn/vò|x
坜=lịch|x
坢=bán|x
坤=khôn|x
坦=thản/tank|x
坨=đống|x
坩=kham|x
坪=bãi/bình/bình địa|x
坱=dưỡng|x
坵=khâu|x
坷=khả|x
坼=sách|x
坿=phụ|x
垂=rủ xuống/thùy/buông xuống|x
垄=lũng|x
垅=lũng|x
垆=lư|x
型=hình|x
垕=hậu|x
垚=nghiêu|x
垛=đống/gò|x
垞=tra|x
垢=cấu|x
垦=khẩn|x
垫=đệm/kê lót/lót|x
垭=khe núi|x
垱=đáng|x
垲=khải|x
垵=am|x
垻=bá|x
垽=ngận|x
垿=tự|x
埃=ai/cát bụi/bụi|x
埄=bổng|x
埆=xác|x
埇=dũng|x
埌=lãng|x
城=thành|x
埗=khu neo đậu tàu|x
埚=qua|x
埝=niệm|x
域=vực|x
埧=cụ|x
埨=luân|x
埭=đại|x
埮=đàm|x
埰=thải|x
埳=khảm|x
埵=đất cứng|x
埶=nghệ|x
基=cơ/dựa vào|x
埻=đôn|x
埼=kỳ|x
堀=quật|x
堃=khôn|x
堉=dục|x
堍=miễn|x
堎=lăng|x
堑=hố/hào|x
堙=nhân|x
堡=bảo/lâu đài|x
堦=giai|x
堪=có thể|x
堰=yển|x
堶=đà|x
堾=xuân|x
塃=hoang|x
塅=đoạn|x
塆=loan|x
塑=tố/nặn|x
塔=tháp|x
塘=đường/hồ|x
塙=xác|x
塚=trủng|x
塞=nhét/nút/bỏ vào|x
塡=điền|x
塨=cung|x
塲=tràng|x
塼=chuyên|x
塽=sảng|x
塿=lũ|x
境=cảnh|x
墍=ký|x
墐=cận|x
墑=thương|x
墖=tháp|x
増=tăng|x
墘=kiền|x
墙=tường|x
墠=thiện|x
墡=thiện|x
墦=phiền|x
墨=mực/mặc|x
墩=đôn|x
墫=tôn|x
墬=địa|x
墻=tường|x
壁=bích/vách tường|x
壅=ủng|x
壆=huyệt|x
壈=lẫm|x
壍=tiễn|x
壕=hào|x
壖=nhuyên|x
壜=đàm|x
壠=lũng|x
壤=nhưỡng|x
壮=tráng/cường tráng|x
声=âm thanh/thanh/tiếng|x
壳=xác|x
壶=ấm/hồ/hũ|x
壸=khổn|x
壹=nhất|x
壻=tế|x
壼=khổn|x
夀=thọ|x
夂=tri|x
处=chỗ/nơi/xử|x
変=thay đổi|x
夊=tuy|x
夏=hạ/Hạ|x
夒=nao|x
夔=quỳ|x
夕=tịch|x
外=bên ngoài/ngoại/ra/ở ngoài|x
夙=túc|x
夜=đêm/dạ|x
够=đủ/với/cú|x
夤=di|x
夥=hỏa/khỏa|x
大=lớn/đại|x
天=trời/ngày/thiên/bầu trời|x
太=quá/thái/rất|x
夭=thiên/yểu/天/yêu|x
央=ương/van xin/trung tâm|x
夯=kháng|x
失=mất/thất|x
夲=bổn|x
夸=khen/khoa trương/khoa/khoe|x
夹=kẹp/giáp/chen lẫn/gắp|x
奀=ân|x
奂=hoán|x
奄=yểm|x
奅=pháo|x
奈=nại|x
奉=phụng/dâng tặng|x
奋=phấn|x
奎=khuê|x
奏=tấu|x
契=khế/văn tự|x
奓=trá|x
奔=chạy/bôn|x
奕=dịch|x
套=bộ/đeo/vỏ/bộ đồ/buộc|x
奚=hề|x
奠=điện|x
奢=xa xỉ|x
奥=áo|x
奭=thích|x
奰=bị|x
奲=đả|x
奴=nô|x
奶=sữa/nãi|x
奸=gian|x
奼=xá|x
好=tốt/hảo/được/thật/dễ/thích/xong|x
妁=chước|x
妃=phi|x
妄=vọng|x
妆=trang|x
妇=phụ|x
妊=nhẫm|x
妍=nghiên|x
妐=chung|x
妓=kỹ/kỹ (nữ)|x
妘=vân|x
妙=diệu/hay|x
妞=cô nàng/nàng/con gái/nữu|x
妣=tỷ|x
妨=trở ngại/phương|x
妩=vũ|x
妬=đố|x
妳=ngươi/nàng|x
妺=muội|x
妻=vợ/thê|x
妾=thiếp|x
姁=hủ|x
姈=linh|x
始=bắt đầu/thủy/mới|x
姑=cô|x
姓=họ/tính|x
委=ủy|x
姗=san|x
姙=nhâm|x
姚=diêu|x
姜=gừng/khương|x
姤=cấu|x
姥=bà ngoại|x
姦=gian|x
姪=điệt|x
姬=cơ/hime|x
姮=hằng|x
姱=khoa|x
姸=nghiên|x
姺=sâm|x
姻=nhân|x
姽=quỹ|x
姿=tư/tư thế/dáng dấp|x
娃=bé con/em bé/oa/trẻ con|x
娄=lâu|x
娇=kiều|x
娈=luyến|x
娉=phinh|x
娑=sa|x
娒=mai|x
娓=vỉ|x
娕=hình dạng đẹp|x
娖=xúc|x
娜=na|x
娟=quyên/đẹp đẽ/đẹp|x
娥=nga|x
娬=vũ|x
娭=ai|x
娯=ngu|x
娱=ngu|x
娴=nhàn|x
娷=đùn đẩy trách nhiệm|x
娼=kỹ nữ|x
娿=a|x
婀=a|x
婆=bà|x
婉=uyển|x
婓=phi|x
婘=quyền|x
婚=cưới/hôn|x
婞=hanh|x
婠=loan|x
婣=nhân|x
婥=sước|x
婬=dâm|x
婳=họa|x
婴=anh|x
婼=xúc|x
媒=môi/mai|x
媖=anh|x
媗=xuân|x
媚=mị|x
媛=viện|x
媜=trinh|x
媟=tiết|x
媦=vị|x
媭=tu|x
媮=thâu|x
媱=dao|x
媳=tức|x
媿=quý|x
嫀=hạo|x
嫂=tẩu|x
嫃=trinh|x
嫄=nguyên|x
嫇=minh|x
嫈=oanh|x
嫉=đố kị/tật|x
嫋=niệu|x
嫌=ngại|x
嫏=lang|x
嫔=tần|x
嫖=chơi gái/chơi/phiêu/chơi trai|x
嫚=mạn|x
嫛=ê|x
嫞=dung|x
嫡=đích|x
嫣=yên|x
嫩=non|x
嫪=lạc|x
嫰=nộn|x
嫳=phách|x
嫺=nhàn|x
嫽=liêu|x
嬀=quy|x
嬃=tu|x
嬉=đùa/chơi|x
嬍=mỹ|x
嬔=phiêm|x
嬗=thiện|x
嬛=huyên|x
嬝=niệu|x
嬢=nương|x
嬭=nãi|x
嬴=doanh/thắng/Doanh|x
嬾=lãn|x
嬿=yến|x
孀=sương|x
孃=nương|x
孅=tiêm|x
子=tử/con|x
孑=kiết|x
孒=quyết|x
孓=củng|x
孔=lỗ/khổng|x
孕=mang thai/dựng/chửa|x
孖=tư|x
孙=tôn|x
孚=phu|x
孛=bột|x
孜=tư|x
孝=hiếu|x
孟=mạnh|x
季=quý|x
孤=cô|x
孥=nô|x
学=học|x
孩=hài|x
孪=loan|x
孳=tư|x
孶=tư|x
孽=nghiệt|x
宀=miên|x
宁=thà/ninh|x
宅=trạch/chỗ ở|x
宇=vũ|x
守=thủ|x
安=an/sao|x
宋=tống|x
完=xong/hết/hoàn|x
宏=hồng|x
宓=mật|x
宗=tông|x
宙=trụ|x
定=định/bình tĩnh|x
宛=uyển|x
宜=nghi/nên/thích hợp|x
宝=bảo|x
实=thực/đầy|x
宠=sủng/cưng chiều|x
客=khách|x
宣=tuyên|x
室=thất/phòng|x
宦=hoạn|x
宧=di|x
宪=hiến|x
宫=cung|x
宬=thành|x
宭=quần|x
宰=làm thịt/tể/chủ trì|x
宴=yến/tiệc rượu|x
宵=tiêu|x
家=nhà/gia|x
容=cho/dung/sắc mặt|x
宼=khấu|x
宽=rộng/khoan/chiều rộng|x
宾=tân|x
宿=túc|x
寁=toản|x
寂=tịch|x
寃=oan|x
寄=gửi|x
寇=khấu|x
寉=hạc|x
富=giàu|x
寐=ngủ|x
寒=lạnh/hàn|x
寓=ngụ|x
寔=thực|x
寖=tẩm|x
寘=trí|x
寜=ninh|x
寝=ngủ|x
寞=mịch|x
察=xem xét/xét|x
寠=cũ|x
寡=quả|x
寤=ngụ|x
寥=liêu|x
寮=lều|x
寯=tuấn|x
寰=hoàn|x
寱=nghệ|x
寳=bảo|x
寸=tấc/inch/thốn|x
对=đối/đúng/đối với/với/đôi|x
寺=chùa/tự|x
寻=tìm/tầm|x
导=đạo|x
寿=thọ|x
封=phong|x
射=bắn/xạ|x
尅=khắc|x
将=đem/sẽ/tướng/tương/sắp|x
尉=úy|x
尊=tôn|x
小=nhỏ/tiểu|x
少=thiếu/ít/trẻ|x
尔=ngươi/thôi|x
尖=nhọn/tiêm/the thé/nhạy bén/mũi|x
尘=bụi/trần|x
尙=thượng|x
尚=còn/chú trọng/vẫn còn|x
尛=nhỏ bé|x
尟=tiển|x
尢=uông|x
尧=Nghiêu|x
尨=mang|x
尪=uông|x
尫=uông|x
尲=giam|x
尸=thi|x
尹=doãn|x
尺=xích/thước|x
尼=ni|x
尽=tận/tẫn/tận|x
尾=đuôi/vĩ|x
尿=nước tiểu/đi tiểu|x
层=tầng/tằng|x
屃=hý|x
屄=bi/âm hộ/lồn|x
居=cư|x
屈=khuất|x
届=giới|x
屋=phòng|x
屌=điểu|x
屏=bình phong/màn hình/hơi|x
屐=kịch|x
屑=mảnh|x
展=triển/giương/发|x
屛=bình|x
屝=phỉ|x
屠=đồ/giết/tàn sát|x
履=giày/lý|x
屧=tiệp|x
屩=cược|x
屭=hí|x
屮=triệt|x
屯=đồn|x
山=núi/sơn|x
屴=lực|x
屹=ngật|x
屺=dĩ|x
屼=ngộ|x
屾=sằn|x
岀=xuất|x
岁=tuổi/tuế|x
岂=há/khởi/há lại|x
岋=ngập|x
岐=kỳ|x
岑=sầm|x
岔=xóa|x
岘=hiện|x
岚=lam|x
岞=tạc|x
岧=thiều|x
岩=nham|x
岪=phất|x
岫=tụ|x
岬=giáp|x
岭=lĩnh|x
岱=đại|x
岳=nhạc/ngọn núi|x
岷=dân|x
岸=bờ|x
峂=đồng|x
峙=trì|x
峡=hạp|x
峣=nghiêu|x
峥=tranh|x
峨=nga|x
峩=nga|x
峫=da|x
峬=xinh đẹp duyên dáng|x
峭=tiễu|x
峯=phong|x
峰=phong/ngọn núi/Phong|x
峱=nạo|x
峿=ngô|x
崀=lương|x
崁=khám|x
崂=lao|x
崆=không|x
崇=sùng|x
崋=hoa|x
崌=cư|x
崎=kỳ/khi|x
崑=côn|x
崒=tốt|x
崔=thôi|x
崖=sườn núi/nhai|x
崙=lôn|x
崚=lăng|x
崛=vùng dậy/quật|x
崟=dần|x
崥=tỳ|x
崧=tung|x
崭=tiệm|x
崱=trắc|x
嵂=luật|x
嵆=kê|x
嵇=kê|x
嵎=ngu|x
嵏=tông|x
嵒=nham|x
嵖=tra|x
嵚=khâm|x
嵩=tung|x
嵲=niệt|x
嵽=điệt|x
嵾=sâm|x
嶂=chướng|x
嶌=đảo|x
嶍=tập|x
嶙=lân|x
嶢=nghiêu|x
嶮=hiểm|x
嶰=giải|x
巃=lung|x
巅=đỉnh|x
巇=hi|x
巉=sàm|x
巍=nguy|x
巎=nao|x
巓=điên|x
巖=nham|x
巘=nghiễn|x
巛=xuyên|x
川=xuyên/sông|x
巡=tuần|x
巢=tổ/sào/sào huyệt|x
左=trái/tả/bên trái|x
巧=xảo/khéo léo/đúng dịp|x
巨=cự/to/lớn|x
巩=củng|x
巫=Vu/vu|x
差=kém/chênh lệch/soa/sai/xui xẻo/sai dịch/error|x
己=mình/mấy|x
巴=ba/mong|x
巵=chi|x
巷=ngõ hẻm|x
巿=phất|x
帀=táp|x
布=vải/bố|x
帅=soái/đẹp trai/ngầu|x
希=hi|x
帐=trướng|x
帓=mạt|x
帕=khăn/bọc|x
帖=thiếp|x
帘=màn/mảnh vải|x
帛=lụa/tơ lụa|x
帜=xí|x
帟=diệc|x
帢=kháp|x
帣=quyển|x
帤=khăn tay|x
帨=thuế|x
席=tịch/bữa tiệc/ghế|x
帱=trù|x
帲=bình|x
帷=duy|x
常=thường|x
帼=quắc|x
帽=mũ/cái mũ|x
幅=bức/biên độ|x
幈=bình|x
幌=màn trướng|x
幎=mạc|x
幕=màn|x
幖=tiêu|x
幙=mạc|x
幛=chướng|x
幠=hô|x
幢=tràng|x
幧=thiêu|x
幨=xiêm|x
幪=mông|x
幮=trù|x
干=làm/cạn/khô/kiền|x
平=bình/phẳng/hòa/mét vuông|x
年=năm/niên/tuổi|x
幷=tịnh|x
幸=hạnh/may mắn|x
幺=yêu|x
幻=huyễn|x
幼=ấu|x
幽=u|x
广=rộng/quảng/rộng rãi|x
庁=sảnh|x
庄=trang|x
庆=khánh|x
庇=che chở/tí|x
庐=lư|x
庒=trang|x
库=kho/khố|x
应=ứng/đáp/ứng với/nên|x
底=ngọn nguồn/đáy/thực chất/cùng/cuối|x
庚=canh|x
府=phủ|x
庞=bàng|x
废=phế|x
庤=chí|x
庥=hưu|x
度=độ|x
座=tòa/tọa/ngồi/toà|x
庬=mang|x
庭=đình|x
庯=xinh đẹp|x
康=khang|x
庸=dung|x
庹=thỏa|x
庼=khoảnh|x
庾=dữu|x
廀=sưu|x
廉=liêm/Liêm|x
廊=hành lang|x
廋=lục soát/ẩn náu|x
廌=trĩ|x
廐=cứu|x
廓=khuếch|x
廕=ấm|x
廖=liêu|x
廙=dực|x
廥=quái|x
廧=tường|x
廰=sảnh|x
廱=ung|x
延=diên/kéo dài|x
建=xây/kiến|x
廻=hồi|x
廼=nãi|x
廾=củng|x
异=dị/khác|x
弆=khí|x
弇=yểm|x
弈=dịch|x
弊=tệ|x
弋=dặc|x
弎=tam|x
式=thức/Shiki|x
弑=thí|x
弔=điếu|x
弗=không|x
弘=hoằng|x
张=trương/tờ/mở/giương|x
弢=thao|x
弤=để|x
弥=di|x
弦=dây cung/huyền|x
弨=siêu|x
弩=nỏ|x
弪=kính|x
弭=nhị|x
弮=khuyên|x
弯=cong/loan/chỗ ngoặt/khom/ngoặt (khom)|x
弱=yếu/nhược|x
弶=cương|x
弹=đạn/đánh/gảy/bắn/nảy|x
强=mạnh/cường/mạnh mẽ|x
弻=bật|x
弾=đạn/弹|x
彀=cấu|x
彄=khu|x
彊=cường|x
彍=khoắc|x
彐=ký|x
彑=kệ|x
当=khi/làm/coi là/đương/nên/đem/đáng/coi|x
彔=lục|x
录=lục/ghi chép/quay/sao chép|x
彝=Di/di|x
彞=di|x
彟=ược|x
彠=hoạch|x
彡=sam|x
形=hình|x
彤=đồng|x
彦=ngạn|x
彧=úc|x
彩=màu/thương/thải|x
彪=bưu|x
彫=điêu|x
彬=bân/nho nhã|x
彭=bành|x
彯=phiêu|x
彰=rõ/chương|x
影=ảnh/Kage|x
彻=triệt|x
彼=kia/đối phương|x
彿=phất|x
往=hướng/vãng/đã qua/đi/hướng về|x
径=đường/kính|x
待=đợi/đãi/chờ/ở|x
徇=tuẫn|x
很=rất|x
徊=hồi|x
律=luật|x
後=sau/hậu|x
徍=vong|x
徐=từ|x
徒=đồ/uổng phí|x
得=đến/phải/được/đắc/bị/mắc|x
徨=hoàng|x
循=theo|x
徬=bạng|x
微=hơi/vi|x
徯=hề|x
徳=đức|x
徴=trưng|x
徵=trưng|x
德=đức/Druid|x
徽=huy|x
心=tâm|x
忄=tâm|x
忆=ức/(ký) ức|x
忉=đao|x
忍=nhẫn|x
忐=lo lắng|x
忓=can|x
忞=mân|x
忠=trung|x
忣=cấp|x
忧=lo|x
忨=ngoạn|x
忩=thông|x
快=nhanh/khoái/mau/hơn/sắp|x
忳=đồn|x
忴=linh|x
念=niệm/đọc|x
忸=nữu|x
忻=hân/hãn|x
忼=khảng|x
忽=chợt/hốt|x
怀=mang/hoài/ngực|x
态=thái/trạng thái|x
怂=sợ/kinh sợ/hèn/hãi|x
怃=vũ|x
怅=trướng|x
怆=sảng|x
怍=tạc|x
怒=giận/nộ|x
怔=giật mình/sợ/sợ run|x
怗=thiếp|x
怛=đát|x
怜=yêu/thương|x
思=nghĩ/tưởng nhớ/tư|x
怠=lười biếng/đãi|x
怡=di|x
急=gấp/cấp/cấp bách|x
性=tính/tính chất|x
怨=oán|x
怪=quái/trách/quá|x
怯=e sợ|x
怱=thông|x
怳=hoảng|x
怵=sợ hãi/sợ|x
怹=than|x
总=tổng/dù sao vẫn/chung quy/cuối cùng|x
恁=thế này|x
恃=ỷ lại/thị|x
恆=hằng|x
恇=khuông|x
恉=chỉ|x
恊=hiệp|x
恋=luyến/yêu|x
恍=bừng tỉnh/hoảng|x
恐=sợ/chỉ|x
恒=hằng|x
恓=tây|x
恕=tha thứ/thứ cho|x
恙=việc gì/bệnh nhẹ/bệnh|x
恝=kiết|x
恟=hung|x
恠=quái|x
恢=khôi|x
恣=tứ|x
恤=lo lắng/tuất/thương xót/T-shirt|x
恩=ân/dạ/ừ|x
恪=khác|x
恬=điềm/yên ổn|x
恭=cung/cung kính|x
息=hơi thở/tức|x
恳=khẩn|x
恶=ác/buồn nôn|x
恸=thảm thiết|x
恹=yêm|x
恻=xót xa|x
恼=buồn bực/ảo não/não|x
恽=uẩn|x
恾=thất kinh|x
悁=quyên|x
悂=phi|x
悄=lặng lẽ|x
悉=tất|x
悍=hung hãn|x
悔=hối hận/会|x
悖=bội/ngược lại|x
悙=qua loa|x
悚=sợ|x
悞=ngộ|x
悟=ngộ|x
悠=du|x
悢=lượng|x
患=hoạn/mắc|x
悤=thông|x
悦=duyệt/vui mừng|x
您=ngài/nâm/người|x
悪=ác|x
悬=treo/huyền/nâng|x
悭=khan|x
悲=buồn/bi|x
悳=trung|x
悴=tụy|x
悸=sợ|x
悹=quan|x
悺=quan|x
悼=điệu|x
悽=thê|x
悾=không|x
惇=đôn|x
惊=kinh|x
惋=thương tiếc|x
惎=kỵ|x
惑=nghi ngờ/hoặc|x
惓=quyền|x
惔=đàm|x
惘=ngơ ngẩn|x
惙=tuyết|x
惛=hôn|x
惜=tiếc|x
惟=duy|x
惠=huệ|x
惢=nhị|x
惥=dũng|x
惨=thảm|x
惩=trừng phạt/trừng|x
惪=đức|x
惫=bại|x
惬=thiếp|x
惭=tàm/tàm (thẹn)|x
惯=quen/thói quen/nuông chiều|x
惰=biếng nhác|x
惴=chúy|x
惵=điệt|x
惶=hoảng sợ|x
惷=xuẩn|x
惸=quỳnh|x
惺=tinh|x
惽=hôn|x
愁=sầu/buồn/ưu sầu|x
愈=càng/dũ/khỏi bệnh|x
愉=du|x
愊=phức|x
愐=miến|x
愒=khế|x
愔=âm|x
愕=kinh ngạc/ngạc|x
愚=ngu|x
感=cảm giác/cảm/cảm (giác)|x
愠=hờn/giận|x
愤=phẫn|x
愦=hội|x
愧=thẹn/xấu hổ/quý|x
愬=tố|x
愱=ji|x
愳=cụ|x
愼=thận|x
愽=bác|x
慁=hỗn|x
慂=dũng|x
慄=lật|x
慇=ân|x
慈=từ|x
慉=sáp|x
慌=hoảng/sợ|x
慎=thận|x
慓=phiếu|x
慕=mộ|x
慙=tàm|x
慜=mẫn|x
慢=chậm/mạn/nhờn|x
慤=khác|x
慥=tháo|x
慦=ngận|x
慧=tuệ|x
慬=cận|x
慭=ngận|x
慰=an ủi|x
慴=triệp|x
慵=thung/biếng nhác|x
慷=khảng|x
慸=sại|x
慼=thích|x
慾=dục/muốn/ham|x
憃=xuẩn|x
憇=khế|x
憋=nghẹn/nín|x
憎=tăng|x
憓=huệ|x
憖=ngận|x
憗=ngận|x
憙=hí|x
憧=sung|x
憨=khờ/đơn giản|x
憩=khế|x
憭=liêu|x
憯=thảm|x
憰=thôi|x
憱=xúc|x
憾=tiếc|x
懁=hoài|x
懃=cần|x
懆=tháo|x
懈=trễ/lười|x
懒=lười/lại/lãn/làm biếng/mệt mỏi/kiệt sức|x
懥=chí|x
懦=nọa|x
懭=khoảng|x
懵=mộng|x
懿=ý|x
戄=quặc|x
戅=tráng|x
戆=tráng|x
戈=qua/thương/mâu|x
戊=Mậu/mậu|x
戌=tuất|x
戍=đóng giữ|x
戎=nhung|x
成=thành|x
我=ta/ngã|x
戒=giới/cai|x
戕=tường|x
战=chiến|x
戚=thích|x
戛=kiết|x
戞=kiết|x
戢=tập|x
戣=khôi|x
戦=chiến|x
戯=hí|x
戱=hí|x
戴=mang|x
戹=ách|x
戺=sĩ|x
戼=mão|x
戽=hố|x
戾=lệ|x
所=chỗ/sở/viện|x
扁=dẹp/làm thịt/bẹp/đánh|x
扂=điếm|x
扆=ỷ|x
扇=phiến/quạt|x
扈=hỗ|x
手=tay/thủ|x
扌=thủ|x
扎=đâm/buộc/mổ/trát/ghim|x
扑=nhào/phốc/bổ nhào|x
托=nhờ/nắm/thác/nâng|x
扛=gánh/khiêng|x
扞=cản|x
扠=tra|x
扡=thiên|x
扤=ngột|x
扥=thác|x
扦=thiên|x
扩=khuếch trương|x
扬=giương/dương/vung/hất|x
扰=nhiễu/quấy nhiễu|x
扱=tráp|x
扳=vịn/ban/vặn/lật|x
扵=ư|x
扶=đỡ/vịn/phù|x
批=nhóm/phê|x
扺=chỉ|x
扼=ách/chặn/bóp|x
扽=cử động|x
承=nhận/thừa/thừa nhận|x
抄=chép/sao/vớ/xét|x
抆=vấn|x
抈=nguyệt|x
抉=quyết|x
抏=ngoan|x
抑=ức|x
抒=trữ|x
抔=bồi|x
投=ném/quăng/đầu|x
抖=run/đẩu/run rẩy/phấn chấn|x
抗=kháng|x
折=gãy/xếp/chiết khấu/lộn/gấp|x
抚=phủ/an ủi|x
抛=ném/phao/vứt/quăng|x
抜=bạt|x
抝=ảo|x
护=hộ/bảo hộ|x
报=báo|x
抰=hiệp|x
抵=chống đỡ|x
抶=sất|x
抺=mò|x
押=áp|x
抿=nhấp/chải/mân|x
拂=phật|x
拃=tra|x
拉=kéo/lạp/hướng|x
拏=nã|x
拐=ngoặt/gậy/lừa gạt/quải/nạng|x
拑=kiềm|x
拒=cự|x
拓=thác/mở đất|x
拕=tha|x
拖=kéo/tha|x
拗=cố chấp/ảo/bẻ/khó lay chuyển/đè nén đi/cưỡng|x
拘=câu|x
拙=vụng/kém cỏi|x
拚=vứt/biện|x
招=chiêu/nhận/làm/nhận tội|x
拢=lũng/áp sát|x
拤=tạp|x
括=quát|x
拭=lau|x
拮=kiết|x
拯=chửng|x
拳=quyền|x
拷=khảo|x
拻=khôi|x
拼=liều/hợp lại/ghép|x
持=cầm/trì/nắm|x
挅=đỏa|x
指=chỉ/ngón tay|x
挎=đeo/khoá|x
挐=noa|x
挑=chọn/chống/chọc/khều/thiêu/khiêu/gánh/hất|x
挖=đào/oạt/móc|x
挚=chí|x
挛=luyên|x
挡=cản/ngăn cản/đáng/chặn|x
挢=kiệu|x
挦=triêm|x
挪=chuyển|x
挫=áp chế|x
振=chấn|x
挱=sa|x
挵=phan|x
挶=cục|x
挹=ấp|x
挺=rất/gắng/đĩnh/ủng hộ/cố gắng/khẩu/thẳng|x
挻=đỉnh|x
挼=noa|x
捁=giảo|x
捄=cứu|x
捓=da|x
捘=tuấn|x
捝=thoát|x
损=tổn hại/cay độc|x
换=đổi/thay/hoán/đổi lại/đổi|x
捥=oản|x
捦=cầm|x
据=theo/cư/cứ/căn cứ|x
捯=đào|x
捱=chống cự|x
捴=tổng|x
捵=điến|x
捶=nện/chủy/đấm/nện|x
捷=nhanh/thắng|x
捺=nại|x
捻=vê|x
捽=tốt|x
掆=giang|x
授=thụ/dạy|x
掉=rơi/mất/bỏ/đi|x
掌=chưởng/bàn tay|x
掏=móc/đào/lấy ra|x
排=sắp xếp/hàng/bài/đứng hàng/trung đội|x
掔=kiên|x
掜=nghễ|x
掞=thiểm|x
採=thải|x
探=dò xét/tham/dò/thăm|x
接=tiếp/nhận/nối|x
措=xử chí|x
掫=tưu|x
掯=khẳng|x
掱=vát|x
掳=bắt/cướp|x
掺=trộn lẫn/sảm|x
掼=quăng/quán|x
掽=bánh|x
揃=tiễn|x
揅=nghiên|x
揆=quỹ|x
揑=niết|x
插=cắm/chọc vào/sáp/xuyên vào/trồng/cấy/xuyên|x
揔=tổng|x
揕=chấm|x
揗=tuần|x
揘=hoành|x
揜=yểm|x
揞=yêm|x
揢=khách|x
揦=lạt|x
揫=thu|x
揭=bóc/vạch trần|x
揳=tiết|x
援=viện binh|x
揶=gia|x
揷=sáp|x
揸=tra|x
揹=bội|x
揾=uấn|x
揿=khấm|x
搀=nâng|x
搆=cấu|x
搉=xác|x
搊=xâu|x
搌=triển|x
搏=đọ sức/đập/bác|x
搐=súc|x
搒=bãng|x
搕=khạp|x
搘=chi|x
搜=lục soát/sưu|x
搢=tấn|x
搤=ách|x
搥=chùy|x
搧=thiên|x
搨=tháp|x
搪=đường|x
搯=đào|x
搰=hột|x
搲=oa|x
搵=uấn|x
搾=trá|x
摀=che|x
摄=nhiếp/chụp|x
摇=dao/dao động/rung/lắc|x
摈=bấn|x
摊=bày/quán/than/vuốt/chia đều|x
摏=thung|x
摒=bài trừ gạt bỏ|x
摓=phùng|x
摘=hái/trích|x
摛=si|x
摞=chồng/chồng chất|x
摧=phá vỡ/tồi|x
摩=ma|x
摰=chí|x
摸=sờ/mò/mạc/tìm tòi|x
摺=gấp/bẻ|x
摽=phiếu|x
撃=kích|x
撅=vểnh lên|x
撇=phiết|x
撏=triêm|x
撒=vung/tát/tản/tung ra/xòe ra/xức/làm càn|x
撙=tỗn|x
撝=huy|x
撡=thao|x
撬=nạy ra/khiêu|x
播=truyền bá|x
撮=túm/dúm|x
撰=soạn|x
撴=đôn|x
撵=đuổi/niện/đuổi đi|x
撷=hiệt/ngắt lấy|x
撽=khiếu|x
擀=lau kỹ/giã/cán|x
擅=thiện/tự ý|x
擕=huề|x
擗=bịch|x
擡=nâng/đài|x
擥=lãm|x
擧=cử|x
擩=nhũ|x
擪=áp|x
擭=hoạch|x
擸=liệp|x
擿=trích|x
攀=trèo/víu/phàn|x
攅=toàn|x
攈=quấn|x
攎=bắt/tóm|x
攒=tích lũy/tích góp|x
攞=muốn|x
攟=quấn|x
攧=điên|x
攩=đảng|x
攫=quắp/chiếm|x
攮=nãng|x
支=chi/thứ/nhánh/giữ/cầm|x
攲=khi|x
攴=phộc|x
攵=phác|x
收=thu/nhận/bắt|x
攸=du|x
改=đổi/sửa|x
攻=công|x
政=chính|x
敁=điêm|x
敂=khấu|x
故=cho nên/cố/nguyên nhân|x
敇=sách|x
敌=địch|x
敎=giáo|x
敏=mẫn|x
敔=ngữ|x
敕=sắc|x
敖=ngao|x
教=giáo/dạy/để/bị|x
敛=liễm|x
敢=dám/cảm/tiến lên/bạo dạn/có dũng khí|x
散=tán|x
敦=thật thà|x
敨=thầu|x
敩=hiệu|x
敪=xuyết|x
敬=kính|x
敭=dương|x
数=số/đếm/mấy/sổ/trách mắng/kể/cân nhắc/tỉnh phỏng/luôn luôn/kể ra|x
整=cả/chỉnh/đều/sửa sang/làm|x
敺=khu|x
敻=quýnh|x
斁=dịch|x
斆=hiệu|x
文=văn/đồng|x
斉=tề|x
斌=bân|x
斒=ban|x
料=liệu/liều|x
斜=nghiêng/tà/vẹo|x
斢=điều|x
斤=cân|x
斥=khiển trách/chê/khai thác/xích/đuổi/bác/dò|x
斧=búa|x
斨=thương|x
斩=trảm/chém|x
断=đoạn/nhất định/gãy/đánh gãy/cắt|x
斮=trác|x
斯=tư|x
新=mới/tân|x
斲=trác|x
斳=cần|x
斵=trác|x
斶=xúc|x
方=phương/mới/vuông|x
於=với/sinh/于|x
斿=du|x
旅=lữ/hành trình|x
旋=xoáy|x
族=tộc|x
旑=y|x
旖=y|x
旛=phan|x
旜=chiên|x
旝=quái|x
无=không/vô|x
旡=ký|x
既=đã/vừa/ký/rồi/tức/thì là|x
旤=họa|x
日=ngày/nhật/mặt trời/xxx|x
旦=sáng|x
旧=cũ/cựu|x
旨=chỉ|x
早=sớm/tảo|x
旪=hiệp|x
旬=tuần|x
旭=húc|x
旱=hạn|x
时=lúc/thì/khi/giờ/thời|x
旷=bỏ/khoáng|x
旸=dương|x
旹=thì|x
旺=vượng|x
旻=mân|x
旾=xuân|x
昂=ngang|x
昆=côn|x
昇=thăng|x
昉=phưởng|x
昋=quế|x
昌=xương/hưng thịnh/hưng|x
明=minh/sáng|x
昏=bất tỉnh/hôn/ngất|x
易=dễ/dịch/dễ dàng/đổi|x
昔=tích/xưa kia|x
昙=đàm/đám mây dày|x
昚=thận|x
昜=dương|x
昝=tảm|x
星=tinh/sao|x
春=xuân|x
昨=hôm qua|x
昪=biện|x
昫=hu|x
昬=hôn|x
昭=chiêu|x
昰=thị|x
昳=điệt|x
昵=mật|x
昺=bính|x
昼=ban ngày|x
昽=lông|x
晁=Triều/triều|x
晅=huyên|x
晋=tấn/tiến lên/Tấn|x
晌=thưởng|x
晏=yến|x
晓=hiểu|x
晖=huy|x
晚=muộn/chiều muộn/tối|x
晜=côn|x
晞=hi|x
晢=triết|x
晦=hối|x
晧=hạo|x
晨=thần/sáng sớm|x
晩=vãn|x
晫=trác|x
晬=tối|x
普=phổ|x
晳=tích|x
晴=tình/trời trong xanh|x
晹=dương|x
智=trí|x
晻=yểm|x
晾=phơi/gạt/bỏ|x
暂=tạm|x
暄=huyên|x
暅=hằng|x
暋=mẫn|x
暍=cảm nắng|x
暎=ánh|x
暐=vĩ|x
暑=nóng|x
暗=ám/ngầm/tối/ngu muội/thầm|x
暝=minh|x
暤=hao|x
暧=ái/mờ/tối|x
暨=kỵ|x
暪=gạt|x
暭=hạo|x
暮=mộ/chiều|x
暱=nật|x
暴=bạo|x
暸=khang|x
暼=bánh|x
曀=ê|x
曁=kỵ|x
曈=đồng|x
曌=chiếu|x
曏=hướng|x
曚=mông|x
曜=diệu/ánh sáng|x
曝=bộc|x
曦=hi|x
曨=lông|x
曰=nói/viết/gọi|x
曳=dắt|x
曵=duệ|x
曶=hốt|x
曹=tào|x
曺=tào|x
曼=man/mạn|x
替=thay|x
最=nhất/tối/rất|x
朁=tuy|x
朅=khiết|x
朆=phân|x
月=nguyệt/tháng/trăng|x
朋=bằng/bằng hữu|x
服=phục/dùng/mặc/uống|x
朏=phỉ|x
朒=nục|x
朓=thiểu|x
朔=sóc|x
朗=lãng|x
朘=thuyên|x
望=nhìn/ngắm/vọng/trông chờ/nhìn qua|x
朝=hướng/sớm mai/sớm/triều|x
朞=ki|x
期=kỳ|x
朣=đồng|x
朦=mông|x
木=mộc/gỗ/cây|x
未=chưa/vị/Mùi|x
末=mạt/mọn/không/hết/cuối/mỏng/nhẹ/hẹp/chưa|x
本=vốn/bản|x
札=trát|x
朮=truật|x
术=thuật|x
朱=Chu/chu/đỏ thắm|x
朴=phác|x
朵=đóa|x
朶=đóa|x
机=cơ/máy bay/máy|x
朽=hủ|x
杂=tạp/hỗn tạp/lẫn lộn|x
杆=cán/cái|x
杇=ô|x
杉=sam|x
杏=hạnh|x
材=tài|x
村=thôn|x
杓=tiêu|x
杕=đệ|x
杗=mang|x
杙=dặc|x
杜=đỗ|x
束=buộc/bó/chùm|x
杠=đòn khiêng/gạch|x
条=đầu|x
杧=mang|x
杪=diểu|x
杭=hàng|x
杯=chén/ly/gia/bôi|x
杲=cảo|x
杳=xa ngút ngàn dặm|x
杵=xử/đứng|x
杶=suân|x
杻=nữu|x
松=lỏng/tùng|x
板=tấm/bản/cửa|x
极=cực/vô cùng|x
构=cấu|x
枅=phanh|x
枏=nam|x
枒=nha|x
枓=đấu|x
枕=gối|x
林=lâm/rừng|x
枚=mai/miếng/viên|x
果=quả|x
枝=nhánh/cành|x
枞=tung|x
枫=phong/cây phong|x
枬=nam|x
枭=kiêu|x
枯=khô|x
枰=bình|x
枱=đài|x
枳=chỉ|x
架=đỡ/khung/cái/chiếc/giá/đánh/trận|x
枹=phu|x
柄=chuôi/thanh|x
柈=bàn|x
柊=Hiiragi|x
柎=phu|x
柏=bách|x
柑=cam|x
染=nhiễm/nhuộm|x
柔=nhu|x
柘=chá|x
柙=cũi/hiệp|x
柚=dữu|x
柜=tủ|x
柝=thác|x
柞=tạc|x
柟=nam|x
柠=nắm|x
柨=thị|x
柩=quan tài|x
柬=giản|x
柮=đốt|x
柯=kha|x
柴=củi/sài|x
柽=sinh|x
柿=thị|x
栀=chi|x
栄=vinh|x
栅=rào/hàng rào|x
标=tiêu/đánh dấu/ngọn/nhãn hiệu|x
栈=sạn|x
栋=tòa/tòa nhà/đống/nóc|x
树=cây/thụ/dựng|x
栒=tuân|x
栓=chốt/cái chốt|x
栖=dừng/tê|x
栗=lật|x
栘=di|x
栝=quát|x
栞=san|x
栟=kiên|x
校=trường học/hiệu/giáo|x
栢=bách|x
栨=thứ|x
株=gốc/gốc cây|x
栴=chiên|x
核=hạch|x
根=cây/rễ/căn/rễ : cái|x
栻=thức|x
格=cách/nghiên cứu/ô vuông/ô|x
栽=cắm/trồng|x
栾=loan|x
栿=phục|x
桀=kiệt/khặc|x
桁=hành|x
桂=quế|x
桃=đào|x
桅=cột buồm|x
框=khung|x
桌=bàn/trác|x
桐=đồng|x
桑=tang/cây dâu|x
桓=hoàn|x
桔=kết|x
桕=cữu|x
桖=mộc huyết|x
桚=tạt|x
档=ngăn/hồ sơ/đương/cấp/bậc|x
桦=hoa|x
桧=cối|x
桩=cọc/cái cọc|x
桫=sa|x
桬=sa|x
桮=bôi|x
桯=thỉnh|x
桰=quát|x
桶=thùng/dũng|x
桹=lang|x
桼=tất|x
梁=lương/xà nhà/dầm|x
梅=mai|x
梆=bang/mõ|x
梓=tử/Azusa|x
梧=ngô|x
梭=toa/con thoi|x
梮=cục|x
梯=bậc thang/thê/cái thang/trèo|x
梱=khổn|x
梹=tân|x
梼=đào|x
梽=chí|x
梾=lai|x
梿=liên|x
检=kiểm|x
棃=lê|x
棉=bông vải/bông|x
棊=kỳ|x
棍=côn|x
棑=bài|x
棒=bổng/tốt/gậy/ca tụng/tuyệt|x
棓=bang|x
棔=hôn|x
棕=tông/nâu|x
棘=cức|x
棠=đường|x
棣=lệ|x
棨=khể|x
棪=diễm|x
森=sâm/dày đặc|x
棱=lăng/đỏ quạch (tỏ ý chán ghét)/cạnh|x
棹=trạo|x
棺=quan tài/hòm quan tài|x
棻=phân|x
棼=phần|x
椀=oản|x
椅=ghế dựa/ghế/ghế tựa|x
椇=củ|x
椉=thừa|x
植=thực|x
椑=ti|x
椗=đính|x
椟=độc|x
椥=tri|x
椪=bàng|x
椰=dừa/gia|x
椳=ôi|x
椸=di|x
椽=chuyên|x
椾=tiên|x
椿=xuân|x
楄=biên|x
楔=tiết|x
楙=mậu|x
楚=sở|x
楛=hộ|x
楞=lăng|x
楠=nam|x
楡=du|x
楥=huyên|x
楩=tiện|x
楬=kiệt|x
楮=chử|x
楯=thuẫn|x
楳=kỳ|x
楷=giai|x
榀=phẩm|x
概=khái|x
榃=đàm|x
榅=ốt|x
榆=du|x
榉=cử|x
榊=Sakaki|x
榎=giá|x
榕=dung|x
榖=cốc|x
榘=củ|x
榛=trăn|x
榤=kiệt|x
榥=hoảng|x
榦=cán|x
榧=phỉ|x
榨=ép|x
榰=chi|x
榲=ốt|x
榴=lưu|x
榾=cốt|x
槀=cảo|x
槃=bàn|x
槅=cách|x
槐=hòe|x
槑=mai|x
槓=cống|x
様=dạng|x
槚=giả|x
槛=hạm|x
槠=chử|x
槡=tang|x
槩=khái|x
槭=túc|x
槹=cao|x
槺=khang|x
槼=quy|x
樀=đích|x
樊=phiền|x
樑=lương|x
樝=tra|x
樟=cây nhãn|x
樠=man|x
模=mô hình/khuông/mô hình (khuôn đúc)|x
樤=đầu|x
横=hoành|x
樱=anh|x
樲=nhị|x
樵=tiều|x
樷=tùng|x
橊=lưu|x
橎=fǎn|x
橑=liêu|x
橕=xanh|x
橙=cam/quả cam/chanh/ghế|x
橚=thu|x
橞=cây gỗ|x
橦=đồng|x
橱=thụ|x
檀=đàn|x
檃=ổn|x
檄=hịch|x
檇=tuy|x
檑=lôi|x
檗=cây hoàng bá|x
檛=qua|x
檝=tiếp|x
檟=giả|x
檠=kềnh/kình|x
檥=nghĩ|x
檩=đòn tay|x
檵=kỷ|x
檿=yểm|x
櫂=trạo|x
櫆=khôi|x
櫉=trù|x
櫫=trư|x
櫱=nghiệt|x
櫺=linh|x
欉=tùng|x
欙=luy|x
欛=bá|x
次=lần/thứ|x
欢=hoan/vui mừng|x
欣=hân/vui mừng|x
欧=âu|x
欬=khái|x
欲=muốn/dục|x
欵=khoản|x
欸=ai|x
欹=y|x
欺=lấn/ức hiếp/bắt nạt|x
欻=hốt|x
款=khoản/kiểu|x
歃=sáp|x
歅=nhân|x
歈=du|x
歉=xin lỗi|x
歌=ca/bài hát|x
歔=hư|x
歕=phun|x
歗=khiếu|x
歙=hấp|x
歛=liễm|x
歠=xuyết|x
止=dừng/dừng lại|x
正=chính/đang/dương/thẳng|x
此=này/thử/ấy/bèn/đây|x
步=bước/bộ|x
武=võ/vũ|x
歧=kỳ|x
歩=bước|x
歬=tiền|x
歯=xỉ|x
歱=chủng|x
歴=lịch|x
歹=xấu/ác quỷ|x
死=chết/tử|x
歼=diệt|x
殀=yểu|x
殁=một|x
殃=ương/hại|x
殆=đãi|x
殉=tuẫn|x
殊=thù/khác biệt/đặc biệt|x
残=tàn|x
殖=thực|x
殚=đàn|x
殡=tấn|x
殢=thế|x
殣=cận|x
殭=cương|x
殰=độc|x
殱=tiêm|x
殳=thù|x
殴=ẩu|x
段=đoạn|x
殷=ân|x
殽=hào|x
殿=điện|x
毅=nghị/kiên quyết|x
毈=đoạn|x
毋=vô|x
母=mẫu/mẹ/cái|x
每=mỗi/thường/từng/mỗi khi/mỗi lần|x
毐=ải|x
毒=độc|x
毓=dục|x
比=so/bỉ/so với|x
毕=tất|x
毗=tì|x
毘=bì|x
毚=sàm|x
毛=lông/mao/cọng lông|x
毡=chiên|x
毧=nhung|x
毨=tiển|x
毫=hào/chút nào|x
毬=cầu|x
毯=thảm/tấm thảm|x
毰=bồi|x
毷=máo|x
毸=tai|x
氂=ly|x
氉=táo|x
氏=thị|x
民=dân|x
気=khí|x
氙=tiên|x
氟=phất|x
氠=tiên|x
氧=dưỡng/oxi|x
氰=tình|x
氵=thủy|x
氷=băng|x
永=vĩnh/vĩnh viễn/lâu dài|x
氽=thỗn|x
氾=giàn giụa|x
氿=cửu|x
汀=đinh/bãi bồi|x
汁=nước/nhựa|x
汇=chuyển/hợp thành/|x
汈=điêu|x
汉=hán|x
汏=đại|x
汕=sán|x
汗=mồ hôi/hãn/đổ mồ hôi|x
汚=ô|x
汛=tấn|x
汜=tỷ|x
汝=nhữ/mày|x
江=sông/giang|x
池=hồ/ao/trì|x
污=ô|x
汤=canh/thang/súp|x
汦=chi|x
汧=khiên|x
汨=mịch|x
汪=uông/gâu|x
汭=nhuế|x
汲=cấp|x
汴=biện|x
汶=vấn/Vấn|x
汹=hung|x
汾=phần|x
沁=thấm|x
沂=nghi|x
沃=ốc|x
沄=vân|x
沅=nguyên|x
沆=hàng|x
沇=duyện|x
沈=thẩm/trầm|x
沉=chìm/nặng/trầm/lặn|x
沐=mộc|x
沓=xấp/xấp (liên tục)|x
沔=miện|x
沕=vật|x
沖=trùng/vọt|x
沙=cát/sa|x
沚=chỉ|x
沛=bái|x
沟=câu/kênh mương/rãnh mương|x
没=không có/ngập/chìm/chưa/mất|x
沢=trạch|x
沣=phong|x
沥=lịch|x
沦=luân|x
沧=thương|x
沨=phong|x
沬=muội|x
沭=thuật|x
沮=tự|x
河=sông/hà|x
沵=nhĩ|x
沷=tẩy rửa sạch sẽ|x
沸=sôi|x
沼=chiểu|x
沾=dính|x
沿=xuôi theo/duyên/ven/bờ/mép/dọc theo|x
泂=huýnh|x
泃=cù|x
泄=tiết|x
泆=dật|x
泉=suối/tuyền/Izumi|x
泊=đỗ|x
泌=bí|x
泗=tứ|x
泚=thử|x
泜=trì|x
泝=tố|x
泠=linh|x
泡=ngâm/cua/phao/bọt/pha/ngâm nước|x
波=sóng/đợt/làn/ba/|x
泣=khóc|x
泥=bùn/nê|x
泪=nước mắt|x
泫=huyền|x
泮=phán|x
泰=thái|x
泱=ương|x
泳=lặn|x
泵=bơm/cô/tuyền|x
泶=hạc|x
泷=lang|x
泸=lô|x
泺=lạc|x
泻=tả/cuồn cuộn/chảy nước|x
泼=giội|x
泽=trạch|x
泾=kính|x
洁=khiết|x
洄=hồi|x
洊=tiến|x
洋=dương|x
洐=hành/diễn|x
洑=phục|x
洒=vẩy/rơi vãi/sái/tẩy/chót vót/tung|x
洚=giáng|x
洛=Lạc|x
洟=di|x
洢=y|x
津=tân|x
洨=hào|x
洪=Hồng|x
洭=khuông|x
洲=châu|x
洴=bình|x
洸=quang|x
洺=minh|x
活=sống/công việc/hoạt|x
洼=oa|x
洽=hiệp|x
洿=ô|x
流=lưu/chảy|x
浅=cạn/nhạt/nông/thiển|x
浆=tương|x
浉=sư|x
浊=trọc/đục/bẩn|x
测=đo/trắc|x
济=tế|x
浐=sản|x
浑=đục/mơ hồ/hồ đồ/thô/tự nhiên|x
浒=hử|x
浓=nồng/đậm đặc/nùng/đặc/dày|x
浔=tầm|x
浕=tận|x
浙=Chiết|x
浚=tuấn/đào sâu|x
浛=hàm|x
浜=banh|x
浡=nổi lên|x
浥=ấp|x
浦=phổ|x
浨=nước cốt lê|x
浩=hạo|x
浪=sóng/lãng|x
浬=lý|x
浭=canh|x
浮=phù/lơ lửng/di động|x
浰=lợi|x
浴=tắm|x
海=biển/hải|x
浻=quýnh|x
浼=mỗi|x
浿=phối|x
涂=bôi/đồ|x
涅=niết|x
消=tiêu/tiêu tan|x
涉=liên quan/trải qua/vượt|x
涊=niễn|x
涎=nước bọt/nước miếng|x
涐=nga|x
涒=thôn|x
涓=suối/chọn|x
涕=nước mắt|x
涖=lỵ|x
涛=đào/sóng/sóng lớn/|x
涝=úng lụt|x
涟=liên/sóng gợn|x
涢=vân|x
涤=địch|x
润=nhuận|x
涨=trướng/phồng|x
涮=xuyến/rửa|x
液=dịch|x
涴=ngâm|x
涵=hàm|x
涸=cạn/hạc|x
涽=hôn|x
涿=trác|x
淀=điến/lắng đọng|x
淅=tích|x
淆=hào|x
淋=xối|x
淏=hạo|x
淑=thục|x
淛=chiết|x
淡=nhạt/đạm|x
淢=vực|x
淤=ứ/ứ đọng|x
淦=cam|x
淩=lăng|x
淬=tôi/ngâm|x
淮=Hoài/hoài|x
淯=dục|x
深=sâu|x
淳=thuần|x
淴=hốt|x
混=hỗn/lăn lộn/trộn lẫn/lăn lộn|x
添=thêm/thiêm|x
淼=miểu|x
淽=nhị|x
清=thanh/trong/rõ ràng/sạch|x
渊=uyên|x
渎=khinh|x
渑=thằng|x
渔=cá|x
渖=thẩm|x
渚=chử|x
渟=đình|x
渡=độ/chở/sang|x
渣=cặn bã/tra/mẩu vụn/mảnh vụn|x
渤=Bột Hải|x
渥=ướt át|x
温=ấm/ôn/hâm nóng|x
渮=ca|x
港=cảng|x
渲=tuyển|x
渴=khát|x
游=du lịch/bơi/du|x
渺=miểu/mịt mù|x
渻=tỉnh|x
渼=mỹ|x
湄=mi|x
湅=luyện|x
湉=điềm|x
湌=xan|x
湍=thoan|x
湏=tu|x
湖=hồ|x
湘=Tương|x
湛=trạm|x
湜=thực|x
湝=giai|x
湟=hoàng|x
湢=bức|x
湣=mẫn|x
湨=cừ|x
湮=yên/nhân|x
湲=viên|x
湳=nươm|x
湼=niết|x
湾=vịnh|x
湿=ẩm ướt/thấp/ướt|x
溃=bại|x
溇=lâu|x
源=nguyên|x
溘=khạp|x
溚=tháp|x
溠=trá|x
溢=tràn/tràn đầy/dật|x
溥=phổ|x
溪=suối|x
溯=ngược dòng/tố|x
溲=sửu|x
溵=ân|x
溶=tan/dung|x
溷=hỗn|x
溺=chìm/nịch|x
溻=thạp|x
溼=ẩm ướt|x
滀=súc|x
滃=ổng|x
滆=cách|x
滈=hao|x
滉=hoảng|x
滍=trĩ|x
滑=trượt/trợt/trơn trượt|x
滔=thao/đào/thao thao/mênh mông/đầy rẫy/cuồn cuộn|x
滕=đằng|x
滙=hối|x
滚=lăn/cút/cổn/chảy cuồn cuộn/sôi/lặn đi|x
滛=dâm|x
滞=trệ|x
满=đầy|x
滤=lọc|x
滥=lạm|x
滨=tân|x
滩=bãi/ghềnh/than/thác|x
滫=tưu|x
滮=bưu|x
滴=giọt/nhỏ/tích/tích|x
漂=phiêu/trôi/nổi/thổi|x
漆=sơn/nước sơn|x
漈=tế|x
漊=lâu|x
漍=quốc|x
漏=để lọt/lỗ hổng/rò/lậu|x
漓=li|x
演=diễn|x
漕=tào|x
漖=giáo|x
漘=thần|x
漙=đoàn|x
漠=mạc|x
漥=oa|x
漦=ly|x
漧=can|x
漪=gợn|x
漫=khắp/mạn/tràn đầy/ướt sũng|x
漰=bằng|x
漳=chương|x
漵=tự|x
漷=quách|x
漻=liêu/liệu|x
漾=dạng|x
潄=sấu|x
潇=tiêu|x
潋=liễm|x
潏=quyết|x
潖=bà|x
潗=tập|x
潘=phan|x
潙=vi|x
潜=lẻn/lặn/tiềm|x
潞=lộ|x
潟=tích|x
潢=hoàng|x
潨=tùng|x
潩=dị|x
潬=đống cát ngâm nước|x
潮=triều|x
潲=sảo|x
潵=tán|x
潼=đồng|x
潽=phô|x
潾=lân|x
澁=sáp|x
澂=trừng|x
澄=trừng/trong vắt|x
澎=bành|x
澒=hống|x
澔=hạo|x
澕=hô|x
澘=san|x
澜=lan|x
澡=tắm|x
澣=cán|x
澥=hải|x
澦=dự|x
澧=lễ|x
澨=phệ|x
澪=Mio|x
澳=úc|x
澴=hoàn|x
澹=đạm|x
激=kích|x
濇=sắc|x
濊=uế|x
濒=tần|x
濡=nhu|x
濩=hoạch|x
濬=tuấn|x
濮=bộc|x
濲=cốc|x
瀁=dưỡng|x
瀌=phiêu|x
瀍=triền|x
瀑=thác nước|x
瀚=hãn|x
瀛=doanh|x
瀡=tủy|x
瀣=dới|x
瀦=trư|x
瀺=sàm|x
瀼=nhương|x
瀽=kiển|x
灉=ung|x
灊=tiềm|x
灋=pháp|x
灌=rót|x
灧=liễm|x
灨=cám|x
灩=diễm|x
火=lửa/hỏa|x
灬=hỏa|x
灰=tro/xám/bụi/hôi|x
灺=tã|x
灼=đốt/sáng tỏ/lửa đốt sáng/chước|x
灿=rực rỡ|x
炀=dương|x
炁=khí|x
炆=văn|x
炉=lô/lò/bếp|x
炊=nấu/xuy|x
炘=hân|x
炙=thiêu đốt|x
炜=vĩ|x
炟=đát|x
炤=chiếu|x
炧=đả|x
炫=huyễn|x
炮=pháo|x
炯=long lanh|x
炰=bào|x
炱=đài|x
炳=bính|x
炸=nổ/tạc/bùng nổ|x
点=điểm/giờ/chút/gật|x
炽=rực|x
烁=nhấp nháy|x
烂=nát/thối rữa/lạn/nát vụn|x
烈=liệt/cháy mạnh/ác/mạnh|x
烔=đồng|x
烕=diệt|x
烖=tai|x
烘=sấy khô/hồng|x
烙=in dấu/nướng|x
烛=nến/đèn cầy|x
烜=huyên|x
烝=chưng|x
烤=nướng/khảo/sấy/quay/nướng/sấy|x
烦=phiền|x
烧=đốt/sốt/thiêu/nướng/xào/cháy/nấu|x
烨=diệp|x
烩=xào/quái/chưng|x
热=nóng/nhiệt/nhiệt nóng|x
烺=lãng|x
烽=phong|x
焂=thúc|x
焄=hôn|x
焉=chỗ này/chỗ nào/yên|x
焌=tuấn|x
焕=hoán|x
焗=hấp|x
焘=đảo|x
焚=đốt|x
焜=hỗn|x
焠=thối|x
焦=tiêu/cháy/sốt ruột/cháy sém/lo lắng|x
焰=diễm|x
然=nhưng/không sai/nhiên|x
煆=hạ|x
煊=huyên|x
煌=hoàng|x
煏=phức|x
煐=anh|x
煑=chử|x
煓=sủy|x
煕=hi|x
煖=noãn|x
煜=dục|x
煞=sát|x
煠=sáp|x
煣=nhu|x
煦=húc/húc|x
照=chiếu/so sánh/noi theo/theo|x
煲=nấu/nồi|x
煸=kích|x
煼=sao|x
熀=sáng|x
熅=huân|x
熊=gấu/hùng|x
熏=hun|x
熔=dung/nấu chảy|x
熙=hi/rộn ràng|x
熛=tiêu|x
熜=thông|x
熟=quen/chín/thục/thục (quen thuộc)|x
熠=dập|x
熨=ủi|x
熲=quýnh|x
熹=hi|x
熻=dục|x
熿=hoàng|x
燃=đốt|x
燄=diễm|x
燊=thân|x
燋=tiêu|x
燎=cháy/liệu|x
燏=duật|x
燐=lân|x
燕=yến|x
燖=tầm|x
燚=diệc|x
燥=khô/táo|x
燬=hủy|x
燻=huân|x
燿=diệu|x
爇=nhiệt|x
爓=diễm|x
爗=diệp|x
爚=dược|x
爥=chúc|x
爨=thoán|x
爪=trảo/móng|x
爫=trảo|x
爮=bào|x
爱=yêu/ái/thích/tình yêu|x
爲=vì/vi|x
爵=tước/cốc ba chân|x
父=cha/phụ|x
爷=gia|x
爻=hào|x
爽=thoải mái/sảng khoái|x
牀=sàng|x
牁=ca|x
片=phiến/mảnh|x
牍=độc|x
牏=du|x
牐=sáp|x
牓=bảng|x
牕=song|x
牖=dũ|x
牗=dũ|x
牚=xanh|x
牛=trâu/ngưu/bò|x
牟=mưu|x
牠=nó|x
牡=mẫu|x
牢=lao/bền vững/nhà tù/tù|x
牣=nhận|x
牤=trâu đực|x
牧=mục|x
物=vật|x
牲=sinh|x
牴=để|x
牸=tự|x
特=đặc biệt/đặc/đặc (biệt)/rất|x
牻=mang|x
牼=khanh|x
犀=tê|x
犁=cày/lê|x
犇=bôn|x
犍=kiền|x
犎=phong|x
犒=khao|x
犨=trừu|x
犬=khuyển/chó|x
犭=khuyển|x
犰=con ta tu|x
犳=trước|x
状=trạng/hình dáng|x
犹=còn/vẫn còn|x
犼=hống/Hống|x
狂=cuồng/điên cuồng|x
狄=địch|x
狉=phi|x
狌=tính|x
狎=suồng sã/cặp kè/hiệp|x
狐=hồ/cáo|x
狙=thư|x
狚=đán|x
狝=tiển|x
狞=dữ tợn|x
狠=hung ác/ngoan/ngận/tàn nhẫn|x
狡=giảo hoạt|x
狨=nhung|x
狩=săn/thú|x
独=độc|x
狭=hẹp|x
狯=quái|x
狰=tranh|x
狱=ngục|x
狴=bệ|x
狸=ly/báo|x
狼=sói/lang|x
猀=khuyển|x
猂=hãn|x
猄=kình|x
猇=hao|x
猋=tiêu|x
猎=săn/liệp|x
猓=quả|x
猕=mi|x
猗=y|x
猛=mãnh/mãnh liệt|x
猜=đoán/sai/ngờ|x
猝=bất ngờ|x
猡=lợn|x
猥=hèn|x
猧=oa|x
猩=tinh|x
猫=mèo/miêu|x
猭=duyên|x
猰=áp|x
猴=khỉ/hầu|x
猷=du|x
猸=mi|x
猹=tra|x
猾=hoạt|x
猿=vượn|x
獀=sưu|x
獁=mã|x
獃=ngai|x
獉=trăn|x
獐=hoẵng|x
獕=thôi|x
獘=tệ|x
獚=hoàng|x
獞=đồng|x
獢=kiêu|x
獦=cát|x
獴=mông|x
玁=hiểm|x
玈=lô|x
玉=ngọc|x
王=vương/vua|x
玎=đinh|x
玏=lặc|x
玓=đích|x
玕=can|x
玙=dư|x
玚=sướng|x
玛=mã|x
玞=phu|x
玟=mân|x
玠=giới|x
玥=nguyệt|x
玦=quyết|x
玩=chơi/đùa/ngoạn|x
玭=tần|x
玮=vĩ|x
环=vòng/hoàn|x
现=hiện/xuất hiện|x
玱=thương|x
玲=linh|x
玷=điếm/làm bẩn|x
玻=kính|x
珀=phách|x
珂=kha|x
珅=thân|x
珉=mân|x
珊=san|x
珌=tất|x
珍=trân|x
珓=giao|x
珖=quang|x
珝=hủ/hứa|x
珞=lạc|x
珠=châu|x
珣=tuần|x
珥=nhị|x
珩=hành|x
珪=khuê|x
班=ban/lớp|x
珮=bội|x
珰=đang|x
珲=hồn|x
珽=đĩnh|x
琀=hàm|x
琁=tuyền|x
琅=lang|x
理=lý/để ý|x
琇=tú|x
琉=lưu|x
琍=lợi|x
琎=tấn|x
琐=tỏa|x
琖=trản|x
琚=cư|x
琤=tranh|x
琥=hổ|x
琦=kỳ|x
琪=kỳ|x
琫=bổng|x
琯=quản|x
琱=điêu|x
琲=bội|x
琳=lâm|x
琶=bà|x
琹=cầm|x
琼=quỳnh|x
瑀=vũ|x
瑄=tuyên|x
瑇=đại|x
瑊=giam|x
瑑=triện|x
瑒=sướng|x
瑕=hà|x
瑙=não|x
瑜=du|x
瑞=thụy|x
瑟=sắt|x
瑢=dung|x
瑨=tấn|x
瑫=tào/đá đẹp|x
瑰=côi/hồn/hồn|x
瑱=thiến|x
瑳=tha|x
瑴=giác|x
瑶=dao/ngọc|x
瑽=xung|x
瑾=cẩn|x
璅=tỏa|x
璆=cầu|x
璈=ngao|x
璐=lộ|x
璘=lân|x
璙=liệu|x
璚=quỳnh|x
璜=hoàng|x
璞=phác|x
璠=phan|x
璢=lưu|x
璧=bích|x
璩=cừ|x
璫=đang|x
璵=dư|x
璺=vấn|x
璿=tuyền|x
瓀=nhuyên|x
瓅=lịch|x
瓆=khóe miệng|x
瓈=lê|x
瓌=khôi|x
瓒=toản|x
瓖=tương|x
瓘=quán|x
瓛=hiến|x
瓜=dưa/qua|x
瓝=dưa nhỏ|x
瓞=điệt|x
瓠=hồ|x
瓢=bầu/hồ lô|x
瓣=cánh/múi/biện/cánh hoa|x
瓤=nhương|x
瓦=ngói/miếng ngói/watt|x
瓩=thiên|x
瓮=vò/vò gốm/hủ|x
瓯=âu|x
瓷=sứ|x
瓻=hi|x
甀=trụy|x
甁=bình|x
甃=trứu|x
甄=chân|x
甆=từ|x
甇=anh|x
甑=nồi đất|x
甒=vũ|x
甔=đam|x
甖=anh|x
甗=nghiễn|x
甘=cam/ngọt|x
甚=rất/cái gì/quá mức/rất : gì|x
甜=ngọt/điềm|x
生=sinh/sống/|x
甡=sân|x
産=sản|x
甦=tô|x
用=dùng/dụng/cần|x
甪=lục|x
甬=dũng|x
甭=khỏi phải/khỏi|x
甮=phụng|x
甯=nịnh|x
田=ruộng/điền|x
由=từ/do/tùy/bởi|x
甲=giáp/A|x
男=nam|x
甸=điện|x
町=đinh|x
画=họa/vẽ/bức tranh/họa (vẽ)/tranh|x
甿=manh|x
畂=điền|x
畅=sướng|x
畇=vận|x
畊=canh|x
畋=điền|x
畏=sợ|x
畑=điền|x
畜=súc|x
畞=mẫu|x
畠=điền|x
畣=đáp|x
畤=chỉ|x
略=hơi/sơ lược/lược|x
畦=huề|x
畧=lược|x
畨=phiên|x
番=phiên/lần|x
畬=dư|x
畮=mẫu|x
畱=lưu|x
畸=cơ/ki|x
畺=cương|x
畿=kỳ|x
疄=lân|x
疆=cương|x
疍=đản|x
疏=sơ|x
疑=nghi|x
疒=nạch|x
疓=đinh|x
疗=liệu|x
疘=giang|x
疝=sán|x
疢=sấn|x
疧=kỳ|x
疫=dịch|x
疯=điên|x
疲=mệt/mỏi mệt|x
疹=chẩn|x
疼=đau/thương yêu/đông|x
疾=tật/nhanh|x
疿=phi|x
痁=thiêm|x
痃=hiền|x
病=bệnh|x
症=chứng|x
痎=giai|x
痕=ngấn/vết|x
痗=mội|x
痘=đậu|x
痛=đau nhức/đau/thương|x
痟=tiêu|x
痠=toan|x
痡=phô|x
痧=sa|x
痩=gầy|x
痯=quản|x
痲=ma|x
痳=lâm|x
痴=si|x
痾=a|x
痿=liệt/nuy|x
瘆=hãi|x
瘈=khế|x
瘉=dũ|x
瘊=hầu|x
瘌=lạt|x
瘖=âm|x
瘙=tao|x
瘜=tức|x
瘝=quan|x
瘟=ôn|x
瘠=tích|x
瘤=lựu|x
瘦=gầy/sấu|x
瘨=điên|x
瘭=tiếu|x
瘯=thốc|x
瘲=túng|x
瘳=sưu|x
瘸=què/cà nhắc|x
瘻=lũ|x
癃=lung|x
癅=lựu|x
癈=phết|x
癌=ung thư|x
癒=dũ/khỏi ốm/lành bệnh|x
癖=đam mê/thích|x
癗=lũy|x
癙=thử|x
癧=lịch|x
癫=điên|x
癶=bát|x
癸=quý|x
登=trèo lên/đăng|x
白=trắng/bạch/phí công|x
百=trăm/bách|x
皁=tạo|x
皂=tạo|x
皇=hoàng/Hoàng|x
皎=sáng/kiểu|x
皐=cao|x
皓=sáng/trắng bóc|x
皕=bức|x
皖=Hoàn|x
皜=hạo|x
皝=hoàng|x
皞=hạo|x
皡=hạo|x
皩=hoàng|x
皪=lịch|x
皭=tước|x
皱=nhăn/mặt nhăn/cau|x
皴=thuân|x
皻=cha|x
皼=cổ|x
盃=cúp|x
盅=chung|x
盆=bồn|x
盇=hạp|x
盈=doanh/đầy đủ|x
益=ích|x
盋=chén bát|x
盌=oản|x
监=giám/giam|x
盒=hộp|x
盖=đóng/che/đắp/nắp|x
盗=cướp/trộm/đạo|x
盘=bàn/cuộn/mâm|x
盛=thịnh/đựng|x
盟=minh|x
盦=am|x
盨=sử|x
盩=chu|x
盪=đãng|x
盭=lệ|x
目=mắt/mục/con mắt|x
盲=mù/đui mù|x
直=thẳng|x
相=tướng/cùng nhau/lẫn nhau/tương|x
盹=chợp mắt/ngủ gật|x
盻=hễ|x
盼=trông mong/phán|x
盾=thuẫn/lá chắn|x
眀=sáng|x
眉=lông mày|x
眊=mạo|x
眙=dị|x
眛=muội|x
眞=chân|x
真=thật/thực/chân|x
眡=thị|x
眨=nháy/trát/nháy mắt|x
眩=huyễn|x
眬=lung|x
眭=khôi|x
眱=di|x
眴=thuấn|x
眷=quyến|x
眸=mắt/con mắt/mâu/con ngươi mắt|x
眺=ngắm/nhìn|x
眼=mắt/nhãn|x
眽=mạch|x
着=lấy/mắng|x
睅=hạn|x
睆=hoản|x
睊=quyến|x
睋=nga|x
睎=hi|x
睒=thiểm|x
睕=loan|x
睖=lăng|x
睚=nhai|x
睛=con ngươi|x
睟=túy|x
睢=tuy|x
督=đốc|x
睥=liếc/bễ|x
睩=lục|x
睪=dịch|x
睹=thấy/đổ/thấy|x
睺=hầu|x
睿=duệ|x
瞄=ngắm/miểu|x
瞆=quý|x
瞇=mị|x
瞋=sân|x
瞎=mù/mò mẫm|x
瞑=minh|x
瞖=ế|x
瞙=mạc|x
瞠=trợn/xanh|x
瞤=giật|x
瞥=liếc/lườm/miết/liếc về|x
瞩=chúc|x
瞫=thẩm|x
瞬=giây lát/trong nháy mắt|x
瞳=đồng/đồng tử|x
瞷=gián|x
瞻=xem|x
瞾=chiếu|x
瞿=cù|x
矉=tần|x
矐=hoắc|x
矑=lô|x
矛=mâu|x
矜=căng|x
矝=lâm|x
矞=duật|x
矟=sáo|x
矢=mũi tên/tiễn|x
矣=vậy/rồi|x
知=biết/tri|x
矦=hầu|x
矧=thẩn|x
矩=cự/củ|x
矫=kiểu|x
短=ngắn/đoản|x
矮=thấp/ải/lùn|x
矱=hoạch|x
石=thạch/đá|x
矻=khốt|x
矽=tịch|x
矾=phèn|x
码=mã/ngựa/yard/con ngựa/gõ|x
砄=quyết|x
砆=phu|x
砌=xây/thế|x
砒=tỳ|x
研=nghiên|x
砗=xa|x
砚=nghiễn/nghiên mực|x
砟=cứng|x
砢=kha|x
砥=chỉ|x
砧=châm|x
砩=phất|x
砭=biêm|x
砲=pháo|x
砳=lặc|x
砵=Đồng Bát|x
砺=lệ|x
砾=đá sỏi|x
硁=khanh|x
硄=quang|x
硅=silic|x
硏=nghiên|x
硕=to lớn|x
硙=ngại|x
硚=kiều|x
硜=khanh|x
硠=lang|x
硬=cứng rắn/cứng rắn (ngạnh)|x
确=xác thực|x
硷=dảm|x
硾=trọng|x
碁=kỳ|x
碌=lục|x
碍=ngại|x
碎=nát/toái/vỡ/bể/nát tan|x
碏=thước|x
碔=vũ|x
碗=bát/chén/oản|x
碞=nham|x
碟=đĩa/cái đĩa/điệp|x
碡=độc|x
碣=kiệt|x
碦=tháp|x
碧=bích|x
碪=châm|x
碫=đoạn|x
碱=tẩy rửa|x
碳=than/cacbon|x
碴=cặn bã/tra/gây sự|x
碹=toàn|x
碾=ép/nghiền|x
磁=từ|x
磅=bang/pound|x
磈=ủy|x
磉=tảng|x
磊=lỗi/chồng chất|x
磋=tha|x
磏=liêm|x
磐=bàn|x
磑=ngại|x
磗=chuyên|x
磜=thế|x
磟=lưu|x
磠=lỗ|x
磡=xử|x
磨=mài/ma|x
磳=zeng|x
磺=hoàng|x
磻=Bàn Khê|x
磾=đê|x
礃=chưởng|x
礆=dảm|x
礌=lôi|x
礜=dự|x
礟=pháo|x
礡=bạc|x
礧=lôi|x
礨=lỗi|x
礩=chí|x
礳=ma|x
礵=sương|x
礶=quán|x
礹=nham|x
示=bày ra|x
礻=thị|x
礽=nhưng/Nhưng|x
礿=dược|x
祁=kỳ/Kỳ|x
祂=Thần/hắn|x
祄=Tạ|x
祅=yêu|x
祇=kỳ|x
祈=cầu/kỳ/|x
祎=y|x
祏=thạch|x
祐=hữu/Hữu|x
祔=phụ|x
祕=bí|x
祖=tổ|x
祘=toán|x
祛=khử/trừ bỏ|x
祝=chúc|x
祠=từ|x
祢=nễ/họ Nễ|x
祥=tường/Tường|x
祫=hợp|x
祭=tế|x
祴=cai|x
祷=đảo/cầu khẩn|x
祼=quán|x
祾=lăng|x
禁=cấm|x
禂=đảo|x
禄=lộc/Lộc|x
禅=thiền|x
禆=khán|x
禇=chử|x
福=phúc|x
禓=thương|x
禔=đề/Đề|x
禕=y|x
禖=môi|x
禘=đế|x
禚=chước|x
禛=chân/Chân|x
禟=Đường|x
禡=mã|x
禤=huyên/Huyên|x
禨=ky|x
禩=tự/Tự|x
禫=đạm|x
禴=dược|x
禸=nhựu|x
禹=vũ|x
禽=chim/cầm|x
禾=mạ/lúa|x
秀=tú/thanh tú|x
私=tư|x
秃=trọc/hói/ngốc|x
秉=nắm/bỉnh|x
秋=thu/thời kì|x
种=loại/trồng/chủng/gan/giống|x
秏=hạo|x
科=khoa|x
秒=giây/miểu|x
秔=canh|x
秖=kỳ|x
租=thuê/tô/cho thuê/mướn|x
秦=tần|x
秧=ương|x
秩=trật|x
秬=cự|x
秭=tỷ|x
积=tích|x
移=dời|x
秽=uế|x
秾=nùng|x
稀=hiếm|x
稊=đề|x
程=trình|x
稍=hơi/sảo/chút|x
稑=lục|x
稔=nhẫm|x
稙=trắc|x
稚=trẻ con/trĩ|x
稜=oai hùng|x
稨=biển|x
稬=nhu|x
稭=giai|x
稳=ổn|x
稹=chẩn|x
稻=cây lúa|x
稼=trồng trọt|x
稽=kê|x
稾=cảo|x
稿=bản thảo|x
穄=tế|x
穅=khang|x
穆=mục|x
穇=sam|x
穈=môn|x
穗=tuệ|x
穜=chủng|x
穟=tuỵ|x
穠=nùng|x
穤=nhu|x
穨=đồi|x
穪=xưng|x
穮=phiêu|x
穵=ấp|x
究=cứu|x
穷=nghèo/cùng|x
空=không/khoảng trống/khoảng không/vô ích/rảnh/trống|x
穽=tỉnh|x
突=đột|x
窅=yểu|x
窈=yểu|x
窍=khiếu|x
窑=lò/hầm lò/chỗ trú|x
窓=song|x
窔=yểu|x
窗=cửa sổ/song|x
窘=quẫn/(túng) quẫn|x
窜=vọt/tháo chạy/lủi|x
窝=ổ|x
窞=đạm|x
窟=quật/hang|x
窣=tốt|x
窥=dòm/dòm ngó|x
窦=đậu|x
窳=dũ|x
窸=tất|x
窻=song|x
窾=khoản|x
窿=lung|x
竈=táo|x
立=lập/đứng|x
竑=hồng|x
竖=dựng thẳng|x
竞=cạnh/lại còn|x
竢=sĩ|x
竣=tuấn|x
竪=thụ|x
竭=kiệt|x
端=đầu/bưng/mang/đoan|x
竸=cạnh|x
竹=trúc|x
竺=trúc|x
竾=trì|x
笇=toán|x
笉=tiếu|x
笋=măng|x
笏=hốt|x
笑=cười/tiếu|x
笔=bút|x
笛=địch|x
笠=nón lá|x
笥=tứ|x
符=phù|x
笨=đần/bổn/ngu/dốt|x
笪=đát|x
第=thứ|x
笭=linh|x
笯=nô|x
笱=cú|x
笵=phạm|x
笸=phả|x
笺=tiên|x
筇=cung|x
筊=giao|x
筐=giỏ|x
筒=ống/đồng|x
筓=kê|x
答=đáp|x
筘=khấu|x
筚=tất|x
筛=si|x
筜=đương|x
筞=sách|x
筠=quân|x
筢=ba|x
筤=lang|x
筥=cử|x
筦=quản|x
筩=đồng|x
筪=xá|x
筭=toán|x
筯=trợ|x
筰=tạc|x
筳=đình|x
筴=sách|x
筷=đũa|x
筸=cao|x
筹=trù|x
筼=vân|x
简=giản/giản đơn|x
箂=lai|x
箄=bài|x
箅=ty|x
箆=bề|x
箒=Houki/trửu|x
箓=lục|x
箘=duẩn|x
箙=phục|x
箜=không|x
箠=chủy|x
管=quản/ống|x
箣=sách|x
箧=tráp/khiếp|x
箩=sọt/la|x
箪=đan|x
箯=tiên|x
箱=rương/hòm|x
箲=tiển|x
箴=châm|x
箵=tinh|x
箸=đũa/trứ|x
篅=thuyên|x
篆=triện|x
篇=thiên/quyển sách|x
篑=quĩ|x
篓=cái sọt|x
篔=vân|x
篝=cái lồng|x
篠=tiểu|x
篡=soán|x
篥=lật|x
篮=rổ/cái giỏ/giỏ|x
篰=bộ|x
篱=ly|x
篴=địch|x
篷=bồng/cột buồm/mui thuyền|x
篸=trâm|x
篼=đâu|x
簃=di|x
簆=khấu|x
簇=đám/bụi|x
簉=sứu|x
簒=soán|x
簕=lặc|x
簝=liêu|x
簦=đăng|x
簨=tuẩn|x
簪=trâm/Kanzashi|x
簮=trâm|x
簰=bài|x
簴=cự|x
簸=sàng|x
簹=đương|x
簿=sổ ghi chép|x
籆=dược|x
籎=ngữ|x
籐=đằng|x
籑=soạn|x
籒=trứu|x
籕=trứu|x
籙=lục|x
籛=tiên|x
籢=liêm|x
籣=lan|x
籥=thược|x
籯=doanh|x
米=gạo/mét/mễ (m)/mễ/thước|x
籹=nữ|x
类=loại/tương tự/thứ/giống như|x
籽=tử/hạt/hạt giống|x
粇=canh|x
粉=phấn/fan/bún/hồng/bột|x
粊=bỉ|x
粒=hạt/lạp/viên|x
粔=cự|x
粗=thô/to|x
粘=dính|x
粟=túc/túc (hạt kê)|x
粧=trang|x
粱=lương|x
粺=bại|x
粽=tống|x
粿=bánh/gạo cao lương|x
糁=tảm|x
糂=tảm|x
糅=hỗn tạp|x
糉=tống|x
糊=dán/hồ/cháy|x
糐=đoàn|x
糒=bí|x
糕=bánh ngọt|x
糖=đường/kẹo/đường kẹo|x
糗=khứu/bựa vãi|x
糙=cẩu thả/tháo|x
糜=cháo|x
糟=hỏng bét/tao/nát|x
糠=khang|x
糢=mô|x
糤=tản|x
糨=cưỡng|x
糯=nhu|x
糵=nghiệt|x
糸=mịch|x
糺=củ|x
系=hệ/thắt|x
紃=xuyên|x
紊=rối|x
紏=củ|x
紘=hoành|x
紝=nhâm|x
紟=kim|x
素=làm/tố/món chay|x
索=tác|x
紥=trát|x
紧=gấp/chặt/nhanh|x
紩=trật|x
紫=tử/tím/Yukari|x
紬=trừu|x
紮=ôm/kẹp/cột|x
累=mệt mỏi/luy/mệt|x
紵=trữ|x
紽=đà|x
紾=chẩn|x
絃=huyền|x
絅=quýnh|x
絍=nhâm|x
絖=khoáng|x
絙=căng|x
絚=căng|x
絝=khố|x
絪=nhân|x
絮=nhứ/sợi thô|x
絰=điệt|x
絸=kiển|x
絺=hi|x
綂=thống|x
綅=tiên|x
綉=tú|x
綌=khích|x
綍=phất|x
綑=khổn|x
綦=kỳ|x
綫=tuyến|x
綮=khể|x
綯=đào|x
綳=banh|x
綵=thải|x
綷=túy|x
緅=tưu|x
緉=lưỡng|x
緌=nhuy|x
緐=phồn|x
緜=miên|x
緤=tiết|x
緥=bảo|x
緺=oa|x
縆=hằng|x
縕=ôn|x
縗=thôi|x
縚=thao|x
縠=hộc|x
縢=đằng|x
縧=thao|x
縩=sái|x
縯=diễn|x
縳=truyện|x
縿=sam|x
繁=phồn|x
繄=ê|x
繣=hoạch|x
繮=cương|x
纆=mặc|x
纎=tiêm|x
纑=lư|x
纒=triền|x
纕=tương|x
纛=đạo|x
纠=sửa chữa|x
红=đỏ/hồng|x
纣=trụ|x
纤=tiêm|x
约=hẹn/ước/ước chừng|x
级=cấp/bậc|x
纨=hoàn|x
纬=vĩ|x
纭=vân|x
纮=hoành|x
纯=thuần/tinh khiết|x
纰=lỗi/lầm|x
纱=sa|x
纳=nạp|x
纴=nhâm|x
纵=tung/túng|x
纷=lộn xộn|x
纹=văn/vân|x
纺=tơ lụa|x
纻=trữ|x
纼=dẫn|x
纽=nữu|x
练=luyện|x
组=tổ|x
绅=thân|x
细=mảnh/tế|x
织=dệt/chức/SHIKI/đan|x
终=cuối cùng/hết/chung|x
绊=vấp|x
绍=thiệu|x
经=trải qua/kinh|x
绑=buộc/trói|x
结=kết|x
绖=điệt|x
绘=vẽ|x
绚=huyến|x
络=lạc|x
绝=tuyệt|x
绞=giảo/xoắn/vắt|x
绣=thêu|x
绤=khích|x
绥=tuy|x
继=kế|x
绩=tích|x
绫=lăng|x
续=tục/tiếp theo|x
绮=khinh|x
绯=phi|x
绰=xước|x
绳=dây thừng|x
维=duy/chiều/chiều không gian|x
绵=miên|x
绷=kéo căng/băng bó/banh|x
绸=lụa|x
综=tổng/tông/tống|x
绽=phun/trán|x
绿=lục/xanh biếc/xanh|x
缄=giam|x
缅=xa|x
缆=lãm|x
缊=ôn|x
缎=gấm|x
缐=tuyến|x
缓=chậm/trì hoãn/hoãn|x
缔=đế|x
缕=sợi|x
编=biên/bện|x
缘=duyên/duyến|x
缙=tấn|x
缜=chẩn|x
缝=khe hở/vá/may|x
缞=thôi|x
缦=man|x
缪=mâu|x
缫=sào|x
缰=cương|x
缱=khiển|x
缶=phữu|x
缺=thiếu/khuyết|x
缾=bình|x
缿=hạng|x
罃=oanh|x
罅=há|x
罇=tôn|x
罈=đàn|x
罊=tề|x
罍=lôi|x
罎=đàm|x
罏=lô|x
罐=bình/lon|x
网=lưới/net/võng/ NET/mạng|x
罒=võng|x
罕=hi hữu|x
罗=la/lưới|x
罚=phạt|x
罝=ta|x
罢=thôi/xong/bỏ đi|x
罣=quái|x
罥=quyến|x
罦=phù|x
罪=tội/khổ|x
罫=quải|x
罭=vực|x
置=đưa/mua/trí|x
罱=lãm|x
署=thự|x
罶=liễu|x
罹=ly|x
罽=kế|x
羀=lữu|x
羁=bó|x
羃=mạc|x
羌=khương|x
美=đẹp/mỹ|x
羐=dũ|x
羑=dũ|x
羒=phần|x
羓=ba|x
羔=cừu con|x
羖=cổ|x
羜=trữ|x
羞=xấu hổ/thẹn thùng/nhục|x
羠=di|x
羡=ao ước|x
羢=nhung|x
羣=quần|x
群=bầy/đàn/nhóm/quần|x
羯=yết|x
羰=thang|x
羴=thiên|x
羵=phần|x
羶=thiên|x
羽=vũ|x
羿=nghệ|x
翀=xung|x
翁=ông|x
翃=hoành|x
翄=sí|x
翅=cánh|x
翎=linh|x
翔=liệng/bay liệng|x
翙=kiều|x
翚=huy|x
翛=tiêu|x
翟=địch/Trạch (họ)|x
翠=thúy/Midori|x
翤=sí|x
翥=chứ|x
翦=tiễn|x
翩=phiên|x
翬=huy|x
翯=hạc|x
翰=hàn|x
翶=cao|x
翺=cao|x
翼=cánh/dực|x
翽=hối|x
翾=huyên|x
翿=đạo|x
老=lão/già/rất|x
考=kiểm tra/thi/khảo thi|x
耄=mạo|x
耆=kỳ|x
耊=điệt|x
耎=nhuyễn|x
耏=nhi|x
耐=nhịn|x
耕=cày/canh|x
耗=hao tổn|x
耙=bá|x
耜=tỷ|x
耝=thư|x
耞=gia|x
耡=sừ|x
耢=lạo|x
耦=ngẫu|x
耰=ưu|x
耲=hoài|x
耳=tai/mà thôi|x
耶=a/cũng/ư|x
耷=đạp|x
耸=đứng thẳng|x
耻=hổ thẹn|x
耼=đam|x
耽=kéo dài/đam|x
耿=cảnh|x
聂=Nhiếp/Niếp|x
聆=linh|x
聊=trò chuyện/tán gẫu|x
聋=điếc|x
聒=quát|x
聚=tụ/họp/xóm|x
聡=thông|x
聪=thông/thính giác|x
聫=liên|x
聱=ngao|x
聴=thính|x
聻=tiệm/nễ|x
聿=duật/họ|x
肃=túc|x
肆=tứ|x
肇=triệu|x
肊=ức|x
肌=cơ|x
肎=khẳng|x
肏=thao/địt|x
肐=cách|x
肖=tiêu/giống như|x
肘=khuỷu tay/khửu tay|x
肚=bụng/dạ dày|x
肝=lá gan/can/gan|x
股=cỗ/cổ/luồng/đùi/sợi/dòng/cổ phần|x
肢=chi|x
肤=da|x
肥=mập|x
肩=vai/kiên|x
肬=vưu|x
肯=chịu/khẳng/đồng ý/tán thành/bằng lòng|x
肰=nhiên|x
育=dục|x
肸=hật|x
肽=thái|x
肾=thận|x
肿=sưng|x
胁=uy hiếp/hiếp|x
胆=gan/đảm/mật/can đảm/Can đảm|x
背=cõng/lưng/khiêng/bối/sau lưng/đọc/kém/học thuộc|x
胎=thai|x
胐=phỉ|x
胔=tí|x
胖=béo/mập|x
胘=thiết|x
胜=thắng|x
胡=hồ|x
胥=tư|x
胫=hĩnh|x
胬=nỗ|x
胯=hông/khố/háng|x
胰=di|x
胲=hợi|x
胳=ca|x
胵=si|x
胶=nhựa cây/mủ cao su/giao/giao (chất dính)|x
胸=ngực/hung|x
能=có thể/năng/có thể/năng lực|x
脁=thiểu|x
脂=son/mỡ|x
脃=thúy|x
脊=sống lưng/sống|x
脍=quái|x
脏=bẩn/tạng|x
脐=tề/rốn/yếm cua|x
脖=cái cổ|x
脡=đĩnh|x
脣=thần|x
脤=thận|x
脦=thắc|x
脧=tuyên|x
脰=đậu|x
脱=thoát/cởi|x
脸=mặt/kiểm/khuôn mặt/vẻ mặt/sắc mặt/biểu cảm|x
腇=nỗi|x
腊=tịch|x
腋=nách|x
腌=ướp/yêm|x
腐=mục nát/hủ|x
腒=cư|x
腓=phì|x
腕=cổ tay/oản|x
腘=quắc|x
腚=mông/đít|x
腤=am|x
腥=tanh|x
腯=đột|x
腴=mập/du|x
腷=phức|x
腹=bụng|x
腽=ột|x
腾=đằng|x
膀=bàng|x
膄=thọ|x
膆=tố|x
膇=truy|x
膈=cách|x
膋=liêu|x
膍=tỳ|x
膏=cao|x
膗=soài|x
膘=phiêu/mỡ|x
膝=đầu gối/đầu gối|x
膣=âm đạo|x
膧=mông lung mờ mịt|x
膰=phiền|x
膳=thiện|x
膴=hô|x
膵=tụy|x
膻=mùi/thiên|x
臀=mông|x
臂=cánh tay|x
臃=ung|x
臄=cược|x
臆=ức/ý nghĩ/ngực|x
臈=lạp|x
臊=thẹn/tao|x
臋=đồn|x
臌=cổ|x
臑=nao|x
臕=phiêu|x
臙=yên|x
臜=châm|x
臝=lỏa|x
臞=cù|x
臡=nê|x
臣=thần|x
臧=tang|x
自=từ/tự/đương nhiên/tự thân/tự nhiên|x
臬=nghiệt|x
臭=thối|x
臯=cao|x
臲=niết|x
至=đến/tới/chí|x
臶=jiàn|x
臻=đạt đến|x
臼=cữu|x
臿=tráp|x
舁=dư|x
舄=tích|x
舅=cậu|x
舆=dư|x
舋=hấn|x
舍=bỏ/xá|x
舒=thư|x
舖=phô|x
舚=thiêm|x
舛=suyễn|x
舝=hạt|x
舞=múa/vũ/võ|x
舟=thuyền|x
舠=đao|x
舢=san|x
航=hàng|x
舫=phảng/thuyền|x
舯=trung điểm|x
舰=hạm|x
舲=linh|x
舷=mạn thuyền|x
艁=tạo|x
艅=dư|x
艇=thuyền/tàu|x
艑=biển|x
艒=mục|x
艓=điệp|x
艖=sa|x
艗=dật|x
艘=chiếc/chiến thuyền|x
艣=lỗ|x
艨=mông|x
艪=lỗ|x
良=lương/người lương thiện|x
艰=gian|x
色=sắc|x
艴=phật|x
艶=diễm|x
艹=thảo|x
艽=giao|x
艾=ngải|x
节=tiết/lễ/knot|x
芃=bồng|x
芄=hoàn|x
芋=dụ|x
芒=mang/mũi nhọn|x
芗=hương|x
芙=phù|x
芜=vu|x
芝=chi|x
芠=văn|x
芣=phù|x
芤=khâu|x
芥=giới|x
芦=lô|x
芧=trữ|x
芩=cầm|x
芬=phân|x
芭=ba|x
芮=nhuế|x
芯=tâm|x
花=hoa/tiêu/tiêu xài/tốn|x
芳=phương|x
芶=tán|x
芷=chỉ|x
芸=vân|x
芹=cần|x
苅=ngải|x
苇=vi|x
苌=trường|x
苍=thương|x
苏=tô/Tô|x
苐=đệ|x
苑=uyển|x
苔=rêu|x
苗=mầm/miêu|x
苘=khoảnh|x
苛=hà khắc/hà|x
苞=bao|x
苟=cẩu/cẩu thả|x
苠=mân|x
苢=dĩ|x
若=như/nếu|x
苦=khổ/đắng|x
英=anh|x
苲=trả|x
苴=tư|x
苶=niết|x
苹=bình|x
苺=môi|x
苻=phù|x
苾=bật|x
苿=phỉ|x
茀=phất|x
茁=truất|x
茂=mậu/tốt|x
范=phạm|x
茄=cà|x
茅=mao|x
茆=lữu|x
茇=bạt|x
茈=sài|x
茌=trì|x
茍=cẩu|x
茓=huyệt|x
茕=quỳnh|x
茘=lệ|x
茜=thiến/Tây/Akane|x
茝=chỉ|x
茧=kén/vết chai/kén|x
茨=tỳ|x
茫=mang|x
茳=giang|x
茵=đệm/đệm|x
茸=nhung|x
茹=như|x
荀=Tuân/tuần|x
荄=cai|x
荅=đáp|x
荆=gai/Kinh|x
荈=suyễn|x
荍=kiều|x
荏=nhẫm|x
荒=hoang/Hoang|x
荔=lệ|x
荚=giáp|x
荞=kiều|x
荟=oái|x
荠=tề|x
荣=vinh/quang vinh|x
荤=ăn mặn|x
荥=huỳnh|x
荧=huỳnh|x
荪=tôn|x
荫=ấm/bóng râm|x
荭=hồng|x
荮=bọc bằng cỏ|x
荳=đậu|x
荷=hà|x
荸=bột|x
荺=quân|x
荻=địch|x
荼=đồ|x
莅=lỵ|x
莎=toa|x
莒=cử|x
莘=tân|x
莙=quân|x
莚=diên|x
莝=tỏa|x
莞=hoàn|x
莤=tú|x
莨=lang|x
莪=nga|x
莫=chớ/màn/không ai/sờ/mạc|x
莱=lai|x
莲=sen/liên|x
莴=oa|x
莹=oánh/óng ánh|x
莼=thuần|x
莽=mãng|x
莾=mãng|x
菁=tinh|x
菂=đích|x
菅=gian|x
菆=tưu|x
菈=lạp|x
菉=lục|x
菊=cúc|x
菏=hà|x
菑=truy|x
菓=quả|x
菡=hạm|x
菫=cận|x
菱=lăng|x
菲=phỉ|x
菸=ư|x
菽=thục|x
菾=điềm|x
萃=tụ tập/tụy|x
萌=manh/moe/nảy sinh (manh)|x
萍=bình|x
萐=tiệp|x
萚=thác|x
萛=thu|x
萝=la|x
营=doanh|x
萦=oanh|x
萧=tiêu|x
萨=tát|x
萩=thu|x
萫=soup rau thịt|x
萲=huyên|x
萹=phiên|x
萼=ngạc|x
落=rơi/lạc|x
葅=thư|x
葊=am|x
葓=hồng|x
葘=truy|x
葚=thậm|x
葛=cát|x
葜=kháp|x
葡=bồ|x
董=đổng|x
葧=nhụy hoa|x
葫=hồ lô|x
葬=táng/chôn cất/mai táng|x
葯=ước|x
葱=hành/thông/hành tây|x
葳=uy|x
葵=quỳ/Aoi|x
葶=đình|x
葹=thi|x
蒂=cuống/đế|x
蒉=quỹ|x
蒋=tưởng/đem|x
蒐=sưu|x
蒓=thuần|x
蒕=uân|x
蒙=được/che/lừa/mê mẩn/đoán mò/mông/ngu dốt/phủ|x
蒟=củ|x
蒡=bảng|x
蒧=điểm|x
蒨=thiến|x
蒭=sô|x
蒯=khoái|x
蒲=Bồ|x
蒸=chưng/xông|x
蒻=nhược|x
蒿=hao/cây ngải|x
蓂=minh|x
蓄=súc|x
蓆=tịch|x
蓇=cốt|x
蓊=ống|x
蓏=lỏa|x
蓓=bội|x
蓝=lam/Ran|x
蓟=kế|x
蓥=oanh|x
蓧=điệu|x
蓬=bồng/oành|x
蓰=tỷ|x
蓱=bình|x
蓴=thuần|x
蓷=thôi|x
蓺=nghệ|x
蓼=liệu|x
蔂=luy|x
蔆=lăng|x
蔇=ký|x
蔌=tốc|x
蔑=miệt|x
蔕=đế|x
蔗=giá/mía|x
蔘=sâm|x
蔚=úy|x
蔟=thốc|x
蔡=thái|x
蔫=ỉu xìu|x
蔬=sơ/rau|x
蔴=ma|x
蔺=lận|x
蔾=lê|x
蕃=phiên|x
蕉=tiêu|x
蕑=gian|x
蕗=lộ|x
蕝=toát|x
蕡=phần|x
蕨=quyết|x
蕰=ôn|x
蕲=kỳ|x
蕴=uẩn/bao hàm|x
蕹=ung|x
蕻=hống|x
蕼=cầm|x
蕾=nụ/lôi|x
薀=ôn|x
薄=mỏng/bạc|x
薆=ái|x
薋=từ|x
薏=ý|x
薐=lăng|x
薓=sâm|x
薘=đạt|x
薙=thế|x
薛=tiết|x
薜=bệ|x
薝=đảm|x
薪=củi/lương|x
薯=khoai|x
薳=vĩ|x
薴=trữ|x
薸=phiêu|x
薻=tảo|x
薾=nhĩ|x
藁=cảo|x
藉=tạ|x
藊=biển|x
藏=giấu/trốn/cất/tạng/tàng|x
藐=miểu|x
藑=quỳnh|x
藕=ngó sen|x
藚=tục|x
藟=lũy|x
藠=hiểu|x
藤=dây leo/đằng|x
藨=biễu|x
藩=phiên|x
藭=cùng|x
藳=cảo|x
藻=tảo|x
藼=huyên|x
藾=lại|x
蘀=thác|x
蘂=nhị|x
蘐=huyên|x
蘑=ma/nấm|x
蘖=nghiệt|x
蘗=bách|x
蘝=liêm|x
蘼=mi|x
虀=tê|x
虆=luy|x
虉=dị|x
虍=hô|x
虎=hổ|x
虐=ngược/hành hạ|x
虒=ti|x
虓=hao|x
虔=kiền|x
虚=hư|x
虞=ngu/lo lắng|x
虡=cự|x
虢=quắc/Quắc|x
虩=khích|x
虯=cầu|x
虸=tử|x
虹=cầu vồng|x
虽=dù/mặc dù|x
蚁=kiến/con kiến/nghĩ|x
蚄=phương|x
蚊=muỗi|x
蚌=con trai/con trai(bạng)|x
蚑=kỳ|x
蚕=tằm|x
蚘=hồi|x
蚛=trọng|x
蚡=phẫn|x
蚦=nhiêm|x
蚩=xi|x
蚬=hiện|x
蚳=chỉ|x
蚵=hà|x
蚿=huyền|x
蛀=đục|x
蛁=điêu|x
蛃=mọt|x
蛊=cổ/sâu độc|x
蛏=sinh|x
蛕=hồi|x
蛙=ếch/oa|x
蛛=nhện|x
蛟=giao/thuồng luồng|x
蛤=cáp|x
蛮=rất/man|x
蛰=ngủ đông/ẩn nấp|x
蛼=xa|x
蜀=thục|x
蜂=ong/phong|x
蜎=quyên|x
蜐=kiếp|x
蜑=đản|x
蜕=thuế|x
蜣=khương|x
蜨=điệp|x
蜷=cuộn tròn/quyền|x
蜹=nhuế|x
蜺=nghê|x
蜼=vị|x
蜿=uyển|x
蝀=đông|x
蝃=đế|x
蝄=võng|x
蝆=dạng|x
蝉=ve/thiền/con ve|x
蝍=tức|x
蝎=bọ cạp/hạt|x
蝓=du|x
蝗=hoàng|x
蝘=yển|x
蝜=phụ|x
蝟=vị|x
蝡=nhuyễn|x
蝨=sắt|x
蝪=thang|x
蝯=viên|x
蝱=manh|x
蝶=bướm/điệp|x
蝾=vinh|x
螀=tương|x
螁=ban|x
螉=ông|x
融=tan|x
螓=tần|x
螘=nghĩ|x
螙=đố|x
螠=ế|x
螡=văn|x
螣=đằng|x
螮=đế|x
螯=ngao|x
螲=chất|x
螺=xoắn ốc/loa|x
螾=dẫn|x
螿=tương|x
蟏=tiêu|x
蟒=mãng|x
蟘=đạc|x
蟜=kiểu|x
蟟=liêu|x
蟠=bàn|x
蟢=hỉ|x
蟫=đàm|x
蟷=đang|x
蟹=cua/giải|x
蟾=thiềm|x
蠁=hưởng|x
蠉=huyên|x
蠋=trục|x
蠎=mãng|x
蠕=nhuyễn|x
蠘=tiệt|x
蠙=tân|x
蠜=phàn|x
蠡=lãi|x
蠢=xuẩn/ngu xuẩn/ngu|x
蠧=đố|x
蠪=long|x
蠲=quyên|x
蠵=huề|x
蠺=tàm|x
衁=hoang|x
衂=nục|x
衅=hấn|x
衆=chúng|x
衇=mạch|x
行=đi/được/hành/nghề/làm/hạnh|x
衍=diễn|x
衎=khản|x
衏=viện|x
衖=hạng|x
街=đường phố/nhai/phố/chợ|x
衚=hồ|x
衞=vệ|x
衠=truân|x
衡=hoành/nhất định|x
衢=cù|x
衣=áo/y|x
补=bổ/bù|x
表=biểu/đồng hồ/bề ngoài/đơn/bày tỏ|x
衩=xái|x
衬=lót/sấn|x
衭=phu|x
衰=suy|x
衵=nật|x
衷=trung|x
衽=nhẫm|x
衾=chăn/khâm|x
袁=viên|x
袆=huy|x
袋=túi/xách|x
袌=bão|x
袍=bào|x
袎=áo|x
袐=bi|x
袒=đản|x
袓=tổ|x
袖=tay áo/tụ|x
袗=chẩn|x
袚=bát|x
袛=chi/đê|x
袜=vớ|x
袟=dật|x
袪=khư|x
袴=khố|x
袽=như|x
袿=khuê|x
裀=nhân|x
裁=cắt/tài|x
裂=nứt/nứt ra/rách|x
装=trang/chứa/giả/lắp/giả bộ/làm ra vẻ/sắp xếp/cài đặt|x
裈=côn|x
裋=thụ|x
裎=trình|x
裐=biển|x
裔=duệ|x
裕=dụ|x
裘=cầu/áo lông|x
裙=váy|x
裛=ấp|x
裠=quần|x
裤=quần|x
裪=Tạo|x
裯=chù|x
裲=lưỡng|x
裴=bùi|x
裸=lõa/trần/khỏa thân|x
裾=cư|x
褂=áo khoác|x
褌=côn|x
褏=tụ|x
褐=hạt|x
褒=bao|x
褓=bảo|x
褔=phúc|x
褕=du|x
褘=huy|x
褚=chử/Chử|x
褝=đan|x
褞=ôn|x
褟=thạp|x
褥=tấm đệm|x
褫=sỉ|x
褭=niểu|x
褯=giải|x
褱=hoài|x
褶=điệp|x
襀=tích|x
襄=tương|x
襇=cán|x
襌=đan|x
襏=bát|x
襕=lan|x
襚=tùy|x
襛=nùng|x
襜=xiêm|x
襢=đản|x
襫=thích|x
襭=hiệt|x
襮=biểu lộ|x
襱=lũng|x
襴=lan|x
襶=đái|x
襼=nghệ|x
襾=á|x
西=tây|x
覃=đàm|x
覆=che|x
覈=hạch|x
覊=ki|x
覔=mịch|x
覜=thiếu|x
覤=đối|x
覥=điễn|x
覧=lãm|x
覩=đổ|x
覰=thứ|x
覶=la|x
覸=gián|x
覼=la|x
观=xem/quan/quán|x
觃=nghiện|x
规=quy|x
觅=tìm/kiếm/tìm kiếm|x
视=xem/thị/nhìn kỹ/coi|x
览=lãm|x
觍=điễn|x
觐=cận|x
角=sừng/vai diễn/góc/giác/nhân vật|x
觔=cân|x
觖=quyết|x
觜=miệng/tuy|x
觝=để|x
觥=quang|x
触=sờ/đụng|x
觫=tốc|x
觭=ki|x
觱=tất|x
觵=quang|x
觺=nghi|x
觽=huề|x
觿=huề|x
言=nói/ngôn/lời|x
訄=cừu|x
訏=hu|x
訑=di|x
訒=nhẫn|x
託=thác|x
訚=ngân|x
訩=hung|x
訸=hoà|x
註=chú|x
証=chứng|x
訾=tí|x
詅=linh|x
詗=huýnh|x
詝=chủ|x
詧=sát|x
詨=hiếu|x
詹=chiêm|x
詻=ách|x
詾=hung|x
誉=dự|x
誊=đằng|x
誐=nga/Nga|x
誓=thề|x
説=nói/thuyết|x
誾=ngân|x
諆=khi|x
諐=khiên|x
諓=tiễn|x
諕=hách|x
諝=tư|x
諟=thị|x
諠=huyên|x
諡=thụy|x
諩=phổ|x
謆=phiến|x
謋=hoạch|x
謌=ca|x
謏=tiểu|x
謻=di|x
謼=hô|x
譁=hoa|x
譅=sáp|x
譆=hi|x
譊=nao|x
譍=ưng|x
譔=soạn|x
譞=huyên|x
譟=táo|x
警=cảnh|x
譭=hủy|x
譱=thiện|x
譸=trù|x
譾=tiễn|x
讁=trích|x
讅=thẩm|x
讋=triệp|x
讌=yên|x
讏=vệ|x
讐=thù|x
讔=ẩn|x
计=kế/tính|x
订=đặt trước/đính|x
认=nhận/nhận thức|x
讥=cơ/mỉa mai|x
讬=thác|x
训=huấn|x
议=nghị|x
记=nhớ/ghi/ký/cái|x
讱=nhẫn|x
讲=giảng/kể/nói|x
讳=húy/kiêng kị|x
讷=nột|x
许=hứa/cho phép/tán dương/đính hôn|x
讹=lừa bịp/ngoa/hạch|x
论=luận/nói/bàn về|x
讻=hung|x
讽=phúng|x
设=thiết|x
诀=quyết/bí quyết|x
证=chứng/chứng nhận|x
评=bình/bình luận|x
诇=huýnh|x
诈=lừa dối/gạt|x
诉=tố|x
诊=xem bệnh|x
诋=để|x
诎=truất|x
诏=chiếu|x
诐=bí|x
译=dịch|x
诔=lụy|x
试=thử/thí/thi|x
诚=thành|x
诞=sinh/đản|x
诟=cấu|x
诡=quỷ|x
询=tuân/hỏi ý kiến|x
详=tường|x
诨=ngộn|x
诪=trù|x
诫=giới|x
诬=vu|x
语=ngữ|x
误=lầm|x
诰=cáo|x
诱=dụ|x
诳=lừa gạt/cuống/nói dối/lừa dối|x
诵=tụng|x
诹=trâu/tưu|x
诺=nặc/ừm/vâng/dạ|x
读=đọc/độc/xem/học|x
调=điều/giọng|x
谆=truân|x
谈=đàm/nói/đàm luận|x
谋=mưu|x
谌=kham|x
谎=láo/dối|x
谐=hài|x
谓=vị/gọi là|x
谕=dụ|x
谗=thèm/gièm pha|x
谙=am|x
谛=đế|x
谞=tư|x
谢=tạ/tạ ơn/cảm ơn|x
谣=dao|x
谤=báng|x
谥=thụy|x
谦=khiêm|x
谨=cẩn|x
谩=mạn|x
谪=trích|x
谬=sai|x
谭=đàm|x
谯=tiêu/tiếu|x
谱=phổ|x
谲=quyệt|x
谴=khiển|x
谷=cốc|x
谿=khê|x
豀=hề|x
豁=thông suốt|x
豇=giang|x
豉=chao/thị|x
豊=phong|x
豋=đăng|x
豒=trật|x
豕=lợn/con heo|x
豖=con lợn bị cùm|x
豗=hôi|x
豝=ba|x
象=tượng/giống như/voi/giống|x
豪=hào|x
豫=dự|x
豭=gia|x
豰=heo con|x
豶=phần|x
豷=ế|x
豹=báo|x
豺=sài|x
貃=mạch|x
貈=mạch|x
貌=mạo|x
貍=ly|x
貎=nghê|x
貐=du|x
貛=hoan|x
貟=viên|x
貣=thắc|x
貤=dị|x
賍=tang|x
賖=tha|x
賙=chu|x
賛=tán|x
賝=sâm|x
賨=tung|x
賮=tẫn|x
賸=thứng|x
贇=xinh đẹp|x
贉=đảm|x
贑=cống|x
贒=hiền|x
贜=tang|x
贝=bối|x
贞=trinh|x
负=phụ/cõng/thua/âm/cậy/phụ|x
贡=cống|x
责=trách|x
贤=hiền|x
质=chất|x
贩=phiến/buôn bán|x
贪=tham|x
贫=bần/lắm mồm/nghèo|x
购=mua/cấu/mua sắm|x
贯=xâu/quan/quán|x
贱=tiện|x
贲=bí|x
贳=thế|x
贴=thiếp/dán|x
贵=quý/đắt|x
贷=vay|x
贸=mậu|x
贺=chúc/hạ|x
贻=di|x
贾=giả/cổ|x
贿=hối|x
赃=tang|x
资=tư|x
赇=cầu|x
赈=cứu tế/giúp|x
赉=lãi|x
赋=phú|x
赌=cược/đánh bạc/đổ/đánh cược/đánh cược|x
赎=chuộc|x
赏=thưởng/phần thưởng/thưởng thức|x
赑=bí|x
赓=canh|x
赕=đạm|x
赖=lại/ỷ lại/dựa vào/nhờ cậy/vô lại|x
赗=phúng|x
赘=vô dụng|x
赛=thi đấu/thắng|x
赝=nhạn|x
赞=tán/khen|x
赟=uân|x
赣=Cán|x
赤=đỏ/xích|x
赦=xá|x
赧=thẹn đỏ mặt|x
赩=hách|x
赪=xanh|x
赫=hách/Hertz|x
赯=đường|x
走=đi/chạy/tẩu|x
赵=triệu/Triệu|x
赶=đuổi/cản/đưa|x
趁=thừa dịp/sấn|x
趂=sấn|x
越=càng/vượt/việt|x
趋=xu thế|x
趍=xu|x
趐=sí|x
趟=lội/chuyến|x
趣=thú|x
趦=tư|x
趯=địch|x
足=đủ/chân/túc|x
趴=nằm sấp/nằm úp sấp|x
趵=bác|x
趹=quyết|x
趻=sẩm|x
趾=chỉ|x
跁=bả|x
跂=kỳ|x
跃=vọt/nhảy|x
跋=bạt|x
跌=ngã/điệt/hạ|x
跐=di|x
跕=thiếp|x
跛=cà thọt|x
距=cách/cự|x
跟=cùng/theo/cân/giống như/như là|x
跦=trù|x
跨=vượt/vượt qua/nhảy qua|x
跩=duệ|x
路=đường/lộ|x
跰=nghiễn|x
跱=trĩ|x
跲=cấp|x
跴=thải|x
践=giẫm đạp/thực hiện|x
跶=đáp|x
跷=khiêu|x
跼=cục|x
踀=xước|x
踁=hĩnh|x
踆=thuân|x
踉=lương|x
踖=tích|x
踘=cúc|x
踡=quyền|x
踥=thiếp|x
踦=khi|x
踧=địch|x
踩=giẫm/thải/giẫm lên/đạp|x
踪=tung|x
踰=du|x
踳=suyễn|x
踶=đệ|x
踸=sẩm|x
踼=thang|x
踽=củ|x
蹀=điệp|x
蹁=biên|x
蹄=vó/đề/móng/chân|x
蹅=tra|x
蹇=kiển|x
蹍=giẫm|x
蹎=điên|x
蹏=đề|x
蹐=tích|x
蹑=nhiếp|x
蹓=lựu|x
蹔=tạm|x
蹚=lội/thang|x
蹜=súc|x
蹝=sỉ|x
蹞=khuế|x
蹟=tích|x
蹡=thương|x
蹢=trịch|x
蹮=tiên|x
蹱=chung/trung|x
蹵=xúc|x
蹻=kiểu|x
蹽=liêu|x
蹾=giằng mạnh|x
躁=nóng nảy|x
躄=tích|x
躈=khiếu|x
躗=vệ|x
躘=long|x
躞=tiệp|x
躬=cung|x
躭=đam|x
躯=thân/thân thể|x
躰=thể|x
躱=đóa|x
躳=cung|x
躹=thân|x
軥=cù|x
軱=cô|x
軶=ách|x
軽=khinh|x
軿=bình|x
輓=vãn|x
輗=nghê|x
輠=quả|x
輧=bình|x
輨=quản|x
輭=nhuyễn|x
輮=nhụ|x
輴=thuân|x
輶=du|x
輹=phúc|x
輺=truy|x
轀=ôn|x
轇=giao|x
轊=duệ|x
轕=cát|x
轖=sắc|x
轗=khảm|x
轘=hoàn|x
轙=nghĩ|x
轝=dư|x
轞=hạm|x
车=xe/xa|x
轧=yết|x
轨=quỹ|x
轩=hiên|x
轪=đại|x
轮=vòng/luân/vành/tua|x
软=mềm/nhuyễn|x
轰=oanh/ầm|x
轴=trục|x
轷=hô|x
轹=lịch|x
轻=nhẹ/khinh/khẽ|x
载=chở/lại/tái/tải/năm/ghi|x
轿=kiệu|x
辁=thuyên|x
较=so sánh/khá/tương đối|x
辄=triếp/thì|x
辅=phụ|x
辆=chiếc|x
辉=huy/sáng chói|x
辍=ngừng/xuyết/thôi/nghỉ|x
辐=phúc|x
辑=tập|x
辒=uân|x
输=thua/vận chuyển/thâu/truyền/nhập|x
辔=bí|x
辕=viên|x
辖=hạt|x
辘=lộc|x
辛=tân/cực nhọc/|x
辜=cô/tội|x
辠=tội|x
辢=lạt|x
辣=cay/lạt|x
辤=từ|x
辥=tiết|x
辨=phân biệt|x
辩=biện|x
辫=biện|x
辱=nhục|x
辵=sước|x
辶=sước|x
边=bên cạnh/vừa/bên/biên/một bên/phe/cạnh|x
辻=thập|x
辽=Liêu|x
迂=vu|x
迄=đến/bèn|x
迅=nhanh chóng/tấn|x
迆=dĩ|x
过=qua/quá/từng/đã từng/tội/sai lầm|x
迈=bước/mại|x
迋=vương|x
运=vận|x
近=gần/cận|x
迒=hàng|x
还=còn/trả/hoàn/vẫn/còn chưa|x
远=xa|x
违=làm trái/không tuân/vi|x
连=ngay cả/liền/liên/cả/liên tục/nối/đại đội|x
迟=trễ/trì|x
迤=dĩ|x
迥=khác hẳn|x
迦=già|x
迪=địch|x
迫=bách/sát/vội vã|x
迭=điệt|x
迮=trách|x
迳=kính|x
迷=mê|x
迸=tóe|x
迹=dấu vết/tích|x
迺=nãi|x
迻=di|x
适=vừa/thích|x
逄=bàng|x
逆=nghịch/trái ngược|x
选=tuyển/chọn|x
逊=kém/tốn|x
逋=bỏ trốn|x
逌=do|x
逍=tiêu|x
逐=trục|x
逝=trôi qua|x
逞=sính|x
速=nhanh/tốc/tốc độ|x
逡=thuân|x
逢=gặp/phùng|x
逬=bính|x
逮=bắt/bắt bớ|x
逯=lục|x
逴=trác|x
逸=dật|x
逻=la|x
遁=độn/chui|x
遂=liền/thích thú|x
遅=trì|x
遉=trình|x
遌=ngạc|x
遍=lượt/khắp/biến/lần/khắp cả|x
遏=át|x
遐=xa|x
遑=hoàng|x
遒=tù|x
道=đạo/đường/nói/đường đi|x
遝=đạp|x
遡=tố|x
遣=phái/khiến/khiển/sai|x
遥=xa|x
遨=ngao|x
遭=bị/lần/tao|x
遯=độn|x
遰=đệ|x
遵=tuân|x
遶=nhiễu|x
遽=cự|x
邂=giải|x
邅=chiên|x
邈=mạc|x
邉=biên|x
邋=lạp|x
邓=đặng|x
邕=ung|x
邗=hàn|x
邘=vu|x
邙=mang|x
邛=cung|x
邝=quảng|x
邠=bân|x
邢=hình|x
邨=thôn|x
邬=ô/ổ|x
邰=thai/Thai|x
邱=khâu|x
邲=bật|x
邳=bi|x
邴=bỉnh|x
邵=Thiệu|x
邸=để/đệ|x
邹=nhăn/trâu|x
邻=lân cận/hàng xóm|x
邽=khuê|x
郁=úc|x
郃=hợp|x
郄=khích|x
郇=tuân|x
郈=hậu|x
郉=hình|x
郊=ngoại ô|x
郋=hề|x
郎=lang/đám/chúng|x
郏=giáp|x
郑=trịnh|x
郓=vận|x
郕=thành|x
郗=si|x
郚=ngô|x
郜=cốc|x
郝=hách|x
郞=lang|x
郤=khích|x
郦=ly|x
郪=thê|x
郭=quách/Quách|x
郯=đàm|x
郰=châu|x
郲=lai|x
郴=sâm|x
郿=mi|x
鄀=nhược|x
鄂=ngạc|x
鄃=huyện du|x
鄅=vũ|x
鄇=hậu|x
鄊=hương|x
鄌=đường|x
鄏=nhục|x
鄕=hương|x
鄘=dung|x
鄙=bỉ|x
鄚=mạo|x
鄜=phu|x
鄞=ngân|x
鄠=hộ|x
鄢=yên|x
鄦=hứa|x
鄩=tầm|x
鄫=tằng|x
鄯=thiện|x
鄾=ưu|x
酂=tán|x
酅=hy|x
酆=phong|x
酇=toản|x
酉=dậu|x
酊=đính|x
酋=tù|x
酌=rót/chước|x
配=phối/xứng|x
酏=di|x
酕=mao|x
酖=đam|x
酘=đậu|x
酞=thai|x
酣=hàm|x
酥=xốp giòn/bánh|x
酦=bát|x
酧=thù|x
酪=lạc|x
酬=thù|x
酰=tiên|x
酱=tương/-chan|x
酷=khốc|x
酸=chua/đau xót/axit/toan/chua xót/Toan (a-xit)/mệt|x
酿=nhưỡng/cất|x
醄=đào|x
醅=phôi|x
醉=say|x
醌=côn|x
醍=thể|x
醎=hàm|x
醐=hồ|x
醕=thuần|x
醝=ta|x
醣=đường|x
醨=ly|x
醭=váng|x
醰=đàm|x
醲=nùng|x
醳=dịch|x
醴=lễ|x
醻=trù|x
醼=yến|x
醽=linh|x
醾=mi|x
醿=my|x
釂=tiếu|x
釆=biện|x
释=thả/thích|x
里=bên trong/lý/dặm/trong/ở bên trong|x
重=nặng/trọng/trùng|x
野=dã|x
釐=ly|x
金=kim/vàng|x
釜=nồi đồng|x
釦=khẩu|x
釬=hạn|x
釭=công|x
釱=đệ|x
鈃=hình|x
鈇=phu|x
鈈=bất|x
鈎=câu|x
鈏=tích|x
鈚=phi|x
鈜=hồng|x
鉄=thiết|x
鉆=kiềm|x
鉋=bào|x
鉢=bát|x
鉥=thuật|x
鉨=tỉ|x
鉲=Cadium|x
鉴=giám/xem cho|x
鉶=hình|x
鉷=hồng|x
鉼=bính|x
銒=bính|x
銛=tiêm|x
銮=loan|x
銲=hãn|x
鋀=đậu|x
鋊=dụ|x
鋋=thiền|x
鋙=ngữ|x
鋩=mang|x
鋬=phạn|x
鋹=sưởng|x
錔=thạp|x
錞=thuần|x
錣=xuyết|x
鍊=luyện|x
鍚=dương|x
鍫=thiêu|x
鍳=giám|x
鍼=châm|x
鍿=truy|x
鎄=nguyên tố Enstein|x
鎋=hạt|x
鎌=liêm|x
鎏=lưu|x
鎗=sinh|x
鎚=chùy|x
鎛=bác|x
鎝=đáp|x
鎞=bề|x
鎡=tư|x
鎭=trấn|x
鎯=lang|x
鎲=đảng|x
鎶=UUb kim loại|x
鎷=mã|x
鏁=tỏa|x
鏐=lưu|x
鏦=thung|x
鏭=tất|x
鐂=lưu|x
鐍=quyết|x
鐎=tiêu|x
鐧=giản|x
鐶=hoàn|x
鐻=cự|x
鑑=giám|x
鑔=sát|x
鑕=chất|x
鑛=khoáng|x
鑤=bào|x
鑥=lỗ|x
鑫=Hâm|x
鑱=sàm|x
鑵=quán|x
鑹=thoản|x
钁=quắc|x
钂=đảng|x
针=châm|x
钉=đinh|x
钌=liễu|x
钎=thiên|x
钏=xuyến|x
钓=câu/điếu/lưỡi câu|x
钔=môn|x
钖=dương|x
钘=hình|x
钛=thái|x
钝=cùn/độn|x
钞=tiền giấy/sao|x
钟=chuông/đồng hồ/chung/chuông / đồng hồ|x
钢=thép/cương|x
钥=chìa/chìa khóa/thược|x
钧=quân|x
钩=câu/(móc) câu|x
钭=thẩu|x
钮=nút/tay cầm|x
钱=tiền/tiễn|x
钳=kìm|x
钵=bát|x
钸=tấm kim loại|x
钻=chui/khoan/dùi/xuyên/toản/kim cương|x
钼=mục|x
铁=sắt/thiết|x
铃=linh/chuông|x
铄=thước|x
铆=mão|x
铇=bào|x
铎=đạc|x
铏=hình|x
铓=mang|x
铔=a|x
铙=nao|x
铚=trất|x
铢=thù|x
铣=tiển|x
铥=đu|x
铦=tiêm|x
铧=hoa|x
铭=minh/chữ khắc|x
铮=tranh/loong coong|x
铱=y|x
铲=xẻng/xúc/xẻng xúc|x
铴=thảng|x
铵=an|x
银=ngân/bạc|x
铸=đúc|x
铹=lao|x
铺=trải/phô/phố/cửa hàng|x
链=liên/liệm/liệm dây xích|x
铿=khanh/leng keng/lạch cạch/loảng xoảng|x
销=tiêu|x
锂=lithium/lí|x
锄=cuốc|x
锆=zirconium|x
锈=gỉ/gỉ|x
锉=mài/tỏa|x
锊=vén|x
锋=phong/mũi|x
锐=duệ/sắc nhọn/nhuệ|x
锒=lang|x
错=sai/thác/kém/lỗi|x
锚=neo/cái neo/mỏ neo|x
锜=kỹ|x
锠=xương|x
锡=tích/thiếc|x
锤=chùy/nện/chuy|x
锥=khoan/trùy|x
锦=gấm|x
锪=hốt|x
键=khóa/chốt|x
锯=cưa|x
锱=tri|x
锳=anh|x
锺=đồng hồ/chung|x
锻=rèn|x
锼=sưu|x
锽=hoàng|x
锿=ai|x
镀=mạ/độ|x
镂=lũ/điêu khắc|x
镃=tư|x
镈=chiêng|x
镊=nhiếp|x
镋=đảng/đinh ba|x
镌=tuyên|x
镎=nã|x
镐=hạo/xà beng|x
镑=bảng|x
镗=thang|x
镙=máy khí bằng đồng|x
镜=kính/gương/Kagami|x
镟=tuyền|x
镠=lưu|x
镡=đốc kiếm|x
镪=cưỡng|x
镬=hoạch|x
镮=hoàn|x
镰=liêm|x
镴=lạp|x
镵=sàm|x
长=dài/mọc/trưởng/trường/sinh trưởng/lớn|x
閈=hãn|x
閗=đấu|x
閙=náo|x
閟=bí|x
関=quan|x
閧=hống|x
闇=ám|x
闉=nhân|x
闍=đồ|x
闑=niết|x
闒=tháp|x
闓=khải|x
闠=hội|x
闤=hoàn|x
门=cửa/môn/cánh cửa/们/khẩu|x
闩=then cài|x
闪=tránh/lóe/chuồn/nhanh chóng/thiểm/chợt hiện|x
闫=diêm/Diêm|x
闬=hãn|x
问=hỏi/vấn|x
闯=xông/sấm|x
闰=nhuận|x
闲=nhàn/rảnh rỗi|x
闳=hoành|x
间=ở giữa/gian/đang lúc|x
闵=mẫn|x
闷=buồn bực/im lìm/muộn/ngạt|x
闸=áp/hạp|x
闻=nghe/ngửi/văn|x
闽=mân|x
闾=lư|x
闿=khải|x
阁=các|x
阅=duyệt|x
阆=lãng|x
阉=thiến/yêm/hoạn|x
阎=Diêm|x
阐=xiển|x
阑=ngăn cản|x
阓=hội|x
阔=rộng/khoát/rộng rãi/giàu|x
阖=hạp/đóng|x
阗=điền|x
阘=tháp|x
阙=khuyết|x
阚=hám|x
阝=phụ|x
阡=thiên|x
阤=đà|x
阧=đẩu|x
阬=khanh|x
阮=nguyễn|x
阯=chỉ|x
阰=tỳ|x
防=phòng/phòng ngự|x
阳=dương|x
阴=âm|x
阶=giai/cấp/bậc|x
阸=ách|x
阺=bồ|x
阻=ngăn/ngăn trở|x
陀=đà|x
陁=đà|x
陂=pha|x
陃=tịnh|x
附=phụ|x
际=tế|x
陆=lục|x
陇=lũng|x
陈=trần|x
陋=lậu|x
陌=mạch|x
降=hàng/giảm|x
陕=nhanh/thiểm|x
陜=xiểm|x
陞=thăng|x
陟=trắc|x
陡=đột ngột/xoay mình|x
陨=vẫn/rơi|x
陪=bồi/cùng/theo/tiếp/đền|x
陵=lăng|x
陶=gốm/đào|x
陻=nhân|x
陿=hiệp|x
隁=yển|x
隂=ẩm|x
隃=du|x
隄=đê|x
隆=long|x
隋=tùy|x
随=theo/tùy|x
隐=ẩn|x
隑=cái|x
隔=cách/ngăn|x
隗=ngỗi|x
隘=ải|x
隠=ẩn|x
隡=tát|x
隣=lân|x
隧=hang ngầm|x
隮=tê|x
隶=lệ|x
隷=lệ|x
隽=tuyển|x
难=khó/nan/khó khăn/nạn|x
雀=tước|x
雁=nhạn/ngỗng|x
雄=hùng|x
雅=nhã|x
集=tập/(tụ) tập|x
雇=thuê/mướn|x
雊=cẩu|x
雌=thư/con mái/cái|x
雍=ung/Ung|x
雏=chim non|x
雒=lạc|x
雝=ung|x
雟=huề|x
雪=tuyết|x
雫=Shizuku|x
雯=văn|x
雰=phân|x
雱=bàng|x
雳=lịch|x
零=số không/0/không/linh/lẻ/không|x
雷=lôi/sấm|x
需=cần/nhu|x
霂=mộc|x
霄=tiêu|x
霉=nấm mốc|x
霍=hoắc/bỗng|x
霎=một thoáng|x
霏=phi|x
霑=thấm/nhiễm|x
霖=lâm|x
霛=linh|x
霞=hà|x
霡=mạch|x
霢=mạch|x
霣=vẫn|x
霤=lựu|x
霪=dâm|x
露=lộ|x
霶=bàng|x
霸=bá|x
靁=lôi|x
靆=đãi|x
靉=ái|x
靑=giáp|x
青=thanh/xanh|x
靓=tịnh|x
靖=tĩnh|x
静=tĩnh/Shizuka|x
靛=chàm/điện|x
靝=thiên|x
非=không phải/phi/không/không phải là|x
面=mặt/bột/diện/mì|x
靣=diện|x
靧=hối|x
革=cách|x
靪=đinh|x
靳=cận|x
靴=giày|x
靶=bia/cái bia|x
靷=dẫn|x
靸=táp|x
靺=mạt|x
靿=áo|x
鞀=đào|x
鞄=bạc|x
鞌=an|x
鞍=yên|x
鞑=thát|x
鞓=thinh|x
鞔=man|x
鞘=vỏ (kiếm, đao)/sao|x
鞚=khống|x
鞞=bỉ|x
鞟=khoát|x
鞠=cúc|x
鞧=thu|x
鞨=hạt|x
鞭=roi/cây roi/tiên|x
鞮=đê|x
鞳=tháp|x
鞵=hài|x
鞶=bàn|x
鞸=tất|x
鞹=khuếch|x
鞺=thang|x
韅=hiển|x
韈=vạt|x
韍=phất|x
韛=bị|x
韝=câu|x
韠=tất|x
韡=vĩ|x
韤=vạt|x
韧=mềm dai/nhận/dẻo dai|x
韨=phất|x
韩=Hàn/hàn|x
韬=thao|x
韶=thiều|x
頔=địch|x
頖=phán|x
頞=át|x
頟=ngạch|x
頮=hối|x
頴=dĩnh|x
頽=đồi|x
頾=tỳ|x
顇=tụy|x
顋=tai|x
顒=ngung|x
顔=nhan|x
顗=nghĩ|x
顚=điên|x
顠=tóc muối tiêu|x
顣=túc|x
顦=tiều|x
顬=nhu|x
页=trang|x
顶=đỉnh/đính|x
顷=khoảnh|x
顸=han|x
项=hạng|x
须=cần/râu/tu|x
顽=ngoan|x
顾=chú ý/ngoảnh đầu/thăm/cố|x
顿=bỗng nhiên/ngừng lại/đốn/ngừng/bữa/tấn/trận|x
颁=ban|x
颂=tụng|x
预=dự|x
颅=sọ|x
领=lĩnh/cổ/dẫn|x
颈=cổ/cái cổ/cảnh/gáy|x
颉=hiệt|x
颋=đĩnh|x
颍=dĩnh|x
颎=quýnh|x
颐=di|x
频=tần/nhiều lần|x
颒=hối|x
颓=sụt|x
颔=hạm/gật đầu|x
颕=dĩnh|x
颖=dĩnh|x
颗=khỏa/viên/khối|x
题=đề/đề tài|x
颙=ngung|x
颛=chuyên|x
颜=nhan|x
额=trán/ngạch/ách|x
颠=điên/đỉnh/xóc|x
颤=rung động/chiến/run rẩy|x
颥=nhu|x
颭=triển|x
颸=ti|x
颻=diêu|x
颿=phàm|x
飅=lưu|x
风=gió/phong/phong cách|x
飏=dương|x
飐=triển|x
飔=ti|x
飖=diêu|x
飗=lưu|x
飙=bão tố|x
飞=bay/phi/非|x
食=ăn/thực|x
飠=thực|x
飣=đính|x
飥=thác|x
飦=chiên|x
飮=ẩm|x
飱=san|x
餂=thiểm|x
餐=bữa ăn/món ăn/xan/cơm/món (ăn)/món ăn|x
餔=quả khô tẩm đường|x
餕=tuấn|x
餖=đậu|x
餗=tốc|x
餙=sức|x
餚=hào|x
餟=chuyết|x
餠=bánh|x
餦=trương|x
餧=ủy|x
餬=hồ|x
餭=hoàng|x
餱=hầu|x
餲=ế|x
餵=cho ăn|x
餺=bác|x
餻=cao|x
餽=quỹ|x
饁=diệp|x
饇=ốc|x
饊=tản|x
饍=thiện|x
饐=ý|x
饕=tham ăn/thao|x
饘=chiên|x
饝=ma|x
饟=hướng|x
饢=nang|x
饣=thực|x
饤=đính|x
饥=đói/cơ|x
饮=uống/ẩm/đồ uống|x
饯=tiễn|x
饰=sức|x
饱=no bụng/ăn no/no|x
饲=tự|x
饳=đốt|x
饵=mồi/mồi|x
饶=tha/làm cho/tha cho|x
饷=lương/hướng|x
饸=hợp|x
饹=hợp|x
饺=sủi cảo|x
饻=thi|x
饾=đậu|x
馂=tuấn|x
馃=quả|x
馅=nhân bánh|x
馆=quán|x
馈=quỹ/trấn|x
馉=cốt|x
馌=diệp|x
馍=bánh bao không nhân|x
馎=bánh bột|x
馏=lựu|x
首=thủ/đầu/bài|x
香=hương/thơm/hương thơm/thơm mát|x
馡=phỉ|x
馥=phức|x
馨=hinh|x
馹=nhật|x
馿=lư/con lừa|x
駃=khoái|x
駅=nhà ga|x
駈=khu|x
駉=quynh|x
駡=mạ|x
駪=sằn|x
駬=nhĩ|x
駮=bác|x
駰=nhân|x
駸=xâm|x
騂=tuynh|x
騃=ngãi|x
騄=lục|x
騈=biền|x
騌=tông|x
騐=nghiệm|x
騕=yểu|x
騞=hoạch|x
騟=du|x
騠=đề|x
騣=tông|x
騤=quỳ|x
騧=qua|x
騻=sương|x
驌=túc|x
驎=lân|x
驐=đôn|x
驑=lưu|x
驖=thiết|x
驝=thác|x
驦=sương|x
马=ngựa/mã|x
驭=ngự|x
驯=thuần|x
驰=trì|x
驱=khu|x
驲=nhật|x
驳=bác/bác (bỏ)|x
驶=chạy/chạy nhanh|x
驷=tứ|x
驻=trú|x
驼=còng/lạc đà|x
驽=nô|x
驾=giá/điều khiển|x
驿=dịch/dịch trạm|x
骁=kiêu|x
骃=nhân|x
骄=kiêu|x
骅=hoa|x
骆=lạc|x
骇=giật mình/hãi|x
骊=ly|x
验=nghiệm|x
骎=xâm|x
骏=tuấn|x
骑=cưỡi/kỵ|x
骒=khoả|x
骕=túc|x
骗=lừa gạt/phiến|x
骙=quỳ|x
骚=tao|x
骠=phiêu|x
骡=la/lừa|x
骤=đột nhiên/chợt|x
骥=ký|x
骦=sương|x
骨=xương/cốt|x
骫=ủy|x
骭=cán|x
骳=bí|x
骴=ci|x
骻=khóa|x
骾=ngạnh|x
髆=vai|x
髈=phảng|x
髎=liêu|x
髑=độc|x
高=cao|x
髙=cao|x
髟=tiêu|x
髠=khôn|x
髣=phảng|x
髤=hưu|x
髥=nhiêm|x
髧=đãm|x
髩=tấn|x
髭=tỳ|x
髲=bị|x
髳=mâu|x
髼=bồng|x
髽=qua|x
鬁=lỵ|x
鬃=tông|x
鬅=bằng|x
鬉=tông|x
鬋=tiên|x
鬌=đỏa|x
鬎=thích|x
鬑=liêm|x
鬒=chẩn|x
鬓=tóc mai|x
鬖=tam|x
鬘=man|x
鬙=man|x
鬜=gian|x
鬝=gian|x
鬣=liệp|x
鬫=hám|x
鬬=đấu|x
鬴=phũ|x
鬵=tẩm|x
鬶=quy|x
鬷=tông|x
魁=khôi|x
魄=phách|x
魆=tối om om|x
魇=yểm/nói mớ/bóng đè|x
魊=vực|x
魋=đồi|x
魌=kỳ|x
魍=Võng|x
魏=ngụy/Ngụy|x
魕=kỳ|x
魨=đồn|x
鮀=đà|x
鮄=phất|x
鮆=tễ|x
鮍=bì|x
鮎=niêm|x
鮓=trả|x
鮝=tưởng|x
鮠=ngôi|x
鮣=ấn|x
鮨=nghệ|x
鮰=nguy|x
鮻=toa|x
鯆=phô|x
鯈=du|x
鯗=tưởng|x
鯚=quý|x
鯠=lai|x
鯶=hỗn|x
鯻=lạt|x
鯿=biên|x
鰆=xuân|x
鰊=liễm|x
鰋=yển|x
鰐=ngạc|x
鰕=hà|x
鰜=kiêm|x
鰤=sư|x
鰵=mẫn|x
鰶=kê|x
鱅=dong|x
鱓=thiện|x
鱚=hỉ|x
鱠=quái|x
鱣=chiên|x
鱨=thường|x
鱮=tự|x
鱵=châm|x
鲁=lỗ|x
鲉=du|x
鲊=trả|x
鲍=bảo|x
鲏=bì|x
鲒=cát|x
鲖=đồng|x
鲗=tặc|x
鲘=hậu|x
鲙=quái|x
鲜=tươi/tiên/quang vinh|x
鲝=trả|x
鲠=ngạnh|x
鲤=lý/cá chép|x
鲨=cá mập/sa|x
鲬=dũng|x
鲸=kình|x
鲹=sâm|x
鲾=bức|x
鲿=thường|x
鳀=đề|x
鳁=ôn|x
鳂=ôi|x
鳄=ngạc/ngạc(cá sấu)|x
鳈=tuyền|x
鳉=tương|x
鳏=góa/quan/góa vợ|x
鳑=bàng|x
鳗=man|x
鳛=tập|x
鳠=hộ|x
鳤=quản|x
鳦=yến|x
鳬=phù|x
鳲=thi|x
鴂=quyết|x
鴃=quyết|x
鴥=duật|x
鵏=bổ|x
鵐=vu|x
鵙=quyết|x
鵟=cuồng|x
鵩=phục|x
鵰=điêu|x
鵶=nha|x
鵷=uyên|x
鵹=li|x
鵾=côn|x
鶂=nghịch|x
鶃=nghịch|x
鶆=lai|x
鶡=hạt|x
鶬=thương|x
鶱=hiên|x
鶹=lưu|x
鶺=tích|x
鷀=từ|x
鷃=yến|x
鷄=kê|x
鷇=cấu|x
鷉=thể|x
鷖=ê|x
鷟=trạc|x
鷩=tế|x
鷫=túc|x
鷭=phiên|x
鷴=nhàn|x
鷽=hạc|x
鷾=ý|x
鸂=khê|x
鸃=trĩ/gà cảnh|x
鸇=chiên|x
鸋=ninh|x
鸎=oanh|x
鸜=cù|x
鸟=chim/điểu|x
鸠=cưu|x
鸡=gà/kê/con gà|x
鸢=diên|x
鸣=minh/hót|x
鸤=thi|x
鸦=quạ|x
鸧=thương|x
鸩=trấm/chậm|x
鸭=vịt/áp|x
鸮=hào|x
鸰=linh|x
鸴=hạc|x
鸷=chí|x
鸻=hằng|x
鸼=châu|x
鸽=bồ câu/chim bồ câu|x
鸾=loan|x
鸿=hồng|x
鹂=Ly/hoàng anh|x
鹋=miêu|x
鹍=côn|x
鹏=bằng/Bằng|x
鹐=kham|x
鹒=canh|x
鹓=uyên|x
鹖=hạt|x
鹙=thu|x
鹚=từ|x
鹝=nghịch|x
鹞=diều hâu|x
鹟=ông|x
鹡=tích|x
鹢=nghịch|x
鹤=hạc|x
鹥=ê|x
鹫=thứu|x
鹬=duật|x
鹭=lộ|x
鹯=chiên|x
鹳=quán|x
鹴=sương|x
鹸=kiềm|x
鹻=dảm|x
鹿=hươu|x
麀=ưu|x
麃=tiêu|x
麄=thô|x
麅=bào|x
麌=ngu|x
麐=lân|x
麑=nghê|x
麕=quân|x
麖=kinh|x
麞=chương|x
麤=thô|x
麦=mạch|x
麨=siêu|x
麪=miển|x
麫=miến|x
麯=khúc|x
麰=mâu|x
麴=khúc|x
麻=tê dại/đay/sợi đay/chập choạng/ma|x
黀=tưu|x
黄=hoàng/vàng|x
黇=chiêm|x
黈=thẩu|x
黎=lê|x
黏=dính|x
黐=ly|x
黑=đen/hắc/hack|x
黒=hắc|x
黕=đảm|x
默=mặc/lặng yên|x
黙=mặc|x
黛=lông mày|x
黟=y|x
黠=tinh ranh/hiệt|x
黦=uất|x
黪=thảm|x
黯=ảm|x
黰=chẩn|x
黱=đại|x
黵=đảm|x
黶=yểm|x
鼂=trào|x
鼃=oa|x
鼈=miết|x
鼋=ngoan/ba ba|x
鼌=trào|x
鼏=mịch|x
鼓=trống/cổ/vỗ|x
鼔=cổ|x
鼖=phần|x
鼟=thăng|x
鼠=chuột|x
鼢=phẫn|x
鼥=bạt|x
鼦=điêu|x
鼧=đà|x
鼩=cù|x
鼫=thạch|x
鼮=đình|x
鼱=tinh|x
鼷=hề|x
鼹=yển|x
鼻=mũi|x
鼽=cừu|x
鼾=hãn|x
齁=hầu|x
齅=khứu|x
齇=tra|x
齈=nông|x
齉=nãng|x
齌=tễ|x
齐=đủ/tề|x
齑=tê|x
齕=hột|x
齗=ngân|x
齘=giới|x
齚=trách|x
齩=giảo|x
齮=nghĩ|x
齼=sở|x
龁=hột|x
龂=ngân|x
龄=linh|x
龇=thử|x
龋=củ|x
龎=bàng|x
龖=đà|x
龘=đát|x
龙=rồng/long|x
龚=cung|x
龝=thu|x
龞=ba ba/鳖|x
龟=rùa/con rùa/quy|x
龡=xúy|x
龢=hòa|x
ー=-|x
恵=Megumi/huệ|x