佚=dật|vg
侈=xỉ|vg
償=thường|vg
刈=ngải|vg
吠=phệ|vg
哂=sẩn|vg
噍=tiếu|vg
囿=hữu|vg
娩=vãn|vg
弃=khí|vg
弒=thí|vg
徙=tỷ|vg
忝=thiểm|vg
怖=phố|vg
悱=phỉ|vg
惮=đạn|vg
慑=nhiếp|vg
戡=kham|vg
揖=ấp|vg
攘=nhương|vg
斂=liễm|vg
斫=chước|vg
晤=ngộ|vg
暌=khuê|vg
枉=uổng|vg
析=tích|vg
殇=thương|vg
殓=liễm|vg
汰=thái|vg
泯=mẫn|vg
浣=hoán|vg
溉=khái|vg
滯=trệ|vg
濯=trạc|vg
牾=ngộ|vg
異=dị|vg
瘁=tụy|vg
眄=miện|vg
眠=miên|vg
睇=thê|vg
睨=nghễ|vg
瞵=lân|vg
禦=ngữ|vg
窃=thiết|vg
笞=si|vg
缚=phược|vg
罄=khánh|vg
耘=vân|vg
膺=ưng|vg
舐=thỉ|vg
荐=tiến|vg
葆=bảo|vg
虑=lự|vg
蚀=thực|vg
觏=cấu|vg
訴=tố|vg
諍=tránh|vg
讼=tụng|vg
诌=sưu|vg
诙=khôi|vg
诤=tránh|vg
诲=hối|vg
诿=ủy|vg
谏=gián|vg
谒=yết|vg
豢=hoạn|vg
赅=cai|vg
赙=phụ|vg
赡=thiệm|vg
趸=độn|vg
踞=cứ|vg
踬=chí|vg
蹈=đạo|vg
蹙=túc|vg
輟=xuyết|vg
述=thuật|vg
逭=hoán|vg
逾=du|vg
酡=đà|vg
酹=lỗi|vg
酾=si|vg
钤=kiềm|vg
阂=ngại|vg
霁=tễ|vg
靡=mỹ|vg
飨=hưởng|vg
馁=nỗi|vg
骋=sính|vg
骧=tương|vg
鬻=dục|vg
