一作=vừa làm|vn
一攻=một công|vn
一查=tra một cái|vn
一箪食=một bữa ăn|vn
一艘船=một chiếc thuyền|vn
一试=thử một lần|vn
一迳=ngay lập tức|vn
下厨房=xuống phòng bếp|vn
下箸=cầm đũa/đụng đũa/gắp ăn|vn
不幸遭遇=gặp bất hạnh|vn
专修=chuyên tu|vn
专攻=chuyên công/chuyên về một môn/chuyên tấn công/chuyên nghiên cứu/chuyên chú|vn
世袭=thế tập/thừa kế/cha truyền con nối|vn
严刑拷打=nghiêm hình tra khảo/tra tấn nghiêm khắc/thẩm vấn bằng tra tấn|vn
个展=triển lãm cá nhân/triển lãm tác phẩm của cá nhân|vn
串口=serial/xuyến khẩu|vn
串游=dạo chơi/bách bộ/đi chơi rong/đi lang thang/đi vòng vòng/nói lan man/dạo quanh|vn
串通=thông đồng/ăn cánh với nhau/xâu chuỗi/móc nối/sáp nhập|vn
临床=lâm sàng|vn
主修=chủ tu|vn
主攻=chủ công/mũi tiến công chính|vn
争先=giành trước/tranh tiên/tranh lên trước/giành lên trước|vn
争命=tranh mệnh/giành mạng sống|vn
争宠=tranh thủ tình cảm|vn
争斗=tranh đấu/đánh nhau/đánh lộn/tranh nhau/tranh giành|vn
争流=tranh lưu|vn
争讼=tranh tụng|vn
亏折=lỗ vốn/thua lỗ|vn
亏损=hao tổn/thua lỗ/hao hụt/lỗ vốn/suy dinh dưỡng/hư hao/suy yếu/suy nhược/hao gầy|vn
亏盈=thiếu đầy đủ|vn
亏空=thâm hụt/thiếu hụt/mắc nợ/nợ/số tiền thiếu hụt/tiền vay|vn
亏蚀=khuyết/che lấp một phần/lỗ vốn/hao/sứt/mẻ/hao tổn/hao phí/hao hụt|vn
亏输=thua thiệt|vn
交关=quan hệ/gắn với nhau/tương quan/tương liên/rất/vô cùng/cực kỳ/rất đông/rất nhiều|vn
交卸=bàn giao việc quan/giao trách nhiệm cho người khác|vn
交响=giao hưởng/hòa âm|vn
交售=bán cho nhà nước|vn
交活=giao ban|vn
交谪=oán trách nhau/oán hận nhau|vn
交费=đóng tiền|vn
交配=giao phối|vn
他杀=hắn giết/mưu sát/giết người|vn
代偿=thay|vn
代售=bán hộ/bán giùm/bán dùm|vn
代培=huấn luyện thay/dạy thay|vn
仲裁=trọng tài|vn
伐罪=phạt tội/trừng phạt kẻ có tội|vn
休整=chỉnh đốn/nghỉ ngơi và hồi phục/nghỉ ngơi chỉnh đốn/nghỉ dưỡng sức/nghỉ ngơi|vn
优作=Yuusaku|vn
优先=ưu tiên|vn
优化=ưu hóa/ưu hoá/làm cho tốt hơn/tối ưu hóa|vn
优惠=ưu đãi/ân huệ|vn
优游=cuộc sống an nhàn/an nhàn/nhàn rỗi|vn
优育=nuôi dạy tốt/nuôi dạy trong điều kiện tốt|vn
会展=hội triển lãm/triển lãm|vn
会活=sẽ sống|vn
传动=truyền lực/phát/truyền/chuyển giao|vn
传播=truyền bá/truyền/phổ biến/toả/chiếu/phát/công bố/ban hành|vn
传染=truyền nhiễm/lây bệnh/lây truyền/lây/nhiễm|vn
传输=truyền thâu/truyền/chuyển|vn
伤怀=đau buồn/buồn|vn
伤损=thương tổn|vn
体育=thể dục/thể thao/hoạt động thể dục|vn
供应=cung ứng/cung cấp|vn
供电=cung cấp điện/cung cấp năng lượng|vn
供给=cung cấp|vn
供职=đảm nhiệm chức vụ/làm việc|vn
供述=khai|vn
供销=cung tiêu/mua bán|vn
侥幸心理=tâm lý may mắn/tin tưởng vào sự may mắn|vn
侧泳=bơi nghiêng|vn
侵染=xâm nhiễm|vn
修整=tu chỉnh/tu sửa/chăm sóc/bảo dưỡng/sửa chữa|vn
修练=tu luyện|vn
假作=giả vờ|vn
假设=giả thiết/giả như/tỉ như/giả dụ/giả thuyết|vn
健斗=hiếu chiến/hay gây hấn|vn
健步=đi nhanh/đi giỏi/dẻo chân/bước đi|vn
健讼=kiện tụng/thích kiện tụng|vn
偷营=cướp trại/bí mật đánh úp doanh trại địch|vn
储备=dự trữ/chứa/trữ/đồ dự trữ/đồ để dành/trừ bị|vn
储运=dự trữ và vận chuyển|vn
催产=trợ sản/giục sinh/thúc đẻ|vn
催命=đòi mạng/thúc riết/giục riết|vn
免试=miễn thí/miễn thi|vn
免费=miễn phí/không lấy tiền/không mất tiền|vn
全损=toàn tổn|vn
公输=Công Thâu|vn
养殖=nuôi dưỡng/nuôi trồng/nuôi dưỡng và sinh sản|vn
养活=nuôi sống/nuôi dưỡng/phụng dưỡng/chăm sóc/nuôi/sinh đẻ|vn
养育=dưỡng dục/nuôi dưỡng và dạy dỗ|vn
冲关=xông quan/vượt qua ải/vượt cửa ải|vn
冲冲=hừng hực/đùng đùng/hầm hầm/hớn hở/trùng trùng|vn
冲决=phá tung/làm nổ tung/chọc thủng/làm bật tung/làm rách tung/làm vỡ tung/xông/xộc/vọt/nước xói vỡ đê|vn
冲击=xung kích/trùng kích/đánh sâu vào/đập vào/chấn động/đánh/quất/nghiền/giã/thụi/xung phong/bó chặt/làm đau/vặt/ngắt/bóp nghẹt/bóp chết/đánh vào|vn
冲刷=cọ rửa/giội rửa/tẩy/gột/chà sạch/cọ chùi/chà xát/rửa sạch/súc sạch/bào mòn/xói mòn/ăn mòn|vn
冲刺=bắn vọt/nỗ lực/chạy nước rút/bứt lên trước/bứt về đích/lao tới đích/vọt/tuôn trào/phun ra/xông vào|vn
冲动=xúc động/xung động/kích thích/thúc đẩy/phát động/thôi thúc/bị kích thích/bị kích động/khởi động/xung lực/sôi nổi/quá xúc động/kích động|vn
冲压=dập/ép/đập|vn
冲口=thốt ra/buột miệng/nói không suy nghĩ|vn
冲床=bàn dập/máy dập/máy khoan/cái dùi|vn
冲撞=va chạm/đập vào/xông tới/dội vào/va nhau/đụng nhau/xung đột/xúc phạm/chạm/đụng đến/làm ai bực mình/làm ai khó chịu/đụng|vn
冲期=xung kỳ|vn
冲杀=trùng sát/xung phong liều chết/xung phong|vn
冲水=xả nước|vn
冲洗=cọ rửa/súc/rửa/cọ/dội/rũ/tráng/rửa hình/in ảnh/hiện ảnh/giũ/chiêu/tắm rửa|vn
冲流=liên tiếp không ngừng|vn
冲破=xông phá/phá tan/chọc thủng/phá vỡ|vn
冲空=trùng không|vn
冲突=xung đột/mâu thuẫn/va chạm/bất đồng/đụng chạm/xích mích/công kích/tấn công|vn
冲级=tăng cấp|vn
冲荡=vỡ bờ/tràn bờ|vn
冶容诲淫=trang điểm diêm dúa chính là dâm phụ|vn
减产=giảm sản lượng/sản lượng giảm sút|vn
减损=giảm bớt/làm giảm|vn
出产=sản xuất/chế tạo/sản vật/sản phẩm|vn
出口=lối ra/mở miệng/ra miệng/xuất khẩu/ra khỏi miệng/nói/ra cảng/cửa ra/đều theo nghĩa ấy cả/lối ra : mở miệng|vn
出售=bán ra/bán|vn
出游=du lịch/đi chơi|vn
出箭=xuất tiễn|vn
出资=bỏ vốn/xuất vốn/xuất tư|vn
出赛=tham gia thi đấu|vn
分争=phân tranh/tranh luận/bàn cãi/tranh bá|vn
分付=phân phó/dặn đò/bảo ban|vn
分化=phân hoá/phân/tách/làm cho phân hoá/phân chia/phân hóa|vn
分外=hết sức/đặc biệt/ngoài bổn phận/không phải trách nhiệm của minh/ngoài phận sự|vn
分工=phân công|vn
分摊=gánh vác/chịu một phần/chia ra|vn
分期=theo giai đoạn/từng kỳ/trả góp|vn
分析=phân tích|vn
分洪=xẻ nước lũ/phân lũ|vn
分理=quy trình/khâu|vn
分管=phân công quản lý/phân quản|vn
分级=phân cấp|vn
分组=phân tổ/chia tổ/chia nhóm/phân nhóm|vn
分节=phân khúc/phân đoạn|vn
分设=đặt riêng|vn
分配=phân phối/phân/bố trí/phân công|vn
创作=sáng tác/viết/vẽ/soạn/thảo/hư cấu/tác phẩm/vật được sáng tạo|vn
创设=sáng lập/sáng tạo/tạo nên/tạo ra/hoạt hoá/tạo điều kiện/làm cho hoạt động/đặt ra|vn
初试=sơ thí/thi vòng đầu/thí nghiệm lần đầu/vòng sơ khảo/thi vòng sơ khảo/thi vòng loại|vn
判罚=xử phạt|vn
判罪=kết tội/xử tội|vn
刮痧=cạo gió/đánh gió|vn
制作=chế tác/chế tạo/chế ra/làm ra/luyện chế|vn
制革=xử lý da|vn
剖析=phân tích/mổ xẻ|vn
剪切=chia cắt/chia ra|vn
劝戒=khuyên răn/khuyên nhủ/khuyên giải|vn
办罪=xử tội/định tội/trị tội/trừng phạt|vn
加工=gia công/chế biến/công việc hoàn chỉnh sản phẩm|vn
加急=khẩn cấp/kịch liệt/gấp|vn
加试=cuộc thi bổ sung|vn
加赛=đấu thêm/gasay/một trận play-off|vn
助产=đỡ đẻ|vn
助推=nâng lên/đưa lên/đẩy mạnh|vn
助攻=trợ công/đánh giúp|vn
助理=trợ lý/giúp việc/phụ tá|vn
劫动=kiếp động|vn
劫营=tập kích doanh trại địch/đánh úp trại địch|vn
劳作=lao động/làm việc tay chân/môn thủ công/làm việc/làm lụng|vn
劳保=bảo hiểm lao động/bảo hộ lao động|vn
劳务=lao động/lao vụ/dịch vụ|vn
劳动=lao động/việc/công việc/lao động chân tay/lao động thủ công/làm/làm việc/phiền/cảm phiền/làm phiền|vn
劳工=lao công/công nhân/thợ/nhân công/thợ thuyền/phu/người bị bắt đi phu|vn
劳损=vất vả mà sinh bệnh|vn
劳改=lao động cải tạo/cải tạo lao động/lao cải|vn
劳易=Lao Dịch|vn
劳步=vất vả tới thăm|vn
劳累=mệt nhọc/cực khổ/cực nhọc/kiệt sức/phiền/cảm phiền/nhờ/làm phiền|vn
劳资=lão tử/mệt sức/chủ và thợ|vn
勘探=khảo sát/trinh sát/do thám/thăm dò|vn
勘查=điều tra|vn
勘测=thăm dò/đo đạc/trắc địa/khám xét|vn
勘误=sửa lỗi in/đính chính/hiệu đính/sửa lỗi|vn
勘验=khám nghiệm/khảo sát/kiểm tra|vn
匆忙之间=trong lòng vội vàng/trong lúc vội vàng|vn
匹练=tấm lụa/thất luyện/dải lụa|vn
升斗=thăng đấu|vn
升空=lên không/bay lên không|vn
升级=thăng cấp/lên cấp/leo thang|vn
协作=hợp tác/hiệp tác|vn
协查=hiệp tra|vn
南斗=Nam Đẩu|vn
印出来=in ra|vn
印刷=in ấn/ấn loát/in|vn
印染=in nhuộm|vn
压破=ép phá|vn
厘清=làm rõ|vn
反动=phản động/phản tác dụng/tác dụng trái ngược nhau|vn
反响=tiếng vọng/âm hưởng/phản ứng/tiếng vang/tiếng dội lại/gây tiếng vang/gây xôn xao/phản hưởng|vn
反应=phản ứng/phản ứng hoá học/phản ứng thuốc/tác dụng phụ/hiệu quả|vn
反推=đẩy ngược|vn
反攻=phản công|vn
反易=điên đảo|vn
反演=đảo ngược/lộn ngược|vn
反潜=chống tàu ngầm|vn
反贪=phản tham|vn
反锁=khóa trái/khoá trái|vn
发丧=phát tang/báo tin buồn/việc tang/lo liệu việc tang/làm tang ma|vn
发付=giao cho/sai/sai bảo/sai khiến|vn
发作=phát tác/phát ra/lên cơn/phát cáu/nổi giận/tức giận|vn
发信=gửi thư/gửi thư tín|vn
发冷=rét run/lạnh run/phát lãnh|vn
发动=phát động/bắt đầu/làm cho chuyển động/khởi động|vn
发售=đem bán/bán/bán ra/nhượng lại|vn
发型=kiểu tóc/phát hình|vn
发外=toát ra|vn
发奖=phát thưởng|vn
发展=phát triển/mở rộng/khuếch trương|vn
发急=gấp quá/sốt ruột/lo/lo lắng/cuống lên|vn
发报=phát tin/liên lạc bằng điện báo/truyền tín hiệu/phát tín hiệu|vn
发排=đem in/đưa bản thảo cho nhà in sắp chữ/đưa nhà in in/đưa đi in|vn
发电=phát điện/đánh điện báo/đánh điện tín|vn
发痧=say nắng/trúng nắng|vn
发福=mập ra/phát tướng/phát phúc|vn
发笑=bật cười/cười/buồn cười/tức cười/mắc cười|vn
发给=phát cho/chia/phát/phân phát/cấp phát|vn
发育=phát dục/dậy thì/trưởng thành/trổ mã|vn
发蒙=không rõ/mù tịt/hồ đồ/lơ mơ/vỡ lòng/dạy vỡ lòng/phát mông|vn
发规=phát quy|vn
发运=chuyển đi/vận chuyển|vn
发配=sung quân/đi đày/đày đi|vn
发野=ngang ngược|vn
发青=phát xanh/phát thanh/xanh lên|vn
变价=đổi giá bán/định lại giá|vn
变位=đổi vị trí/đổi chỗ/đá dịch chuyển|vn
变冷=trở nên lạnh|vn
变动=biến động/thay đổi/biến đổi/suy suyển/sửa đổi|vn
变化=biến hóa/biến hoá/biến đổi/thay đổi|vn
变压=biến áp/thay đổi áp suất/thay đổi áp lực/thay đổi áp suất không khí|vn
变型=biến hình/biến thể|vn
变易=biến dời/biến đổi/biến hoá|vn
变法=biến pháp/cải cách chính trị|vn
变焦=biến cháy|vn
变老=già đi|vn
变节=phản bội/thay đổi lập trường/không giữ khí tiết/khuất phục kẻ thù/bội giáo/bỏ đảng/bội phản/phụ bạc|vn
变诈=đánh lừa/lừa dối/lừa bịp|vn
变迁=biến thiên/dời đổi/đổi dời/biến dời/đổi thay/biến đổi|vn
变通=biến báo/biến thông|vn
变量=lượng biến đổi/đại lượng biến thiên|vn
变青=biến xanh|vn
变革=biến đổi/biến cách/thay đổi/cải cách|vn
变频=đổi tần số/thay đổi tần số|vn
口惠=hứa suông/chỉ nói miệng/ân huệ đầu môi chót lưỡi|vn
口试=thi miệng/thi vấn đáp|vn
合一=hợp nhất/kết hợp/phối hợp|vn
合作=hợp tác|vn
合击=hợp kích/cùng đánh/cùng tấn công/đánh hội đồng (hợp kích)|vn
合法化=hợp pháp hóa|vn
合演=hợp diễn/cùng biểu diễn/cùng diễn/diễn chung|vn
合理=hợp lý/có lý|vn
合营=hợp doanh/kết hợp kinh doanh/hùn hạp|vn
合计=tổng cộng/bàn bạc/hợp kế/cộng lại/tính gộp lại/[hé·ji]/tính toán/lo toan/dự kiến/trù tính/lo/thương lượng/thảo luận|vn
合资=hùn vốn/góp vốn/hợp doanh/hợp tư|vn
后传=hậu truyện|vn
后排=hàng sau/xếp sau/đứng sau|vn
后育=sinh ra sau này|vn
启动=khởi động/mở/chạy/bắt đầu công việc|vn
吹响=thổi lên/quạt lên|vn
咨嗟=Tư ta/than thở|vn
咨询=tư vấn/trưng cầu ý kiến/cố vấn/trưng cầu/tư tuân|vn
品嚐=đánh giá|vn
哄传=râm ran/náo động/xôn xao/nhốn nháo/truyền khắp chốn|vn
哄动=náo động/xôn xao/nhốn nháo/vang động|vn
哪些地方=những địa phương nào|vn
哪年哪月=năm nào tháng nào|vn
嗡嗡作响=ông ông tác hưởng/vang lên ong ong|vn
嗡嗡响=vang ong ong|vn
嚎啕大哭=gào khóc/khóc thét|vn
嚐试=nếm thử/尝试|vn
回响=tiếng vọng/tiếng vọng lại/tiếng vang/hưởng ứng/đáp lại/vọng về/vang vọng|vn
回环=quanh co/vòng vèo/uốn khúc|vn
回输=chuyển trở về/trả về/trả lại|vn
国丧=quốc tang|vn
国资=quốc tư|vn
国骂=quốc mạ|vn
圈外=ngoài vòng tròn/ngoài vòng|vn
在响=đang vang lên|vn
在播=tại phát|vn
在擦=đang sát/đang lau|vn
在练=đang luyện|vn
垦殖=khai khẩn/vỡ hoang/khai hoang sản xuất|vn
培修=bồi thêm/đắp thêm|vn
培育=bồi dưỡng/đào tạo/bồi đắp/chăm chút/gây trồng|vn
培训=huấn luyện/đào tạo/học bổ túc|vn
备查=để làm rõ/để điều tra/để tham khảo về sau/để điều tra|vn
复古=phục cổ|vn
复查=phúc tra/kiểm tra lại|vn
复活=phục sinh/sống lại/hoạt động trở lại/làm cho sống lại|vn
复赛=đấu bán kết/thi đấu bán kết|vn
多元化=đa nguyên hoá/đa dạng hóa/Đa dạng hóa, đa dạng|vn
多管=quản nhiều/nhiều nòng|vn
多费=tốn nhiều|vn
大展=đại triển|vn
失利=thất bại/thất lợi/không thành công/bất lợi/chiến bại|vn
失口=lỡ lời/buột miệng/lỡ miệng|vn
失控=mất khống chế/không khống chế được|vn
失盗=mất cướp/mất trộm|vn
失节=thất tiết/mất khí tiết/mất trinh|vn
奔突=xông xáo/chạy băng băng|vn
奖励=ban thưởng/thưởng cho/khen thưởng/khuyến khích/khuyến thưởng/tưởng thưởng|vn
奖罚=thưởng phạt|vn
女傧相=nữ phù dâu|vn
奸淫掳掠=gian dâm cướp bóc|vn
姿意妄为=cẩu thả/bất cẩn|vn
威吓=đe dọa/hăm dọa/dọa dẫm/đe doạ/hăm doạ/doạ dẫm|vn
威慑=uy hiếp/đe doạ bằng vũ lực|vn
威胁=uy hiếp/đe doạ/doạ dẫm|vn
威迫=cưỡng bức/đe doạ|vn
娱乐=giải trí/tiêu khiển/vui chơi giải trí/trò vui/trò chơi|vn
婚配=hôn phối/kết hôn/lập gia đình/thành gia thất|vn
存查=tài liệu tham khảo/bảo lưu/lưu công văn để xét|vn
存活=sống sót/còn sống/sinh tồn/trữ hàng/tồn tại|vn
孵育=nở/ấp|vn
宏伟蓝图=hoành vĩ lam đồ|vn
定作=định làm/định ...|vn
定命=định mệnh/số phận/xu thế tất yếu|vn
定期=định kỳ/thường lệ/định ngày/định thời gian/theo kỳ hạn|vn
定理=định lý|vn
定罪=định tội/khép tội/buộc tội|vn
定规=quy chế/quy định/nhất định/chắc chắn/định quy|vn
定计=lập kế hoạch/lập kế/lên kế hoạch/suy tính|vn
定陶=Định Đào|vn
实体化=thực thể hóa|vn
实惠=lợi ích thực tế/thực dụng/lợi ích thiết thực|vn
实验=thí nghiệm/thực nghiệm/công việc thực nghiệm|vn
审判=thẩm phán/ thẩm lí và phán quyết/thẩm lí và phán quyết/xét xử|vn
审查=thẩm tra/xem xét/xét duyệt|vn
审理=thẩm tra xử lí/thẩm lý|vn
审美=thẩm mỹ/khiếu thẩm mỹ|vn
宣传=tuyên truyền|vn
宣判=tuyên án/tuyên bố|vn
宣化=Tuyên Hoá|vn
宽展=thanh thản/thư thái/thư thản/rộng rãi/rộng lớn/giàu có/dư dả/sung túc|vn
寄售=gửi bán/gửi bán/ký gửi|vn
对付=đối phó/ứng phó/tạm/tạm bợ/hợp nhau/hợp|vn
对口=cùng một/nhọt gáy/nhọt ở gáy/đối đáp/cùng/hợp khẩu vị/đối khẩu|vn
对工=hợp/phù hợp/thích hợp/thoả đáng/đối công|vn
对应=đối ứng/tương ứng/phù hợp|vn
对撞=đụng nhau/va chạm|vn
对攻=đối công/tấn công|vn
对杀=giết nhau|vn
对焦=điều chỉnh tiêu điểm/đối tiêu|vn
对练=đối luyện|vn
对联=câu đối liễn/câu đối/đôi liễn|vn
射出来=bắn ra|vn
射击=xạ kích/bắn/môn xạ kích|vn
射发=bắn đi|vn
射杀=bắn giết/bắn chết|vn
射电=sóng ra-đi-ô|vn
将功抵罪=lấy công chuộc tội|vn
小厨房=phòng bếp nhỏ/nhà bếp nhỏ|vn
尝试=nếm thử/thử/thử nghiệm|vn
尝鲜=nếm thức ăn tươi/ăn thực phẩm tươi/nếm món ăn|vn
尧天舜日=ngày Nghiêu tháng Thuấn|vn
展播=phát thanh|vn
展期=kéo dài thời hạn/gia hạn/thời hạn triển lãm/thời gian triển lãm/triển kì/khoan cho thêm hẹn nữa|vn
展老=Triển lão|vn
屠杀=đồ sát/tàn sát/giết hàng loạt/giết hại/tru diệt|vn
屠空=Đồ Không|vn
巡查=tuần tra/tuần sát|vn
工业化=công nghiệp hoá|vn
工休=nghỉ/ngày nghỉ/ngày không làm việc/nghỉ ngơi/nghỉ giải lao|vn
工作=làm việc/công việc/công tác/việc làm/việc|vn
工整=tinh tế/cẩn thận/ngay ngắn/nắn nót|vn
工期=kỳ hạn công trình/thời hạn công trình/công kỳ|vn
工读=vừa làm vừa học/trường giáo dưỡng|vn
工资=tiền lương/lương|vn
巨响=tiếng vang/nổ mạnh/nổ/nổ vang|vn
常设=thường trực|vn
平展=bằng phẳng rộng rãi/mênh mông bằng phẳng/bằng phẳng|vn
广播=phát thanh/truyền phát/quảng bá|vn
应付=ứng phó/đối phó/qua loa/có tính chất đối phó/tạm/tàm tạm|vn
应口=ứng khẩu/nói được làm được/lời nói đi đôi với việc làm|vn
应急=khẩn cấp/ứng phó nhu cầu bức thiết/khẫn cấp/đáp ứng nhu cầu bức thiết/ứng cho|vn
应试=dự thi|vn
应输=ứng thua|vn
应验=ứng nghiệm/linh nghiệm|vn
废弛=buông thả/lỏng lẻo/không được chấp hành|vn
建修=thi công/xây dựng|vn
建古=kiến cổ|vn
建工=kiến công|vn
建环=kiến hoàn|vn
建设=kiến thiết/xây dựng/xây cất/lập nên|vn
开赛=bắt đầu thi đấu/bắt đầu cuộc thi/bắt đầu/mở cuộc tranh tài|vn
开门揖盗=cõng rắn cắn gà nhà/rước voi về giày mả tổ|vn
强推=đẩy mạnh/bầu cử top|vn
强突=cường đột|vn
归化=quy thuận/quy phục và chịu giáo hoá/phục tùng/quy hóa|vn
归口=quy về/trở về ngành nghề của mình/trở về ngành cũ/làm lại nghề cũ/quay về nghề cũ|vn
归整=chỉnh lý/sắp xếp/thu dọn|vn
归期=ngày về/ngày quay lại|vn
归类=phân loại/xếp loại|vn
归罪=quy tội/đổ tội/đổ lỗi|vn
录播=ghi âm|vn
形同陌路=mỗi người một ngả/hình đồng mạch lộ/như người dưng nước lã|vn
影像=hình ảnh/vẽ tranh/chân dung/hình tượng/hình bóng/hình phóng/hình chiếu|vn
影刺=Ảnh Thứ|vn
影印=sao chụp/photocopy/in chụp|vn
影响=ảnh hưởng/bị ảnh hưởng/chịu ảnh hưởng/vô căn cứ/đồn đại|vn
影射=ám chỉ/ánh xạ/nói bóng gió nói xa nói gần/ảnh xạ|vn
影展=triển lãm ảnh/triển lãm điện ảnh|vn
影杀=Ảnh Sát|vn
影步=ảnh bộ|vn
影老=Ảnh lão|vn
影评=bình luận điện ảnh/bình luận phim|vn
影踪=tăm hơi|vn
影迷=mê điện ảnh/cây xinê|vn
影集=tập ảnh/an-bom|vn
彻响=vang vọng|vn
彻查=tra rõ/điều tra kỹ|vn
征询=trưng cầu/hỏi ý|vn
待查=đợi điều tra|vn
御膳房=ngự thiện phòng|vn
循序=tuần tự/theo thứ tự|vn
循法=tuần pháp/noi theo phép|vn
循环=tuần hoàn|vn
循理=tuần lý/noi lẽ|vn
循行=tuần hành/đi tuần|vn
循问=hỏi thăm|vn
微动=khẽ nhúc nhích|vn
微响=lay động|vn
微控=vi khống|vn
微核=vi hạch|vn
微笑=mỉm cười/tươi vui/cười mỉm/cười tủm tỉm/cười nụ/cười chúm chím|vn
微缩=thu nhỏ lại/hơi co lại|vn
微罪=vi tội/tội nhỏ|vn
微醉=hơi say|vn
微锁=nhíu lại|vn
必输=tất thua/nhất định thua/phải thua|vn
忌口=ăn kiêng/kỵ khẩu|vn
快攻=khoái công/công nhanh|vn
怫然作色=đỏ mặt tía tai|vn
恢宏大度=hào phóng|vn
恢廓大度=khoan dung độ lượng|vn
恫吓=đe doạ/hăm doạ/doạ dẫm|vn
恫喝=quát nạt/quát mắng/Ðỗng hát/dọa nạt|vn
悸动=rung động/quý động|vn
悸心=sợ hãi|vn
悸震=kinh hoàng|vn
悸颤=sợ phát run|vn
惩戒=trừng trị/khiển trách/phạt cảnh cáo/uốn nắn/quở trách/trừng phạt|vn
惩罚=trừng phạt/nghiêm phạt/nghiêm trị/nghiêm khắc trừng trị/nghiêm khắc trừng phạt|vn
愉悦感=cảm giác vui thích/cảm giác vui vẻ|vn
感喟=than thở/thở than|vn
感胁=cảm hiếp|vn
慇勤=Ân cần/ân cần|vn
战修=chiến tu|vn
战损=chiến tổn|vn
战斗=chiến đấu/đấu tranh|vn
扎营=hạ trại/đóng/đóng quân/cắm trại/đồn quân/đóng trại|vn
打响=khai hỏa/phát hoả/nổ súng/bắn/thành công|vn
打夯=đầm/dầm/nện|vn
托付给=giao phó cho/giao cho|vn
执一=chấp nhất/cứng nhắc/chuyên nhất/một lòng/dốc lòng|vn
执勤=phiên trực/làm nhiệm vụ/thi hành nhiệm vụ/chấp cần|vn
扰动=nhiễu loạn/lộn xộn/náo động/nhiễu động|vn
批斗=công khai xử lý tội lỗi|vn
投产=đầu tư/đi vào sản xuất/đưa vào sản xuất|vn
投保=mua bảo hiểm/làm thủ tục bảo hiểm|vn
投合=hợp nhau/ăn ý/hợp ý/hợp/phù hợp|vn
投怀=đầu hoài|vn
投敌=đầu hàng địch/đi theo địch/đi theo giặc/chạy sang hàng ngũ địch|vn
投毒=đầu độc|vn
投资=đầu tư/bỏ vốn/đầu tư vốn/vốn đầu tư/tiền bỏ ra/tiền vốn|vn
投递=đưa/gửi/phát|vn
抖震=run lẩy bẩy|vn
抗击=chống lại/đánh lại/chống trả|vn
抗捐=chống nộp thuế|vn
抗撞=khả năng chống va chạm|vn
抗旱=chống hạn|vn
抗洪=chống lũ/chống lụt|vn
抗灾=chống thiên tai/phòng chống thiên tai|vn
抗疫=kháng dịch/chống dịch/Chống dịch|vn
抛费=lãng phí/hao phí/làm hư hại|vn
抵债=gán nợ/trả nợ/trừ nợ|vn
抵偿=đền/đền bù/bồi thường|vn
抵命=đền mạng|vn
抵抗=chống cự/chống lại/đề kháng/để kháng/chống cự lại|vn
抵押=thế chấp/mượn nợ/cầm/đợ/gán/cầm cố/để áp/ngang giá/thế chân/đặt cọc|vn
抵罪=đền tội/để tội/đáng tội|vn
拘挛=sài kinh/co rút/khó co duỗi/chân tay co quắp lại/câu nệ/cố chấp|vn
招展=phấp phới/lung lay/dao động/đung đưa|vn
拨云撩雨=thăm dò đối phương|vn
拼拼凑凑=chắp vá|vn
拽起来=kéo dậy|vn
指控=lên án/tố cáo/chỉ trích và tố cáo|vn
指环=chiếc nhẫn/chỉ hoàn/nhẫn|vn
按动=nhấn|vn
按响=ấn vang|vn
按揭=án yết|vn
按理=theo lý/lẽ ra/thông thường/như thường lệ|vn
按练=tuần tra huấn luyện|vn
挑一=chọn một|vn
挑出来=lựa đi ra|vn
挑刺=trêu chọc|vn
挑动=kích động/gây xích mích/gây chia rẽ/khiêu khích/thiêu động|vn
挑口=kén cá chọn canh|vn
挑战=khiêu chiến/gây chiến/thách/thách thức/thách đấu|vn
挑水=gánh nước/nấu nước|vn
振作=tỉnh lại/phấn khởi/phấn chấn|vn
振动=chấn động/dao động/rung động|vn
捱到=chịu đựng được đến/kéo dài đến/cầm cự đến|vn
排查=loại bỏ/bài tra/điều tra|vn
排练=tập luyện/tập diễn/bài luyện|vn
探析=bàn thảo/nghiên cứu thảo luận và phân tích|vn
探查=dò xét/tra xét|vn
探究=tìm tòi nghiên cứu/tìm tòi tra cứu/tham cứu|vn
探询=điều tra/hỏi han/thăm hỏi/dò hỏi/thăm dò|vn
推究=tìm hiểu và kiểm tra/suy cứu|vn
掩日=yểm nhật|vn
掼跤=ngã/ngã nhào|vn
提督=Đô đốc/Đề đốc|vn
插播=sáp bá/phát sóng/để làm gián đoạn|vn
援交=viện giao|vn
援兵=viện binh/quân cứu viện/viện quân|vn
援助=viện trợ/giúp đỡ/cứu trợ/chi viện/trợ giúp|vn
援外=viện trợ nước ngoài/chi viện nước ngoài|vn
援引=dẫn ra/dẫn/đưa ra/đề cử/giới thiệu/tiến cử/bổ nhiệm|vn
援护=viện hộ|vn
援用=dẫn ra/dẫn/đề cử/bổ nhiệm/tiến cử/giới thiệu|vn
搌布=khăn lau/giẻ lau/vải lau|vn
搏斗=vật lộn/bác đấu/đã đấu/đọ sức/vật/đè/đánh xáp lá cà/tranh đấu kịch liệt/trận chiến/đấu tranh/tranh đấu|vn
搜查=điều tra/lục soát/tra khám/kiểm soát|vn
摀住=bịt|vn
摆迷魂阵=bỏ bùa mê/bỏ bùa|vn
摔跤手=tay đấu vật/đô vật|vn
摩擦=ma sát/ma/cọ xát/mài/xung đột|vn
撤营=dỡ trại|vn
撤资=rút vốn|vn
支气管=nhánh khí quản/cuống phổi/phế quản|vn
支配=chi phối/an bài/sắp xếp/sắp đặt/điều khiển/khống chế|vn
改产=thay đổi sản xuất|vn
改判=sửa án/sửa đổi bản án|vn
改动=cải biến/đổi/sửa đổi/thay đổi|vn
改口=đổi giọng/chữa lại/đổi/đổi cách xưng hô/đổi lời nói|vn
改型=cải tạo|vn
改日=ngày khác/hôm khác|vn
改易=sửa/sửa chữa|vn
改期=đổi ngày/hoãn lại/thay đổi thời hạn|vn
改线=đổi đường dây/đổi tuyến|vn
改组=cải tổ/tổ chức lại|vn
改节=cải tiết|vn
改革=cải cách/cải tiến/đổi mới/cách tân|vn
攻坚=công thành/công kiên/công đồn/hạ lô-cốt/giải quyết vấn đề khó khăn nhất/công kích|vn
攻讦=công kích/đả kích/công kích sai lầm của người khác|vn
救助=cứu trợ/cứu giúp|vn
救命=cứu mạng/người cứu mạng/ân nhân cứu mạng|vn
救应=tiếp ứng/ứng cứu/tăng cường/gia cố|vn
救急=cứu cấp/cấp cứu|vn
救援=cứu viện/cứu giúp/viện trợ/giúp đỡ|vn
救活=cứu sống|vn
救灾=cứu tế/uỷ lạo/cứu trợ/cứu nạn|vn
教习=giáo tập/giáo viên|vn
教化=giáo hóa/giáo hoá/giáo dục cảm hoá|vn
教工=nhân viên trường học/nhân viên nhà trường/giáo viên|vn
教管=giáo quản/giáo dục, quản lý/quản lý giáo dục|vn
教练=huấn luyện viên/giáo luyện/huấn luyện|vn
教给=dạy cho|vn
教育=giáo dục/đào tạo/dạy dỗ/dạy bảo/chỉ dẫn/chỉ thị/dạy|vn
教范=tài liệu giảng dạy cơ bản/giáo án|vn
教训=giáo huấn/dạy bảo/dạy dỗ/bài học kinh nghiệm|vn
散播=tản/lan ra/rắc/rải/tung ra/gieo rắc/tán bá|vn
整整=ròng rã/chỉnh một chút/suốt/tròn/trọn/đằng đẳng/sơ sơ|vn
整训=chỉnh huấn/chỉnh đốn và huấn luyện|vn
敷衍搪塞=trình bày qua loa|vn
斗乱=bay tán loạn|vn
斗争=đấu tranh/tranh đấu/đấu/đấu nhau/phấn đấu|vn
斗剑=đấu kiếm|vn
斗口=tranh cãi/cãi nhau/cãi cọ|vn
斗尊=Đấu Tôn|vn
斗杀=đánh giết/người bị đánh chết/thiệt mạng do đánh nhau|vn
斗法=đấu pháp/ngầm đấu đá|vn
斗火=đấu hỏa|vn
斗皇=Đấu Hoàng|vn
斗破=đấu phá|vn
斗米=đấu gạo|vn
斗转=đấu chuyển|vn
斗量=đo bằng đấu/đấu lượng|vn
施展=thi triển/phát huy/thi thố/triển khai|vn
施工=thi công|vn
施法=thi pháp/làm phép|vn
旅游=du lịch/du ngoạn|vn
旅行=lữ hành/du lịch|vn
旅费=lộ phí/phí tổn trên đường đi|vn
无所遁形=không chỗ che thân|vn
早睡早起=ngủ sớm dậy sớm|vn
时间跨度=khoảng cách thời gian/khoảng thời gian|vn
春播=vụ xuân/gieo trồng vụ xuân|vn
普查=tổng điều tra/điều tra rộng khắp/thăm dò rộng khắp|vn
暗斗=ám đấu|vn
暗潜=ám tiềm|vn
暗练=thuần thục|vn
暴突=nổi lên|vn
有偿=có thù lao/có giá|vn
有关=có quan hệ/hữu quan/có liên quan/liên quan đến/đề cập đến|vn
有损=có hại/bị hư hỏng|vn
有染=cấu kết|vn
有理=có lý/hữu lý/để ý tới|vn
有空=có rảnh/lúc rảnh rỗi/có không|vn
有罪=có tội|vn
有误=có sai/có sai lầm/sai lầm|vn
朊病毒=bệnh Prion/prion|vn
服丧=để tang/tang phục/đồ tang|vn
服务=phục vụ/phụng sự/service|vn
服毒=uống thuốc độc|vn
服法=tuân thủ pháp luật|vn
服用=phục dụng/dùng|vn
服罪=nhận tội/chịu tội|vn
服老=chịu già/thừa nhận mình già|vn
服装=trang phục/đồng phục|vn
服输=chịu thua/thừa nhận thất bại|vn
服辩=thư nhận lۗi/thư nhận lỗi/thư xin lỗi|vn
机修=duy tu/bảo dưỡng/sửa phi cơ|vn
杂活=việc vặt|vn
杂谈=tạp đàm|vn
束缚=trói buộc/ràng buộc/gò bó|vn
松弛下来=lỏng xuống|vn
枪响=súng vang lên/tiếng súng|vn
架设=bắc/mắc khung/mắc/nối/giá thiết|vn
某件事=chuyện nào đó|vn
某大学=đại học nào đó|vn
标准化=chuẩn hoá/tiêu chuẩn hoá|vn
标售=giá bán|vn
标配=tiêu chuẩn phân phối/tiêu chuẩn thấp nhất/tiêu phối|vn
核查=kiểm tra đối chiếu sự thật/thẩm tra/tra xét/hạch tra|vn
核资=thẩm định/thẩm tra/kiểm tra tài sản/kiểm tra vốn|vn
根深柢固=thâm căn cố đế/gốc sâu và cố định|vn
栽判=trọng tài|vn
栽培=tài bồi/vun trồng/vun xới/vun bón/bồi dưỡng/đào tạo/cất nhắc/đề bạt/Tài bồi|vn
栽种=trồng/gieo/trồng trọt|vn
栽花=trồng hoa|vn
栽赃=vu oan/đổ tội/vu cáo/gài tang vật|vn
械斗=giới đấu/dùng binh khí đánh nhau/nhiều người đánh nhau bằng khí giới|vn
检修=kiểm tra tu sửa/kiểm tu/kiểm tra/tu sửa/đại tu|vn
检察=kiểm sát/kiểm soát|vn
检束=kiểm tra việc giữ nội quy|vn
检查=kiểm tra/kiểm soát/khám/tra cứu/tìm/tra xét/điều tra/kiểm thảo/kiểm điểm|vn
检核=kiểm hạch|vn
检测=kiểm trắc/kiểm tra đo lường/đo lường|vn
检疫=kiểm dịch|vn
检索=kiểm tra|vn
检验=kiểm nghiệm/kiểm tra|vn
欺老=lấn già|vn
欺诈=lừa gạt/bịp bợm/lừa dối/đánh lừa|vn
武曌=Võ Chiếu|vn
残响=tàn hưởng|vn
比作=so sánh/ví|vn
比试=so tài/tỷ thí/thi/làm động tác/tư thế|vn
比赛=tranh tài/trận đấu/bỉ tái/thi đấu/đấu|vn
比配=tương xứng/hợp/xứng hợp|vn
汇展=triển lãm|vn
汇演=hội diễn|vn
污损=nhiễm bẩn|vn
污染=ô nhiễm/làm bẩn/nhiễm bẩn/sự ô nhiễm|vn
污蔑=nói xấu/vu oan/vu tội/làm bẩn/vấy bẩn/bêu xấu|vn
污血=máu đen|vn
沉凝=trầm ngưng/ứ/tù đọng/trì trệ/uể oải/chậm chạp/lờ đờ/tù/đọng|vn
沉潜=chìm lặn|vn
沤肥=ủ phân|vn
沿街乞讨=ăn xin dọc đường|vn
泄口=phát tiết|vn
波动=ba động/chấn động/chập chờn/không ổn định/sóng/gợn sóng|vn
波导=dẫn sóng|vn
波折=khó khăn trắc trở/khúc chiết/trắc trở/khó khăn/vấp váp/bước ngoặt/thăng trầm/ba chiết|vn
波束=chùm sóng /chùm sóng|vn
波流=luồng sóng|vn
波荡=chập trùng/dập dờn bồng bềnh/sóng cồn/gợn/dập dờn/dập dềnh/bềnh bồng/trập trùng/chập chùng/sóng gợn|vn
活像=rất giống/giống hệt/giống nhau/giống như|vn
活剑=Hoạt Kiếm|vn
活动=hoạt động/chuyển động/vận động/theo mục đích/vì mục đích nào đó/hành động có mục đích/lay động/lung lay/không ổn định/đung đưa/lắc lư/linh hoạt/di động/không cố định/sinh hoạt/chạy chọt/đút lót/mua chuộc|vn
活化=hoạt hoá/làm tăng hoạt tính/kích hoạt|vn
活口=người sống/nhân chứng sống/tù binh/tội phạm|vn
活命=mạng sống/sống/để sống/cứu sống/cứu mạng/sống sót|vn
活埋=chôn sống|vn
活塞=pít-tông/píttông|vn
活期=không kỳ hạn/không định kỳ/vô kỳ hạn/vô định kỳ|vn
活水=nước chảy/nước thông|vn
活法=cách sống|vn
活活=tươi sống/tươi/sống/đang sống/giống như/y như|vn
活络=linh hoạt/lung lay/rơ/linh lợi/ỡm ờ/hoạt lạc|vn
活罪=tội sống/khốn khổ/mang vạ/bị tai vạ/khổ thân|vn
活血=lưu thông máu/hoạt huyết|vn
活计=công việc/hoạt kế/việc/sản phẩm|vn
活话=lời hứa tạm/nhắn lại/lời nhắn/dặn lời/lời hứa chưa dứt khoát|vn
活跃=sinh động/phát triển/sôi nổi/hoạt động mạnh/sục sôi/làm sôi nổi/thúc đẩy/đẩy mạnh/sống động/phát triển mạnh|vn
流产=sinh non/đẻ non/sinh thiếu tháng/sinh non|vn
流传=lưu truyền/truyền lưu/truyền đi|vn
流动=lưu động/chảy/di động/không cố định|vn
流往=đổ/chảy/truyền/rơi - vào/đến/tới|vn
流播=lưu truyền/truyền tụng/chuyển đổi/chuyển sang|vn
流通=lưu thông/thoáng/không bí|vn
流配=đi đày|vn
测报=dự báo/quan sát và dự báo|vn
测探=thăm dò/suy đoán/tìm hiểu/dò hỏi/đo lường thăm dò|vn
测控=quan sát, đo lường và điều khiển/quan trắc và điều khiển|vn
测算=đo lường tính toán/trắc toán|vn
测绘=đo vẽ bản đồ|vn
测试=khảo thí/trắc thí/kiểm tra/trắc nghiệm/khảo nghiệm|vn
测量=đo đạc/trắc lượng/trắc địa/đo lường/đo|vn
测验=trắc nghiệm/kiểm nghiệm/đo lường/thăm dò/kiểm tra/sát hạch|vn
浮动=lưu động/di động/lững lờ/trôi lơ lửng trên mặt nước/không ổn định/phấp phỏng/thấp thỏm/hoang mang/phù động|vn
浮步=phù bộ|vn
浮游=phù du/bơi/bơi lội/du ngoạn/rong chơi|vn
浮潜=lặn với ống thở|vn
海损=tổn thất/thiệt hại/tổn hại|vn
消化=tiêu hóa/tiêu hoá/tiêu tan vật chất hóa ra chất khác|vn
消损=giảm dần/tiêu hao|vn
消毒=trừ độc/tiêu độc/khử trùng/trừ bỏ độc hại|vn
消灾=tiêu tai|vn
消费=tiêu phí/chi phí/tiêu dùng|vn
消逝=tan biến/nhạt nhòa/biến mất/mất hẳn/nhạt nhoà|vn
消闲=giết thì giờ|vn
涉讼=liên quan đến kiện tụng|vn
液休=dạng dịch|vn
液化=hoá lỏng/biến thành chất lỏng|vn
淬体期=Tôi Thể Kỳ|vn
淬厉=sắc bén|vn
淬洗=tôi luyện|vn
淬火=tôi vào nước lạnh/ngâm/dìm/dập tắt/tôi/tôi thép/nhúng vào nước lạnh|vn
淬砺=tôi luyện/tôi|vn
淬练=tôi luyện|vn
混作=trồng xen/trồng lẫn|vn
混合=hỗn hợp/trộn/nhào/phối hợp/hoà vào nhau/pha trộn|vn
混战=hỗn chiến/trận hỗn chiến/giao chiến/đánh nhau lộn xộn|vn
清偿=bồi thường toàn bộ|vn
清化=Thanh Hoá/tỉnh Thanh Hoá|vn
清析=rõ nét|vn
清查=thanh tra/kiểm tra|vn
清营=Thanh Doanh|vn
清蒸=hấp/chưng|vn
渎职=không làm tròn trách nhiệm/không làm tròn nhiệm vụ/độc chức|vn
游击=du kích/chiến sĩ du kích|vn
游动=du động/bơi lội|vn
游斗=du đấu/du đấu (hit and run)|vn
游泳=bơi lội/bơi|vn
游览=du lãm/du lịch/đi chơi/dạo chơi|vn
游资=vốn lưu động/vốn nổi|vn
滑动=hoạt động/sự trượt/độ trượt/chuyển động trượt/trượt|vn
滑步=hoạt bộ/bước lướt|vn
满脸堆笑=cười rạng rỡ|vn
演出服=áo quần diễn xuất|vn
演播=diễn bá/phát sóng/hiệu suất phát sóng|vn
演练=diễn luyện|vn
漫展=triển lãm Anime|vn
漫步=dạo bước/bước chậm/đi dạo/dạo chơi|vn
漫游=dạo chơi/ngao du/đi chơi|vn
漫谈=mạn đàm|vn
灌口=miệng vòi|vn
灌溉=tưới tiêu/tưới/dẫn nước tưới ruộng/dẫn thuỷ nhập điền/quán khái|vn
灌输=quán thâu/dẫn nước/đưa nước/truyền bá/truyền/truyền thụ/truyền vào|vn
灌醉=quá chén/say khướt/chuốc say|vn
炼体期=Luyện Thể kỳ|vn
炼化=luyện hóa|vn
炼焦=luyện than cốc/than cốc|vn
烘培=làm bánh/nướng/nướng bánh|vn
烧夷弹=bom cháy|vn
热播=nhiệt bá|vn
熏制=hun/xông|vn
熏染=tiêm nhiễm/nhuốm|vn
熏蒸=nóng bức/hun đốt|vn
熏陶=hun đúc/khai trí/soi sáng|vn
爆响=bạo hưởng/nổ vang|vn
爽口=sướng miệng/ngon miệng|vn
牙刷=bàn chải đánh răng/đánh răng/bàn chãi đánh răng|vn
牴触=mâu thuẫn/chống đối|vn
牵动=khiên động/tác động/kéo theo/biến động theo/làm động tới|vn
犯休=thì thầm|vn
犯冲=xung đột/xung khắc quá|vn
犯戒=phạm giới|vn
犯法=phạm pháp/trái phép/trái luật/vi phạm|vn
犯禁=phạm cấm/vi phạm lệnh cấm/vi phạm điều cấm|vn
犯罪=phạm tội/gây tội|vn
犯规=phạm quy/phạm quy định/phạm nội quy/phạm luật|vn
犯讳=phạm huý/phạm vào điều kiêng kị|vn
犯赃=ăn hối lộ|vn
狗苟蝇营=ruồi nhặng bay quanh|vn
独活=sống một mình|vn
独资=vốn riêng/vốn cá nhân/độc tư|vn
猜出来=đoán được|vn
猜度=phỏng/ước đoán/đoán chừng/đoán/ngờ/phỏng chừng/ước chừng/ngờ tới/ngờ là/phỏng đoán|vn
猜测=suy đoán/đoán/phỏng đoán/ngờ là/ngờ tới|vn
现代化=hiện đại hoá/hiện đại|vn
现代版=phiên bản hiện đại|vn
璞玉浑金=ngọc chưa mài/vàng chưa luyện/hoàn toàn trong trắng/nét đẹp tự nhiên/ngọc thô chưa mài|vn
生产=sản xuất/sinh sản/sinh con|vn
生俘=bắt sống|vn
生冷=sống nguội/lạnh|vn
生动=sinh động/sống động|vn
生化=sinh hóa|vn
生命=sinh mệnh/tính mệnh/mạng sống/sinh mạng|vn
生殖=sinh sản/sinh đẻ/sinh sôi|vn
生活=sinh hoạt/cuộc sống/đời sống/sinh tồn/tồn tại/mức sống/việc/công việc|vn
生活费=tiền sinh hoạt/sinh hoạt phí|vn
生理=sinh lý/sinh lí|vn
生畏=sinh ra sợ hãi/kinh sợ/sợ hãi/sinh sợ|vn
生育=sinh dục/sinh đẻ/sinh con|vn
生计=sinh kế/kiếm sống/kế sinh nhai|vn
生造=tạo ra/đặt ra|vn
生鲜=tươi sống/tươi/sản phẩm tươi sống và thực phẩm mới chế biến|vn
电击=điện giật|vn
电抗=điện kháng|vn
电邮=email|vn
疾风迅雷=Tật Phong Tấn Lôi|vn
痉挛=co rút/kinh luyên/co quắp/co giật/chứng co giật/chuột rút|vn
盐焗鸡=gà hấp muối|vn
监利=Giám Lợi|vn
监制=giám chế/giám sát/theo dõi việc sản xuất/giam chế|vn
监听=nghe lén/nghe trộm/giam thính|vn
监守=trông coi/trông nom/giam thủ|vn
监审=giám thẩm|vn
监察=giám sát/quản lý|vn
监工=giám sát/trông coi/đốc công/giám công/người quản lý|vn
监房=phòng giam|vn
监护=giám hộ/giám sát|vn
监押=bắt giữ/câu lưu|vn
监控=giám sát/quản chế/giám sát và điều khiển/theo dõi|vn
监测=giám sát/theo dõi|vn
监牧=giám mục|vn
监督=giám sát/giám đốc/đốc thúc/giám sát viên/đốc công/người làm nhiệm vụ giám sát|vn
监禁=giam cầm/giam giữ/bỏ tù/cầm tù|vn
监管=giám thị/quản giáo/giam quản|vn
监考=giám thị/coi thi/gác thi/người coi thi/người gác thi/giám khảo|vn
盘查=kiểm tra/kiểm soát lại/truy hỏi/thẩm tra/bàn tra|vn
盘活=hồi sinh/sống sót|vn
盘究=truy hỏi/gặng hỏi/chất vấn/truy vấn/vặn hỏi|vn
直响=vang lên|vn
直播=trực tiếp/gieo thẳng/sạ/phát sóng trực tiếp/trực tiếp truyền|vn
督邮=Đốc Bưu/giám sát bưu chính|vn
瞋目=trừng/nhìn chằm chằm|vn
矮牵牛=dạ yến thảo/thuốc lá cảnh (petunia)/ải khiên ngưu/ngắn dắt bò/Hoa dã yên thảo|vn
研习=nghiên tập/nghiên cứu|vn
研修=nghiên tu/nghiên cứu|vn
研创=nghiên cứu sáng chế|vn
研判=nghiên phán|vn
研制=nghiên cứu chế tạo/nghiên chế|vn
研磨=mài/nghiền nát/nghiền/mài nhẵn|vn
研究=nghiên cứu/tìm tòi học hỏi|vn
研讨=nghiên cứu và thảo luận/nghiên thảo|vn
砥柱=Để Trụ|vn
破响=phá hưởng|vn
磋商=bàn bạc/hội ý/trao đổi/thảo luận kỹ lưỡng/tra cứu/tham khảo/tha thương|vn
磨损=mài mòn/mòn|vn
磨练=tôi luyện/rèn luyện/nung đúc|vn
示警=cảnh báo/báo hiệu/báo hiệu cảnh giới/kỳ cảnh|vn
离析=phân ly/ly tán/chia ly/phân tích/làm rõ/chia rẽ|vn
离环=ly hoàn|vn
私活=việc tư/việc ngoài|vn
移动=di động/chuyển dời/di chuyển|vn
移易=thay đổi/dời đổi|vn
移步=dời bước|vn
稽查=tra xét/cứu xét/người tra xét/người kiểm soát|vn
突击=đột kích/xung kích/làm gấp|vn
突刺=đột thứ/đâm/gai nhọn/chợt đâm|vn
突破=đột phá/phá bỏ|vn
突突=thình thịch/xình xịch|vn
突袭=tập kích/đánh bất ngờ/tập kích/đánh úp bất ngờ/tập kích bất ngờ|vn
立传=lập truyện|vn
竞争=cạnh tranh/đua tranh/ganh đua|vn
竞价=đấu giá/tranh giá|vn
竞试=thi đua|vn
竞赛=thi đấu/thi đua|vn
竞选=tranh cử/vận động bầu cử|vn
符籙=phù lục/sách bùa|vn
策试=thi viết|vn
筛查=sưu tra/sàng lọc|vn
管乐=diễn tấu nhạc khí|vn
管保=bảo đảm/đảm bảo/cam đoan|vn
管制=quản chế/kiểm soát/quản lý chặt/quản lý cưỡng chế/quản thúc cưỡng chế|vn
管口=miệng nòng|vn
管护=quản lý bảo hộ|vn
管控=quản khống|vn
管杀=quản sát|vn
管束=quản thúc/kềm chế/quản chế/nén lại/kềm lại/ràng buộc/ràng giữ|vn
管治=quản trị|vn
管理=quản lý/phụ trách/trông nom/bảo quản và sắp xếp/trông coi|vn
管理费=quản lý phí|vn
管用=có tác dụng/dùng được/hữu hiệu/hiệu nghiệm/có kết quả/tác dụng|vn
管管=quản quản|vn
紧锁=khóa chặt/trói chặt/nhíu mày/nhăn trán/khâu lại/móc lại|vn
累活=việc cực|vn
约制=ước chế/hạn chế/quản thúc/ràng buộc/bó buộc|vn
约合=ước tính/khoảng/về|vn
约斗=ước đấu|vn
约期=ước hẹn/hẹn ngày/ngày hẹn/kỳ hẹn/kỳ hạn khế ước|vn
约束=ước thúc/ràng buộc/trói buộc|vn
约法=ước pháp/hiến pháp tạm thời|vn
约计=ước tính/tính đại khái|vn
细查=xem kỹ|vn
细究=tra cứu/tìm hiểu kỹ/để xem xét|vn
经传=kinh truyện/tác phẩm kinh điển/văn cổ điển/kinh truyền|vn
经售=bán ra/bán/phát hành|vn
经营=kinh doanh/tổ chức/làm/tiến hành|vn
经藉=kinh sách|vn
经费=kinh phí/tiền chi tiêu/tiền phí tổn|vn
经销=bán ra/bán|vn
绝响=thất truyền|vn
统一=thống nhất/nhất trí/chỉnh thể/đơn nhất|vn
统属=lệ thuộc/chi phối|vn
统管=quản lý/quản lý chung/tổng quản lý|vn
统销=thống nhất tiêu thụ|vn
续作=phần tiếp theo/tiếp theo|vn
续命=tục mệnh/kéo dài tính mạng|vn
综合=tổng hợp/tổng hợp lại/hệ thống lại|vn
综治=tống trì|vn
综计=tổng cộng/cộng lại|vn
综述=nói khái quát/tổng thuật|vn
绿营=lục doanh|vn
缄口=im miệng/ngậm miệng|vn
缉查=tra khám/tra xét/sưu tra|vn
缔娜=Đế Na|vn
老俩口=lão lưỡng khẩu|vn
考勤=chấm công/kiểm tra chuyên cần/điểm danh|vn
考古=khảo cổ/khoa khảo cổ|vn
考期=kỳ thi/ngày thi|vn
考查=khảo tra/đánh giá/kiểm tra/sát hạch|vn
考核=khảo hạch/sát hạch/kiểm tra đánh giá/kiểm tra|vn
考研=thi nghiên cứu|vn
考究=khảo cứu/nghiên cứu/cầu kỳ/đẹp/tinh tế/mỹ thuật/tìm tòi nghiên cứu|vn
考组=khảo tổ|vn
考试=khảo thí/cuộc thi/thi/kiểm tra/sát hạch|vn
考验=khảo nghiệm/thử thách|vn
耕一=Koichi|vn
耕作=canh tác/việc đồng áng/cày cấy/cày bừa và trồng trọt|vn
耦合=ngẫu hợp|vn
耳聋=tai điếc|vn
联展=liên kết triển lãm/liên kết kinh doanh|vn
联播=tiếp âm/tiếp sóng/liên bá/phát thanh|vn
联赛=thi đấu vòng tròn/liên kết/đấu vòng tròn/cuộc thi|vn
肥育=vỗ béo/nuôi thúc|vn
胜利=thắng lợi/đạt được/thành công/Thắng Lợi|vn
胜算=phần thắng/kế hay/khéo tính kế hay/mẹo thắng|vn
胜诉=thắng kiện/được kiện|vn
脱口=bật thốt lên/buột miệng nói ra/nói không suy nghĩ/nói thiếu suy nghĩ|vn
脱期=lỡ hạn/quá hạn/trễ hạn|vn
腹诽心谤=oán thầm trong lòng/phỉ báng|vn
自传=tự truyện/từ truyền|vn
自保=tự vệ/tự bảo vệ mình|vn
自动=tự động/tự|vn
自命=tự cho là/tự nghĩ là|vn
自控=tự điều khiển/điều khiển tự động/tự kiềm chế/tự động kiềm chế|vn
自播=tự gieo hạt|vn
自查=tự tra|vn
自测=tự kiểm tra|vn
自理=tự gánh vác/tự đảm đương/tự lo/tự lo liệu|vn
自营=bán trực tiếp/tự sản tự tiêu|vn
自讼=tự trách/tự trách mình/tự than phiền/tự phàn nàn|vn
自费=tự trả tiền/tự chi tiền/tự túc|vn
舒展=giãn ra/xoè ra/mở ra/khoan khoái/dễ chịu/giản ra/triển khai|vn
节育=hạn chế sinh đẻ/tránh thai/kế hoạch hoá gia đình/khống chế sinh đẻ|vn
芳兰竟体=thanh tao lịch sự|vn
苍蝇拍=vỉ đập ruồi/vợt đập ruồi|vn
苍蝇粉=bột con ruồi|vn
草测=đo lường sơ khởi/đo qua/đo đạc bước đầu/đo sơ bộ/trắc lượng sơ bộ|vn
草薙=Kusanagi|vn
营私=mưu lợi riêng/kiếm chác/doanh tư|vn
营造=kiến tạo/xây dựng/tái tạo/tạo|vn
营销=marketing|vn
蒸蒸=bốc lên|vn
薰衣草=huân y thảo/Lavender|vn
虚设=không có tác dụng/vô dụng|vn
蛙泳=bơi ếch/bơi nhái|vn
蛙跳=nhảy cóc/nhảy ếch|vn
蛙鸣=ếch kêu|vn
蜡染=nhuộm sáp/nhuộm vải hoa bằng sáp|vn
蜥蜴人=người thằn lằn/tích dịch nhân|vn
蝌蚪文=khoa đẩu văn|vn
融冰=Dung Băng|vn
融化=hòa tan/tan/hoà tan|vn
融合=dung hợp/hoà hợp|vn
融和=dung hòa/hòa hợp/ấm áp/ấm/dung hoà/hoà hợp|vn
融流=chảy đều|vn
融浆=dung nham|vn
融环=dung hoàn|vn
融资=đầu tư bỏ vốn|vn
融通=lưu thông|vn
融雪=tuyết tan|vn
血馒头=Huyết Man Đầu|vn
行动=hành động/đi lại/đi đi lại lại/hành vi/cử động|vn
行罚=hành phạt|vn
行营=hành dinh|vn
行销=tiêu thụ/bán|vn
行骗=đi lừa gạt|vn
衍化=diễn hoá/diễn hóa/để phát triển và thay đổi|vn
衝破=phá tan|vn
衝突=xung đột|vn
补一=bù một|vn
补偿=đền bù/bồi thường/đền bù tổn thất/bổ sung/bổ khuyết|vn
袪除=loại trừ|vn
被动=bị động/thụ động|vn
被控=bị cáo/bị tố cáo/bị lên án|vn
被活=bị chôn|vn
裁判=phán định/trọng tài/tài phán/phán xử/xét xử/phán quyết và quyết định/phán quyết/phân xử|vn
裂响=nứt vang|vn
装聋=giả điếc|vn
装设=lắp đặt/gắn/lắp|vn
观测=quan trắc/đo/quan sát đo đạc/quan sát đánh giá/quan sát và đoán định|vn
观赛=xem thi đấu/xem trận đấu|vn
规整=hợp quy tắc/hợp quy cách/ngay ngắn|vn
解析=phân tích/mổ xẻ/đi sâu phân tích/giải tích|vn
警探=thám tử|vn
认输=nhận thua/chịu thua|vn
训喻=huấn dụ/giảng giải khuyên bảo|vn
训导=huấn đạo/dạy bảo/khuyên răn|vn
训戒=huấn giới|vn
训斥=răn dạy/quở mắng/răn dạy và quở mắng/khiển trách|vn
训练=huấn luyện|vn
训育=giáo dục đạo đức|vn
训话=phát biểu/lời dạy bảo/lời giáo huấn/huấn thoại|vn
训诫=răn dạy/phê bình giáo dục/huấn giới|vn
讲究=giảng cứu/chú ý/sang trọng/coi trọng/chú trọng/xem trọng/đáng được chú ý/đẹp đẽ/lịch sự/có ý tứ|vn
讹诈=đe doạ/lừa bịp tống tiền/lừa gạt tống tiền/doạ dẫm/lừa gạt/lừa bịp|vn
论外=luận ngoại|vn
论罪=luận tội/xử tội/định tội|vn
设备=thiết bị/dụng cụ/trang bị|vn
设置=thiết trí/xây dựng/thiết lập/trang bị/lắp đặt|vn
设计=thiết kế/xếp đặt thiết kế/trù tính|vn
访古=kiếm di tích cổ/viếng di tích cổ|vn
访查=điều tra|vn
评传=truyện ký có bình luận|vn
评估=ước định/bình cổ|vn
评判=bình phán/phân xét/trọng tài/phán xét|vn
评奖=bình thưởng/bình bầu khen thưởng/bình chọn khen thưởng|vn
评审=giám khảo|vn
评核=đánh giá lại/bình hạch|vn
评测=bình trắc|vn
评理=phân xử/phân tích đúng sai/bình lý|vn
评级=bình xét cấp bậc/bình xét bậc lương|vn
诈作=giả bộ/giả vờ/ra vẻ|vn
诈捐=lừa tiền quyên góp/quyên góp|vn
诈骗=lừa gạt/lừa dối/lừa bịp/lường gạt|vn
诉讼=tố tụng/kiện tụng/kiện thưa|vn
试作=thí tác|vn
试工=làm thử|vn
试探=thăm dò/thử/dò xét/thử dò xét/thăm dò|vn
试用=dùng thử|vn
试管=ống nghiệm/thí quản|vn
试纸=giấy thử|vn
试练=thí luyện|vn
试试=thử một chút/thử xem|vn
试销=bán thử|vn
试验=thí nghiệm/thực nghiệm/thử nghiệm/thi cử|vn
诰命=cáo mệnh/lệnh vua|vn
诱导=hướng dẫn/dạy dỗ khuyên bảo/gợi mở/dẫn bảo/dẫn dụ/cảm ứng/dẫn đến/tạo ra/dụ đạo|vn
请稍等=xin chờ một chút|vn
调亲=tự thân - điều/điều động/phân phối|vn
调价=điều chỉnh giá|vn
调休=nghỉ ngơi/bù đắp cho việc nghỉ ngơi trong ngày làm việc bằng cách làm việc vào ngày nghỉ|vn
调制=điều chế/điều chỉnh/pha chế|vn
调动=điều động/đổi/thay đổi/động viên/huy động/vận động|vn
调匀=điều hoà/đều đặn/điều hòa|vn
调和=điều hòa/điều hoà/hoà giải/điều đình/dàn xếp/thoả hiệp/nhượng bộ|vn
调回=triệu hồi/thu quân/gọi về|vn
调培=Điều Bồi|vn
调往=điều đi/điều động tới|vn
调护=điều dưỡng chăm sóc/điều dưỡng trông nom|vn
调控=điều tiết khống chế/điều khiển/điều khống|vn
调整=điều chỉnh/điều hoà|vn
调查=điều tra/xem xét/kiểm tra/khảo sát|vn
调治=điều trị/điều dưỡng/trị liệu|vn
调派=điều động/sai/phái/điều/sắp xếp|vn
调演=hội diễn|vn
调理=điều trị/điều dưỡng/trông nom/chăm sóc/huấn luyện/quản giáo/trêu chọc/trêu đùa/điều lý|vn
调用=điều động/thuyên chuyển/điều phối sử dụng/điều dụng|vn
调研=điều tra nghiên cứu/điều nghiên|vn
调离=dời/chuyển/điều ly|vn
调笑=trêu chọc/trêu đùa/trêu ghẹo|vn
调级=điều cấp/điều chỉnh cấp bậc lương|vn
调置=bố trí|vn
调职=thuyên chuyển/đổi đi nơi khác/thuyên chuyển công tác/điều chức/chuyển việc|vn
调节=điều tiết/điều hoà/điều chỉnh|vn
调试=điều chỉnh thử/vận hành thử/chạy thử/điều thí|vn
调资=điều chỉnh lương bổng|vn
调转=thay đổi/đổi/chuyển/quay ngược lại/quay lại/điều chuyển|vn
调运=điều vận/vận chuyển/phân phối và vận chuyển|vn
调配=điều phối/điều động phân phối/phân chia/điều hoà/phối hợp/phân phối|vn
调酒=pha rượu/điều tửu|vn
调防=đổi nơi đóng quân/thay đổi nơi đồn trú/điều phòng|vn
调集=triệu tập/tập hợp/điều động/tập trung/điều tập|vn
调音=điều âm/điều chỉnh/để điều chỉnh|vn
调频=xoay tròn/điều chỉnh công suất dòng điện/sự điều biến tần/tần số|vn
谈价=nói giá|vn
谈兴=hứng thú nói chuyện/hứng nói chuyện|vn
谈兵=đàm binh|vn
谈判=đàm phán/thương lượng|vn
谈助=đề tài câu chuyện/đề tài nói chuyện|vn
谈吐=ăn nói/nói năng|vn
谈笑=đàm tiếu/cười nói|vn
谈论=đàm luận/bàn bạc/bàn tán|vn
谈话=nói chuyện/trò chuyện/bài nói chuyện/bài phát biểu|vn
谈谈=nói chuyện/nói chuyện một chút|vn
谈资=đề tài nói chuyện/đề tài câu chuyện/đề tài nói chuyện/đàm tư|vn
贩售=buôn bán|vn
贩私=buôn lậu/buôn bán hàng lậu|vn
贬谪=biếm trích/bị giáng chức/bị phái đến những nơi xa kinh thành|vn
贸易=mậu dịch/buôn bán/thương mại/mua bán|vn
贺电=điện mừng/điện chúc mừng|vn
赈灾=chẩn tai/giúp nạn thiên tai/cứu trợ thiên tai/cứu tế tai hoạ|vn
赎命=chuộc mạng|vn
赎罪=chuộc tội/tha tội|vn
赏析=thưởng tích|vn
起鬨=tụ tập đùa giởn|vn
越游=càng bơi|vn
跨步=cất bước|vn
跳动=nhảy lên/đập|vn
跳船=nhảy thuyền|vn
蹩脚货=hàng xấu/hàng kém chất lượng/hàng thứ phẩm|vn
躁动=xao động/nóng nảy/vội vàng/đập không ngừng/đập liên tục|vn
转业费=phí chuyển nghề|vn
转产=đổi mặt hàng sản xuất/thay đổi sản phẩm|vn
转会费=phí chuyển nhượng/tiền thưởng đăng nhập|vn
转口=chuyển khẩu/nhập khẩu/chuyển cảng|vn
转播=tiếp sóng/truyền lại/chuyển tiếp|vn
转环=chuyển vòng|vn
转输=chuyển thâu|vn
轮作=luân canh|vn
轰响=nổ vang/nổ ran/nổ đùng đoàng/ầm vang|vn
辅修=phụ tu/Phụ/thứ 2|vn
辅公=Phụ Công|vn
辅助=phụ trợ/giúp/giúp đỡ/phụ|vn
辅导=phụ đạo/chỉ đạo/hướng dẫn/dạy kèm|vn
辨析=phân tích rõ/phân biệt|vn
过活=sống qua/sống/sinh sống/sinh nhai|vn
运作=vận hành/vận tác/hoạt động/triển khai hoạt động/vận hành và thao tác|vn
运动=vận động/chuyển động/hoạt động thể thao/cuộc vận động/phong trào/chạy chọt/chạy vạy|vn
运命=vận mệnh|vn
运往=vận chuyển về|vn
运用=vận dụng/áp dụng/sử dụng|vn
运算=tính toán/giải toán/làm toán/tính toán/vận toán (operation)|vn
运营=vận doanh/đưa vào hoạt động/đưa vào kinh doanh/vận chuyển buôn bán/hoạt động/vận động|vn
运费=phí chuyên chở/phí vận chuyển|vn
运转=vận chuyển/quay quanh/xoay quanh/chuyển vận/chạy/chuyển động/vận hành/hoạt động|vn
运输=vận chuyển/vận tải/tải/chuyển vận|vn
运销=đưa đi bán/vận chuyển hàng hoá đi bán/chuyển đi bán|vn
进出口=xuất nhập cảng|vn
进口=nhập khẩu/vào bến/vào cảng/nhập cảng/cửa vào/lối vào/tiến khẩu|vn
进展=tiến triển/tiến hoá/phát triển|vn
违抗=chống lại/cãi lời/cưỡng lại/cải lời|vn
违法=phạm pháp/vi phạm/trái pháp luật/trái phép|vn
违章=vi phạm luật lệ|vn
违规=vi quy/không tuân theo quy định/làm trái quy tắc|vn
违误=làm trái/làm hỏng/trái nhỡ|vn
连作=liên tác/trồng liền vụ/trồng liên tục một giống cây|vn
连播=phát sóng liên tục|vn
连环=liên hoàn/liên tục|vn
连突=liên đột|vn
连营=liên doanh|vn
连输=thua liền|vn
连锁=mắt xích/xích/trói/bó lại/mắc xích/móc vào nhau/dây chuyền/mắc xích (dây chuyền)|vn
逆推=đẩy ngược/ngược lại|vn
通传=thông truyền/thông báo|vn
通关=thông quan/qua cửa|vn
通判=Thông phán|vn
通通=toàn diện/toàn bộ/tất cả/hết thảy|vn
逛商场=shopping|vn
造作=chế tạo/làm/làm điệu/làm dáng/kiểu cách/giả bộ|vn
道歉信=thư xin lỗi|vn
遗产=di sản/của để lại|vn
遗传=di truyền|vn
遗作=tác phẩm để lại|vn
遗命=di mệnh|vn
遗留=còn sót lại/di lưu/để lại/truyền lại/còn để lại|vn
遗训=di huấn|vn
遥控=điều khiển/điều khiển từ xa/hộp điều khiển tv|vn
遥测=đo cự ly xa|vn
遺產=di sản|vn
避日=tị nhật|vn
邮展=triển lãm tem|vn
配乐=phối nhạc/hòa nhạc|vn
配出来=phối xuất ra|vn
配售=bán phân phối|vn
酢浆草=cây me đất|vn
酿制=ủ chế/chế riêng/chế riêng cho|vn
酿造=sản xuất|vn
酿酒=cất rượu/chưng cất rượu|vn
重修=trùng tu/học lại/sửa lại/trọng tu|vn
重击=trọng kích/đòn nghiêm trọng|vn
重刷=lại quét|vn
重合=trùng hợp/trùng khít/chồng/trọng hợp|vn
重响=trọng hưởng|vn
重审=phúc thẩm/xử lại ở cấp cao hơn|vn
重工=công nghiệp nặng/công việc nặng|vn
重播=phát lại/phát thanh lại|vn
重整=trọng chỉnh/chỉnh đốn lại|vn
重案组=tổ trọng án|vn
重活=sống lại/việc nặng/công việc nặng nhọc/trọng hoạt|vn
重游=lại một lần nữa du lịch/thăm lại|vn
重演=tái diễn/lại xảy ra/tái hiện/trở đi trở lại/tái phát/trở lại/xem lại/chiếu lại|vn
重组=gây dựng lại|vn
重罚=trọng phạt/phạt nặng|vn
重罪=trọng tội|vn
重设=thiết lập lại/làm lại|vn
重试=thử lại|vn
重资=vốn lớn/vốn nhiều|vn
重赛=đấu lại/tái đấu|vn
鉴戒=rút kinh nghiệm/làm gương/điều răn/làm mẫu/rút bài học|vn
鉴证=bằng chứng giám định/chứng cứ giám định/chứng thực/Xác nhận/xác thực/xác minh|vn
铐起来=còng|vn
铢两悉称=kẻ tám lạng người nửa cân/bên tám lạng bên nửa cân/tương đương nhau|vn
铺展=trải ra/dàn ra/phô triển|vn
铺设=trải/rải/đặt|vn
销作=tiêu tác|vn
销售=tiêu thụ|vn
销商=tiêu thương (dealers)|vn
销磨=làm tiêu hao|vn
销蚀=ăn mòn|vn
销行=đưa ra tiêu thụ|vn
销赃=thủ tiêu tang vật|vn
镂空=chạm rỗng/lũ không/điêu khắc|vn
镪水=a-xít mạnh/cường toan/axít mạnh|vn
闭环=vòng kín|vn
防务=phòng ngự/công việc bảo vệ an ninh quốc gia|vn
防控=phòng khống/phòng ngừa và kiểm soát/Phòng ngừa và kiểm soát|vn
防旱=phòng hạn/chống hạn|vn
防汛=phòng lụt/phòng chống lụt|vn
防洪=chống lũ/chống lũ lụt/chống lụt/phòng lũ|vn
防疫=phòng dịch/phòng bệnh truyền nhiễm|vn
防盗=phòng trộm/bảo vệ/phòng trộm cắp/chống trộm/đề phòng trộm cắp|vn
防空=phòng không/phòng thủ trên không|vn
防老=dưỡng già/dưỡng lão|vn
附合=phụ họa|vn
附设=lập thêm/còn có thêm/thiết lập thêm|vn
降贵纡尊=hạ mình/hàng quý dực tôn|vn
陪练=bồi luyện|vn
集邮=sưu tập tem/chơi tem/tập bưu|vn
零售=bán lẻ|vn
零工=việc vặt/làm công nhật/người làm việc vặt/người giúp việc/linh công|vn
零散=rải rác/phân tán|vn
零活=linh hoạt|vn
零环=0 hoàn|vn
零用=tiêu vặt/dùng vặt/tiền tiêu vặt|vn
零级=0 cấp/linh cấp|vn
震动=chấn động/rung động/làm rung động/rung rung/vang dội/vang động/làm chấn động|vn
震响=vang vọng/vang dội|vn
震憾力=chấn hám lực|vn
震潜=Chấn Tiềm|vn
震破=đánh vỡ/bị phá vỡ/phá vỡ|vn
震级=cấp độ động đất|vn
非攻=phi công/không chiến tranh|vn
革书=sách da|vn
革出=khai trừ/đuổi|vn
革命=cách mạng/có ý thức cách mạng/cải cách triệt để/cải cách căn bản|vn
革新=cách tân/đổi mới/cải cách|vn
革职=cách chức|vn
预付=dự chi/ứng trước|vn
预估=dự đoán|vn
预先=dự đoán/trước/sẵn/sẵn sàng/sớm/đoán trước/từ trước|vn
预售=bán trước|vn
预审=dự thẩm/thẩm tra/thẩm vấn|vn
预展=triển lãm thử|vn
预报=dự báo/báo trước|vn
预期=dự tính/mong muốn/mong chờ/trông mong/mong đợi/dự trù|vn
预测=dự đoán/dự tính/ước đoán/đoán trước/báo trước|vn
预演=diễn thử/dự diễn|vn
预览=xem trước|vn
预警=dự cảnh/báo động trước/báo nguy trước|vn
预计=dự tính/tính trước|vn
预设=dự thiết/cài đặt trước/mặc định|vn
预赛=đấu loại/đấu vòng loại|vn
领洗=rửa tội|vn
领罪=lĩnh tội/nhận tội|vn
飞播=gieo hạt|vn
餬口=ăn cháo cầm hơi/sống qua ngày đọan tháng/sống tạm|vn
首播=phát sóng lần đầu/phát sóng đầu tiên|vn
驱动=khu động/khu động (driver)/khởi động|vn
驻外=trú ngoại|vn
验货=kiểm hàng|vn
验资=nghiệm tư/kiểm tra tài sản/xác minh vốn|vn
骑马找马=đứng núi này trông núi nọ/được voi đòi tiên/cưỡi ngựa tìm ngựa/đãng trí quá chừng|vn
骑驴找马=đứng núi này trông núi nọ/Cưỡi lừa để tìm ngựa/Cưỡi lừa để tìm một con ngựa|vn
骷髅兵=Khô Lâu binh/khô lâu binh|vn
骷髅头=đầu lâu/đầu khô lâu|vn
骷髅旗=cờ đầu lâu/cờ khô lâu|vn
鸣响=vang lên/minh hưởng|vn
龌龊事=chuyện xấu xa|vn
