丗=thế|yg
丣=dậu|yg
乄=ngũ|yg
乢=cái|yg
仌=băng|yg
侭=tận|yg
倄=giáo|yg
僇=lục|yg
儤=bạo|yg
冐=mạo|yg
冹=phu|yg
凷=khối|yg
剒=thố|yg
卭=ngang|yg
卼=ngột|yg
呉=ngô|yg
唕=tạo|yg
嘐=hao|yg
噇=trảng|yg
嚚=ngân|yg
圢=đinh|yg
堧=nhuyên|yg
堩=hằng|yg
塟=táng|yg
壃=cương|yg
妌=tịnh|yg
娰=nữ|yg
孻=nai|yg
孼=nghiệt|yg
宂=nhũng|yg
寀=thái|yg
尀=phả|yg
尒=nhĩ|yg
峃=học|yg
嵕=tông|yg
嶓=ba|yg
巂=tây|yg
庅=người|yg
庿=miếu|yg
弌=nhất|yg
徧=biến|yg
戭=diễn|yg
拝=bái|yg
挜=á|yg
揌=tai|yg
摠=tổng|yg
攗=quấn|yg
敚=đoạt|yg
斄=ly|yg
斠=dác|yg
旣=ký|yg
晛=hiện|yg
暵=hán|yg
枌=phần|yg
枲=tỷ|yg
枻=duệ|yg
柲=bí|yg
梠=lữ|yg
棐=phỉ|yg
棬=khuyên|yg
椶=tông|yg
樛=cù|yg
橧=tăng|yg
檮=đào|yg
毌=quán|yg
氄=nhũng|yg
汍=hoàn|yg
汎=phiếm|yg
汳=biện|yg
沘=tỉ|yg
泲=tể|yg
洏=nhi|yg
溁=oanh|yg
溓=liễm|yg
潓=huệ|yg
澼=phích|yg
濆=phần|yg
灜=doanh|yg
牷=toàn|yg
牿=cố|yg
犂=lê|yg
狾=chế|yg
猲=yết|yg
獧=quyến|yg
瑯=lang|yg
璪=tảo|yg
畆=mẫu|yg
痀=câu|yg
痌=thông|yg
瘥=ta|yg
皦=kiểu|yg
睍=hiển|yg
瞚=thuấn|yg
碶=thế|yg
磎=khê|yg
礀=tư thế|yg
礮=pháo|yg
禑=vũ|yg
穉=trĩ|yg
窊=oa|yg
窎=điếu|yg
筀=quế|yg
籝=doanh|yg
粃=chủy|yg
絏=tiết|yg
絻=miễn|yg
総=tổng|yg
緑=lục|yg
縰=sỉ|yg
繐=huệ|yg
耑=chuyên|yg
肈=triệu|yg
胠=khư|yg
胹=nhi|yg
胾=chí|yg
脗=vẫn|yg
脝=hanh|yg
脶=loa|yg
舩=thuyền|yg
藂=tùng|yg
蜰=phì|yg
蠨=tiêu|yg
衒=huyễn|yg
褧=quýnh|yg
襍=tập|yg
覉=ki|yg
訢=hân|yg
詟=triệp|yg
誖=bội|yg
譈=đỗi|yg
豻=ngan|yg
贋=nhạn|yg
赒=chu|yg
赬=xanh|yg
躩=khước|yg
軏=nguyệt|yg
輈=chu|yg
輙=triếp|yg
逷=địch|yg
逿=đáng|yg
遆=đề|yg
遹=duật|yg
鄗=hạo|yg
醱=bát|yg
釽=tịch|yg
鉏=sừ|yg
銶=cầu|yg
錡=kỹ|yg
閦=súc|yg
阨=ách|yg
隖=ổ|yg
霅=tráp|yg
靦=điến|yg
靮=đích|yg
韔=sướng|yg
韮=phỉ|yg
飂=liêu|yg
餈=tư|yg
驩=hoan|yg
鬨=hống|yg
魭=tra|yg
鳡=cảm|yg
鳣=chiên|yg
鴞=hào|yg
鹮=hoàn|yg
鼪=sinh|yg
齞=nhe răng|yg
