一幢幢=từng sàn|z
一炷香=một nén hương|z
不含糊=nghiêm túc/đâu ra đó/không mơ hồ/không rõ ràng/không hàm hồ/nhập nhằng nước đôi/tốt/hay/đẹp/độc đáo/hợp lý/phải chăng/không yếu kém/chẳng hãi sợ|z
不咋地=không ra sao/không phải đất/không tốt lắm|z
不哼不哈=không nói không rằng/không hé răng/cạy răng không nói một lời/chẳng nói chẳng rằng|z
不大清楚=không rõ ràng lắm|z
不好比=không giống vậy|z
不急不徐=không gấp không chậm|z
不闪=không tránh/không né|z
不驯服=không thuần phục|z
不高兴地=mất hứng|z
丝丝缕缕=từng tia từng sợi/từng sợi tơ/từng tia từng dòng|z
丝森冷=tia lạnh lẽo|z
丝绵=bông tơ|z
两足=hai chân|z
两重天=lưỡng trọng thiên/hai tầng|z
严严实实=cực kỳ chặt chẽ/nghiêm nghiêm thật thật/chặt chẽ|z
主辱臣死=chủ nhục thần tử|z
久呆=ở lâu|z
久寂=yên tĩnh lâu|z
乌沉沉=ô trầm trầm|z
乌溜溜=đen lúng liếng/đen láy/đen nhánh/đen lay láy|z
乌漆麻黑=lấm tấm màu đen|z
乐呵乐呵=vui a vui a/khúc khích|z
乐呵呵=vui tươi hớn hở/nhạc a a/vui cười hớn hở|z
乐滋滋=vui sướng hài lòng/thích thú/khoái trá/nhạc tư tư|z
乐颠颠=hí ha hí hửng|z
乱乎=hỗn loạn|z
乱伦=loạn luân|z
乱冲=xông loạn|z
乱呼=hô loạn|z
乱哄哄=kêu loạn/ầm ĩ/hỗn loạn/mất trật tự/hò hét loạn lên|z
乱喷=phun tung tóe|z
乱摇乱颤=rung rinh lay động|z
乱撞=đi loạn|z
乱晃=chuyển loạn|z
乱杂=tạp loạn/lẫn lộn|z
乱滚=lăn loạn|z
乱糟糟=rối bời/lộn xộn/tùm lum tùm la/bối rối/tùm la tùm lum|z
乱纷纷=hỗn loạn/rối loạn/rối bời|z
乱腾=hỗn loạn/ồn ào/mất trật tự|z
乱腾腾=rối mù/rối ren/rối bời|z
乱蓬蓬=rối bời/rối bù/bù xù|z
乱蹦=nhảy tưng|z
乱蹭=cọ lung tung/cà xát vào lung tung|z
乱闪=chớp loạn|z
乱麻=đay rối/loạn ma|z
亮堂堂=sáng trưng/sáng choang|z
亮天=trời sáng|z
亮晶晶=sáng lóng lánh/sáng trông suốt/lấp lánh/lóng lánh/long lanh/sáng lấp lánh|z
亮灿灿=sáng rực/sáng rực rỡ|z
亮红=đỏ đậm|z
亮若=sáng như/lượng nhược|z
亮闪闪=sáng long lanh/sáng ngời|z
亲亲热热=thân thân nhiệt nhiệt|z
人声嘈杂=tiếng người huyên náo|z
什么世道=thế đạo gì|z
仓猝=vội vàng/vội vã/gấp gáp/gấp|z
仔仔细细=tỉ mỉ|z
仔细搜索=tìm tòi tỉ mỉ|z
优伶=đào kép|z
优良=ưu lương/tốt đẹp/tốt|z
优闲=nhàn nhã|z
依依=lưu luyến/lả lướt/Y Y/bịn rịn/quyến luyến/vẫn như cũ|z
依凡=Y Phàm|z
依旧=vẫn như cũ/vẫn/như trước/như cũ/y nguyên|z
依蜜丽=Ymily|z
倔头倔脑=cứng đầu cứng cổ/cục cằn|z
倔强地=quật cường|z
假惺惺=giả mù sa mưa/vờ vĩnh/giả bộ|z
傻乎乎=đần độn/trì độn|z
傻呆=ngốc nghếch|z
傻呵呵=ngây ngô/đờ đẫn/đần độn|z
傻愣=ngây ngốc/sỏa lăng|z
傻熊=gấu ngốc|z
傻白甜=ngốc bạch ngọt/ngốc trắng ngọt ngào/người phụ nữ trẻ ngọt ngào, ngây thơ|z
傻里傻气=đần độn ngu si/ngốc nghếch/khờ dại|z
僵呆=cứng nhắc/đờ ra/bất động|z
僵巴=cứng/không cử động được/tê cứng|z
光溜=sạch sẽ/sáng bóng/nhẵn bóng/bóng|z
光溜溜=trần trùng trục/trơn bóng/trơn/nhẵn bóng/trần truồng/trơ trụi|z
光灿灿=chói/lóa mắt/chói mắt/loá mắt/sáng loè loè|z
光秃=trọc/trụi/trơ trụi|z
光秃秃=trụi lủi/trọc lóc/nhẵn bóng/trơ trụi/trọc lốc|z
光裸=trần trụi/trần truồng|z
光闪=quang thiểm|z
光闪闪=lóng lánh/óng ánh/ánh sáng mờ ảo/ánh sáng chập chờn|z
兮兮=hề hề/như vậy|z
兴冲冲=hứng thú bừng bừng/bị kích động/cực kỳ hứng thú/hào hứng|z
兴匆匆=kích động|z
冒然=mạo muội/liều lĩnh/bất chấp/đường đột|z
冰冰=băng băng/Băng Băng|z
冰冰冷冷=băng băng lãnh lãnh|z
冰冰凉凉=lạnh lạnh lẽo lẽo/lạnh lẽo|z
冰冷=băng lãnh/lạnh giá/lạnh buốt/băng giá/rét cóng/giá lạnh/lạnh như tiền/vô cùng lạnh nhạt/lãnh đạm/lạnh như băng/lạnh lẽo|z
冰凉=lạnh buốt/lạnh lẽo/lạnh ngắt/lạnh giá/lạnh cóng/lạnh như băng|z
冰凉凉=lạnh buôn buốt|z
冰溜=băng lưu|z
冰熊=Băng Hùng|z
冰莹=băng oánh|z
冰蓝=băng lam|z
冰闲=Băng Nhàn|z
冲愣=làm càn|z
冲飘=thổi hướng|z
冷冷地=lạnh lùng|z
冷冷淡淡=lãnh lãnh đạm đạm|z
冷冷清清=lãnh lãnh thanh thanh/vắng ngắt|z
冷咧=lãnh liệt|z
冷幽=u lãnh|z
冷烫=uốn tóc nguội|z
冷飕飕=lạnh buốt/lạnh giá|z
凄凄凉凉=thê thê lương lương|z
凄凄切切=bi bi ai ai|z
凄凄惨惨=thê thê thảm thảm|z
凄然=buồn bã/đau thương/đau buồn/buồn rầu/buồn bã|z
凉飕飕=lạnh lẽo/lạnh giá|z
凑热闹=tham gia náo nhiệt/vô giúp vui/tham gia trò vui|z
凛凛=lẫm liệt/lẫm lẫm/rét căm căm/rét mướt/nghiêm nghị|z
凛异=kì dị|z
凛然=nghiêm nghị/lẫm liệt/hào hùng/lẫm nhiên|z
凛酱=Rin-chan|z
凛香=Rinka|z
凶巴巴=dữ dằn/trừng mắt/hung ba ba/hung ba ba (*trừng mắt)|z
切切实实=thiết thiết thực thực/thiết thiết thật thật|z
别别扭扭=kỳ quái|z
到哪去=đi nơi nào|z
刷油漆=quét sơn|z
刷的=xoạt|z
刺溜=xẹt/chíu chíu/rẹt/thứ lưu|z
剥茧抽丝=bác kiển trừu ty|z
劈哩啪啦=phách lý ba lạp|z
勃然=thốt nhiên/mạnh mẽ/dồi dào/thịnh vượng/bừng bừng/hầm hầm/tái người/tím mặt/bỗng nhiên|z
勃谿=cãi trong nhà|z
勉勉强强=miễn miễn cưỡng cưỡng/miễn miễn cường cường/quá miễn cưỡng|z
勤勤恳恳=cần cù chăm chỉ/cần cần khẩn khẩn|z
勾勾搭搭=câu kết làm bậy/câu câu đáp đáp/cấu kết làm bậy|z
匆=thông|z
匆匆=vội vàng/vội vã/vội vội vàng vàng/hấp tấp|z
匆匆忙忙=vội vàng/vội vội vàng vàng|z
匆忙=vội vàng/vội vội vàng vàng/gấp ga gấp gáp/ba chân bốn cẳng|z
十乌=Thập Ô|z
十佳=mười tốt/top 10|z
半旧=hơi cũ|z
半疯半癫=nửa điên nửa khùng|z
半眯=híp lại/nửa hí|z
半裸=nửa trần/nửa thân trần|z
半酣=uống chưa đủ đô/uống chưa đã/uống chưa mềm môi|z
厚墩墩=dày cộp/dày cộm/dày cồm cộp|z
厚黑=hậu hắc|z
叠翠=cây rừng trùng điệp xanh mướt|z
可怜兮兮=vô cùng đáng thương/đáng thương|z
可怜巴巴=tội nghiệp/đáng thương|z
合作愉快=hợp tác vui vẻ|z
含含糊糊=hàm hàm hồ hồ/sờ soạng/lóng ngóng/vụng về|z
含糊地=hàm hồ|z
含萧=ngậm tiêu|z
呆呆=ngơ ngác|z
呆呆地=ngơ ngác/ngơ ngác mà|z
呆在=ở tại/đứng ở/sống ở|z
呆头呆脑=đần độn/đầu óc ngu si/ngờ nghệch/ngốc nghếch|z
呆怔=ngẩn ngơ/trơ/đờ/ngây/đực mặt/ngơ ngẩn|z
呆愣=ngu ngơ/ngốc lăng/sững sờ|z
呆愣愣=ngây ngốc|z
呆然=sững người|z
呆若=ngốc như|z
呱呱叫=tuyệt/cừ/tuyệt lắm/không chê vào đâu được|z
呻吟声=tiếng rên rỉ|z
咋咋呼呼=kêu kêu gào gào|z
和珅=Hòa Thân|z
哀啼=khóc lóc|z
哆哆嗦嗦=run rẩy/sỉ sỉ sách sách/run lập cập|z
哑然=yên lặng/tức cười/hoạt kê/vắng lặng/cười khanh khách|z
哓哓=nhao nhao|z
哗然=xôn xao/ồ lên/ồn ào/rộ lên/náo động|z
哩哩啦啦=tung toé/tràn khắp ra|z
哩哩啰啰=lúng ta lúng túng|z
哭哭啼啼=khóc sướt mướt/khốc khốc đề đề|z
哭湿=khóc ướt|z
哭穷=khóc than/kêu nghèo/than nghèo|z
哼哼唧唧=lẩm bẩm/rầm rì|z
唠叨=lải nhải/lảm nhảm/càm ràm/lắm mồm/ba hoa/ríu rít/nói huyên thuyên|z
唠唠叨叨=lao thao/thao thao bất tuyệt|z
啰啰嗦嗦=dài dòng văn tự|z
啰嗦=dông dài/dài dòng|z
喉咙干=cổ họng khô|z
喘吁吁=thở hổn hển/thở phì phò/hen suyễn/thở nặng nhọc|z
喘喘气=thở một chút|z
喘气声=tiếng hơi thở/tiếng thở|z
喜冲冲=vui mừng hớn hở/mừng rối rít/mừng quýnh|z
喜滋滋=mừng khấp khởi/vui rạo rực/hỉ tư tư|z
喷涂=phun ra|z
嗡嗡地=ông ông|z
嗡嗡声=tiếng ông ông|z
嗫嗫=ấp úng/lúng túng|z
嗫嗫嚅嚅=ngập ngừng|z
嘀嘀咕咕=thầm thầm thì thì/nói nhỏ/nói thầm/càu nhàu/cằn nhằn|z
嘈嘈=tiếng chói tai|z
嘈杂声=tiếng ồn ào/tiếng huyên náo|z
嘎嘣脆=giòn/rất giòn/ròn/dứt khoát/thẳng thắn|z
嘎然=két két/quàng quạc/quang quác/tắt/nghẽn/đột nhiên/tắc nghẽn|z
嘓嘓=Quắc quắc/nuốt ực ực|z
嘟嘟囔囔=lầm bầm lầu bầu|z
嘟囔=lầm bầm/lầu bầu/lẩm bẩm|z
嘻哈=hip-hop/hi cáp/hiphop|z
嘻嘻=hì hì/Hi hi/cười hi hi|z
嘻嘻哈哈=hi hi ha ha/cười toe toét/hỉ hả/ha hả/cười vui vẻ|z
噩噩=Ngạc ngạc/nghiêm túc|z
嚐嚐=nếm một chút|z
囚首垢面=đầu bù tóc rối/mặt mày lem luốc/mặt mày nhem nhuốc|z
圆乎乎=tròn vo|z
圆圆满满=mỹ mãn|z
圆浑=uyển chuyển/du dương/réo rắt/ý vị đậm đà/không trau chuốt|z
圆溜=tròn trịa|z
圆溜溜=tròn căng/tròn vo|z
圆滚=tròn mép/viên cổn|z
圆滚滚=tròn vo/tròn xoe|z
圆瞪=trừng trừng|z
圆鼓鼓=tròn trịa/căng tròn/mẩy/viên cổ cổ|z
坦坦荡荡=rất thẳng thắn/bằng phẳng/thản thản đãng đãng|z
坦荡荡=thản đãng đãng/bằng phẳng|z
垂青=lọt mắt xanh/coi trọng/xem trọng/thùy thanh|z
多呆=ở lâu/ở lâu thêm|z
大佳=cực tốt|z
大凛=run sợ|z
大呆=đại ngốc|z
大呼小叫=kêu la om sòm/hét lên và hét lên/làm ầm ĩ lên|z
大咧咧=tùy tiện/cười toe toét/đỉnh đạc|z
大夥儿=đại khoả nhi|z
大大咧咧=tùy tiện/tuỳ tiện/cẩu thả/không cẩn thận/đại đại liệt liệt/lẫm lẫm liệt liệt|z
大大小小=to to nhỏ nhỏ/tất cả lớn nhỏ|z
大白熊=đại bạch hùng|z
大白痴=tên ngớ ngẩn|z
大红大绿=xanh đỏ loè loẹt/màu sắc sặc sỡ|z
大老粗=đại lão thô/già nua/Người kém văn hoá/không có văn hoá|z
大老黑=Đại Lão Hắc|z
大胖=mập mạp|z
大隐=đại ẩn|z
奄奄=yếu ớt/thoi thóp|z
奄忽=đột nhiên/bất chợt|z
奕剑=Dịch Kiếm|z
奕奕=sáng láng/hồng hào/dồi dào/quắc thước/Dịch dịch/to lớn/lù lù|z
奕棋=đánh cờ|z
奕芯=Dịch Tâm|z
好哄=dễ dụ|z
好孤单=thật cô đơn|z
好捏=dễ mà bóp|z
好烫=thật nóng/thật là nóng|z
好的=tốt/hay|z
好端端=êm đẹp/tốt lành/tốt/yên lành/hảo đoan đoan/đang yên đang lành|z
好红=thật là đỏ|z
好长好白=thật dài thật trắng|z
好黑=tối quá/thật hắc|z
如恒=như hằng|z
如旧=như trước|z
如松=như tùng|z
如痴=như si/như mê|z
妥妥当当=thỏa đáng|z
姌袅=mảnh khảnh/mảnh mai/cao gầy|z
姣=giảo|z
姣丽=xinh đẹp|z
姣好=mỹ lệ/đẹp đẽ|z
姣姣=Giảo Giảo|z
姣美=đẹp đẽ|z
娇呼急喘=yêu kiều thở gấp|z
娇啼=kiều khóc|z
娇娜=cử chỉ đáng yêu/điệu bộ dễ thương|z
娇滴=kiều tích|z
娇滴滴=nũng nịu/õng ẹo/yểu điệu/kiều tích tích|z
娇痴=ngây thơ đáng yêu/hồn nhiên đáng yêu|z
娇红=mặt hồng hào|z
娇绿=xanh non/xanh mơn mởn|z
娇翠=xanh non/xanh mơn mởn|z
娇黄=vàng nhạt|z
娉娉婷婷=duyên dáng/thướt tha|z
娉婷=thướt tha/duyên dáng/phinh đình|z
婆娑=lượn quanh/lòa xòa/lật đật/lượn vòng/quay tròn/đu đưa/đưa qua đưa lại/bà sa|z
婉婷=Uyển Đình|z
婉晶=Uyển Tinh|z
婉秋=Uyển Thu|z
婉芸=Uyển Vân|z
婠婠=Loan Loan|z
婷婷=Đình Đình/đình đình|z
嫣丽=Yên Lệ|z
嫣奴=Yên nô|z
嫩白=trắng noãn|z
嫪毐=Lao Ái|z
孤伶伶=cô linh linh/lẻ loi|z
孤孤单单=cô đơn|z
孤零零=lẻ loi trơ trọi/cô linh linh/lẻ loi/trơ trọi|z
安啦=yên nào/yên chí|z
安安稳稳=an an ổn ổn|z
安安静静=yên lặng|z
完完整整=hoàn hoàn chỉnh chỉnh|z
实实在在=thật sự/thật thật tại tại/chân thực|z
实挺=thật rất|z
宽宽大大=rộng thùng thình|z
宽宽松松=rộng rãi|z
寂寥=tịch liêu/tịch mịch/buồn tẻ/vắng vẻ trống trải/trống vắng/lặng lẽ mênh mông|z
密匝匝=chi chít/dày đặc|z
密密丛丛=dày dặc/um tùm/tầng tầng lớp lớp|z
密密匝匝=rậm rạp/um tùm|z
密密层层=chi chít/trùng trùng điệp điệp/kín như bưng|z
密密麻麻=lít nha lít nhít/rậm rạp chằng chịt/rậm rạp/chi chít/lít nhít/líu nhíu|z
密麻麻=Mật ma ma|z
寥寂=tịch liêu/tĩnh mịch/buồn tẻ/cô đơn|z
寥寥=rải rác/rất ít/lác đác/cực ít/le que|z
寥廓=mênh mông/mênh mang/bát ngát|z
寥落=thưa thớt/lác đác/lạnh lẽo/trống vắng|z
小叠=xếp nhỏ/chồng nhỏ|z
小呆毛=tiểu ngốc mao|z
小喷=phun nhỏ|z
小娉=Tiểu Phinh|z
小彤=tiểu đồng|z
小悠=Tiểu Du|z
小手小脚=không hào phóng/rụt rè/nhút nhác|z
小淋=tiểu Lâm|z
小白足=chân trắng nhỏ|z
小眯=chợp mắt một chút|z
小胖=tiểu bàn/béo con|z
小迷糊=tiểu mơ hồ|z
小黄漫=eromanga|z
小黑=tiểu Hắc/tiểu hắc|z
尨茸=Mông Nhung|z
层叠=trùng điệp|z
层层叠叠=tầng tầng lớp lớp|z
峥嵘=tranh vanh/cao chót vót|z
崚嶒=Lăng tằng/cao chót vót|z
嵯峨=cheo leo/lởm chởm/hiểm trở/dốc đứng|z
嶙峋=đá lởm chởm/gầy trơ xương/khí thế/khí phách/cương trực/Lân tuân/chỗ sườn núi chập trùng hom hỏm/lân tuân|z
巍峨=nguy nga/sừng sững/cao ngất/đồ sộ|z
巍巍=lồng lộng/cao lớn/sừng sững/cao ngút/cao ngất|z
巍然=sừng sững/đồ sộ/nguy nga/nguy nhiên|z
幢幢=lay động/lắc lư|z
干巴巴=khô cằn/khô nẻ/nhạt nhẽo/vô vị/chán ngắt/tẻ ngắt/không sinh động/buồn tẻ|z
干干净净=sạch sẽ/ngăn nắp/sạch/sạch bóng/sạch sẽ/sạch sành sanh|z
干干地=khô khốc|z
干干脆脆=dứt dứt khoát khoát|z
干红=kiền hồng|z
平平凡凡=bình thường|z
平平整整=bình bình chỉnh chỉnh|z
平平淡淡=bình bình đạm đạm/thanh thanh thản thản|z
平平静静=thật yên lặng|z
年轻气盛=trẻ tuổi nóng tính|z
幽幽=yếu ớt/u u/thăm thẳm/sâu kín/xa xôi/xa thẳm|z
幽幽地=sâu kín|z
幽然=u nhiên|z
幽白=U Bạch|z
幽红=đỏ sậm|z
幽黑=tối tăm/u hắc|z
广藿香=quảng hoắc hương/hương thơm rộng/hoắc hương|z
庸庸碌碌=tầm thường|z
弯弯曲曲=quanh co khúc khuỷu|z
彻地=triệt địa/Triệt Địa|z
彻骨=thấu xương/thấu cốt/vô cùng/cực kỳ/hết sức|z
往左边=hướng bên trái|z
微凉的=hơi lạnh|z
微呆=hơi ngẩn ra|z
微哼=hừ khẽ|z
微怔=liền giật mình/khẽ run/hơi run|z
微愣=sững sờ/vi lăng|z
微的=hơi|z
微眯=nhắm lại/híp lại|z
微茫=mơ hồ/mù mịt/mờ ảo|z
微醺=hơi say rượu|z
微颤颤=khẽ run run|z
心情愉快=tâm tình khoái trá|z
忙忙碌碌=bận rộn/mang mang lục lục|z
忙手忙脚=mang thủ mang cước|z
忙晃=vội lắc|z
忙里忙=vội vội vàng vàng|z
快去快回=đi nhanh về nhanh|z
快手快脚=nhanh tay nhanh chân|z
快放=mau thả|z
快滚=mau cút|z
快闪=tránh mau|z
忽亮忽暗=chợt sáng chợt tối|z
忽冷忽热=lúc lạnh lúc nóng|z
忽大忽小=lúc lớn lúc nhỏ|z
忽忽悠悠=sững sờ/kinh ngạc|z
忽急忽缓=lúc nhanh lúc chậm|z
忽悠=lắc lư/lừa dối/chập chờn/rung rinh/dao động|z
忽悠悠=xiêu vẹo|z
忽明忽暗=lúc sáng lúc tối|z
忽热=chợt nóng|z
忽白忽黑=lúc trắng lúc đen|z
忽红忽白=thoạt đỏ thoạt trắng/lúc xanh lúc trắng|z
忽长忽短=lúc dài lúc ngắn|z
忽闪=vụt sáng/nhấp nháy|z
忽隐忽现=lập loè/thoắt ẩn thoắt hiện|z
忽青忽白=lúc trắng lúc xanh|z
忽青忽红=lúc xanh lúc đỏ|z
忽高忽低=chợt cao chợt thấp|z
怃然=buồn vô cớ|z
怆地呼天=kêu trời kêu đất|z
怏=ưởng|z
怏怏=ấm ức/bất mãn/có vẻ/không hài lòng|z
怏然=không vui/kiêu ngạo/kiêu căng/vênh vang|z
怒冲冲=hầm hầm/giận dữ/đùng đùng nổi giận|z
怒吟=nộ ngâm/gầm lên giận dữ|z
怒哼=tức giận hừ|z
怒的=giận|z
怛然失色=sợ xanh mặt/đột nhiên mất màu|z
急冲=lao nhanh|z
急匆=gấp gáp|z
急匆匆=vội vã/vội vàng/vội vội vàng vàng/vội vã|z
急巴巴=hấp tấp/vội vã|z
急忙忙=vội vàng|z
急急巴巴=hấp tấp vội vàng/vội vàng|z
急急忙忙=vội vội vàng vàng|z
急溜=quan trọng|z
急溜溜=khẩn cấp/gấp gáp/vội vàng|z
急滚=vội lăn|z
急煎煎=vội vàng/hấp tấp|z
急闪=lóe lên/tránh gấp|z
怦然=thình thịch/áy náy|z
怪里怪气=kỳ dị/lập dị/kỳ cục/lầm lì khó hiểu/khác thường/quái dị|z
怯声怯气=nói năng luống cuống|z
怯怯=sợ hãi|z
怯生生=rụt rè/nhút nhát e lệ/khiếp sinh sinh/nhút nhát/khiếp sinh sinh/rụt rè|z
恍忽=hoảng hốt/ngơ ngẩn/ngẩn ngơ|z
恍恍惚惚=hốt hoảng/lờ mờ/hoảng hoảng hốt hốt|z
恍若=phảng phất giống như/bừng tỉnh/làm như/dường như|z
恭恭敬敬=cung cung kính kính/cung kính|z
恭敬地=cung kính/cung kính mà|z
恶噩=ác mộng|z
恶狠狠=hung dữ/tàn bạo/hung tợn/hung ác|z
恹恹=mệt mỏi/suy nhược/uể oải|z
悄寂=tiễu tịch|z
悄悄=lặng lẽ/nhẹ nhàng/yên ắng|z
悄悄地=lặng lẽ/lén lút|z
悄默声=lặng tiếng|z
悒=ấp|z
悒悒=lo lắng không yên|z
悠忽=nhàn rỗi/nhàn nhã/nhàn hạ|z
悠悠=ung dung/lo lắng/lâu dài/xa tắp/xa vời/dài dằng dặc/nhiều/đông đúc/thong thả/khoan thai/hoang đường/khoa trương/du du/dằng dặc/xa xôi|z
悠悠忽忽=sững sờ/kinh ngạc|z
悠悠扬扬=du du dương dương|z
悠悠然=khoan thai|z
悠悠荡荡=trôi giạt từ từ/lôi cuốn từ từ/trôi dạt từ từ|z
悠然=khoan thai/thản nhiên/thong thả/nhởn nhơ|z
悠荡=đong đưa/đu đưa/đung đưa|z
悠长=kéo dài/dài lâu/dài/lâu/du trường|z
悠闲=nhàn nhã/nhàn nhã đi chơi/thong dong|z
悠闲地=nhàn nhã|z
悲啼=bi thương khóc|z
悲悯=thương xót/thương hại|z
惘怅=sững sờ|z
惘然=ngơ ngẩn/thất vọng/chán ngán/chán nản/buồn rầu|z
惨兮兮=thảm hề hề/thảm hại|z
惨哼=rên thảm/thê thảm rên lên|z
惨淡=thảm đạm/u ám/âm u/tăm tối/xỉn màu/thê lương/thê thiết/tiêu điều/xơ xác/không sáng sủa/ế ẩm/vất vả trầy trật/bù đầu bù cổ/tối mày tối mặt|z
惨然=đau thương/lộ vẻ sầu thảm/bi thảm/thê lương|z
惨白=trắng bệch/ảm đạm/thảm đạm/nhợt nhạt/phờ phạc|z
惨绿=xanh lét/xanh thê thảm|z
惴惴=lo sợ/bất an/bộ dạng kinh sợ/bộ dạng khiếp đảm/chúy chúy|z
惶惶然=hoảng sợ|z
惶然=lo sợ không yên/hoảng sợ|z
惺惺=tỉnh táo/thông minh/người thông minh/giả bộ/giả vờ giả vịt|z
愣头愣脑=lăng đầu lăng não/cứng đầu cứng cổ/bướng bỉnh/liều lĩnh/ẩu|z
愣头青=lăng đầu thanh/ lăng đầu thanh/trẻ con miệng còn hôi sữa/lăng đầu thanh (*thanh niên sức trâu)|z
愣神儿=ngẩn ra/choáng váng|z
慌慌张张=vội vàng hấp tấp/hoảng hoảng trương trương/hoang mang hoảng loạn|z
慌手忙脚=tay chân luống cuống/luống cuống tay chân|z
慌手慌脚=hoảng thủ hoảng cước/cuống chân cuống tay/chân tay luống cuống|z
慌神儿=ruột gan rối bời/tinh thần hoang mang/hoang mang|z
慌里慌张=vội vội vàng vàng/cuống cuồng/cuống quýt/líu quíu|z
慢吞吞=chậm rãi/chậm quá/rì rì/chậm rì/chậm rì rì|z
慢悠悠=chậm rãi/chậm rì rì/chậm như rùa|z
慢慢儿=từ từ|z
慢慢悠悠=chậm rãi từ từ|z
慢慢腾腾=chậm rì rì/ì à ì ạch/chậm chạp|z
慢热=chưa nóng|z
慢腾腾=chầm chập/chậm chạp/chậm rãi|z
憨乎乎=thật thà chất phác/thật thà phúc hậu|z
憨厚老实=phúc hậu thành thật/thật thà và trung thực|z
懒洋洋=uể oải/lười biếng/bộ dạng uể oải/tướng lờ đờ|z
懒熊=gấu lợn|z
懵然=mộng nhiên|z
戆头戆脑=đầu óc ngu đần/ngu ngốc đần độn|z
戆直=cương trực thẳng thắn|z
战沉=đánh chìm|z
扁平足=bệnh chân bẹt|z
扎扎实实=mạnh mẽ/vững chắc|z
扑愣=phác lăng|z
扑扑=phác phác/nhào lộn/nhào tới|z
扑簌簌=đổ rào rào|z
扑闪=chớp/nháy|z
打趸儿=mua sỉ/bán sỉ/tóm lại/tổng cộng/gộp|z
打铁趁热=rèn sắt khi còn nóng|z
扭扭捏捏=nhăn nhăn nhó nhó|z
扯来扯去=lấy tới lấy lui|z
拖拖拉拉=lề mà lề mề|z
拨雨撩云=thăm dò đối phương|z
挑挑拣拣=chọn chọn lựa lựa|z
挑的=chọn|z
挤扁=đè bẹp|z
挺的=ưỡn lên|z
挺老旧=rất cũ kỹ|z
挺舒服=thật thoải mái|z
捶胸跌足=đấm ngực dậm chân/đâm ngực và rơi xuống|z
搞来搞去=đảo đi đảo lại|z
摁钉儿=đinh rập/đinh mũ|z
摇摇晃晃=lung la lung lay/loạng choà loạng choạng|z
摇晃=lay động/đong đưa/lung lay|z
摇来晃去=lắc qua lắc lại|z
摇滚=Rock n' Roll/diêu cổn|z
摇蓝=diêu lam|z
摇蜜=quay mật ong|z
摸黑=sờ soạng/bôi đen|z
敢肯定=dám khẳng định|z
敦敦实实=cường tráng chắc nịch|z
整整齐齐=chỉnh chỉnh tề tề/chỉnh tề/thật chỉnh tề|z
文绉绉=vẻ nho nhã/trưởng giả|z
斐然=nổi bật/văn hoa/đẹp đẽ/hiển nhiên/rõ rệt/phỉ nhiên|z
斑斑=loang lổ/lốm đốm/nhiều vết/chấm/tàn nhang|z
斑斓=lộng lẫy/sặc sỡ/rực rỡ|z
斑比=Bambi|z
斑白=hoa râm/muối tiêu/ban bạch|z
斑秃=bệnh rụng tóc|z
斑驳=pha tạp/loang lổ/sặc sỡ/nhiều màu/loang lổ nhiều màu|z
料峭=se lạnh/hơi lạnh/lành lạnh|z
断梗飘蓬=phiêu bạt khắp nơi|z
无恒=không bền lòng/không kiên định|z
无恙=không việc gì/khoẻ mạnh/không thiệt hại|z
无悠=Vô Du|z
无懈=vô giải|z
无瑕=không tì vết/không chút tì vết|z
无穷小=vô cùng bé/vô cùng nhỏ|z
无良=vô lương/bất lương|z
旮旯儿=góc/xó/hốc/nơi hẻo lánh nhỏ bé/nơi chật hẹp vắng vẻ|z
明明白白=rõ ràng/rõ rành rành/tỉnh táo/minh mẫn/quang minh chính đại/rất rõ ràng/rõ rõ ràng ràng|z
明晃晃=sáng loáng/sáng ngời|z
昏幽=u ám|z
昏昏沉沉=mê man/hỗn loạn/đầu óc không tỉnh táo/thiêm thiếp/mơ mơ màng màng|z
昏昏然=tối tăm|z
昏沉=u ám/hôn mê/ảm đạm/u tối/lờ mờ/mê man/mê mẩn/thiếp/thiêm thiếp|z
昏沉沉=mờ mịt/chìm vào hôn mê|z
昏花=mờ/mắt mờ/hoa mắt|z
昏蒙=ngu muội/mơ hồ|z
昏蒙蒙=tối mù mịt|z
昏黄=mờ nhạt/lu mờ/lờ mờ/ảm đạm/hoàng hôn|z
昏黑=đen kịt/tối om/tối sầm/tối đen/tối mò/tối mù mịt/tối mờ|z
昧良心=trái lương tâm|z
昭昭=sáng tỏ/sáng sủa/rõ ràng/rõ rệt|z
昭然=rất rõ ràng/rất rõ rệt/chiêu nhiên|z
晃悠=lắc lư/lay động/lật bật/run rẩy/hoảng du|z
晃悠悠=hoảng du du|z
晃晃=lắc lắc/lắc lư|z
晃晃悠悠=lảo đảo/lắc lư/loạng choạng|z
晃晃荡荡=đung đung đưa đưa|z
晃来晃去=lúc ẩn lúc hiện|z
晃花=choáng váng|z
晕乎乎=chóng mặt|z
晕地=chóng mặt|z
晕晕乎乎=chóng mặt/ngất ngất ngây ngây|z
晦暗=ảm đạm/đen tối/buồn bã/u tối/u ám/tối tăm/mờ mịt|z
暖冰=noãn băng|z
暖暖=ủ ấm/ấm áp|z
暖暖的=ấm áp|z
暖洋洋=ấm áp|z
暖烘烘=ấm áp dễ chịu|z
暖黄=vàng ấm|z
暗沉沉=âm u|z
曲曲弯弯=quanh quanh co co/uốn khúc/khúc khuỷu/ngoằn ngoèo|z
曲曲折折=quanh co|z
最佳=tốt nhất/điều kiện tốt nhất/điều kiện thuận lợi nhất/cao nhất|z
最嫩滑=trơn mềm nhất|z
最浓=dày đặc nhất|z
最淡定=bình tĩnh nhất|z
最糟=khó khăn nhất|z
最红=nổi tiếng nhất/hot nhất/đỏ nhất|z
最绿=xanh nhất|z
最老旧=cũ kỹ nhất|z
最舒服=thoải mái nhất|z
最里层=tầng trong nhất|z
最里端=phía trong cùng nhất/phía trong cùng|z
最隐蜜=ẩn mật nhất|z
最顶=cao nhất|z
最高处=chỗ cao nhất|z
最高层=tầng cao nhất/cao tầng nhất|z
服服帖帖=ngoan ngoãn/dễ bảo/biết vâng lời/phục phục thiếp thiếp|z
朗爽=sang sảng|z
朦朦=mờ nhạt/mờ ảo/mông lung|z
朦朦胧胧=mông lung/mơ hồ/mơ mơ hồ hồ|z
木讷=chất phác/chậm chạm/hiền như khúc gỗ/hiền như bụt/hiền lành/đần độn|z
松松垮垮=lỏng lỏng lẻo lẻo|z
枉然=uổng công/phí công/uổng phí|z
枯朽=khô mục/mủn/mục rữa/mục nát|z
枯瘦=khô gầy/gầy khô/gầy đét|z
枯黄=khô héo/khô vàng|z
某一方面=ở một phương diện khác|z
柔依=Nhu Y|z
梆硬=cứng/rắn|z
森然=sâm nhiên/lành lạnh/sừng sững/dày đặc/um tùm/uy nghiêm đáng sợ|z
模模糊糊=mơ mơ hồ hồ|z
模糊地=mơ hồ|z
正堂=chính đường/chính đường|z
正正好好=vừa vừa vặn vặn|z
正正当当=chính chính đương đương|z
正比=có quan hệ trực tiếp/số biến đổi tương ứng/tỉ lệ/tỉ lệ thuận|z
正红=chính hồng|z
正酣=say sưa|z
歪曲=bẻ cong/uốn éo/xuyên tạc/bóp méo|z
歪歪=méo mó|z
歪歪扭扭=xiêu xiêu vẹo vẹo/nguệch ngoạc/cẩu thả|z
歪歪斜斜=cong vẹo/vòng vo|z
死死地=gắt gao/chặt chẽ|z
死气沉沉=âm u đầy tử khí/không khí trầm lặng/không khí đầy vẻ đe doạ|z
死的=chết|z
死磕=cùng chết|z
毒辣辣=cay độc|z
毛刷=chổi lông|z
毛毛躁躁=nôn nôn nóng nóng/mao mao táo táo|z
毛烘烘=lông lá xồm xàm/lông rậm/lông lá bù xù|z
毛茸茸=lông xù/lông lá xồm xàm/lông lá|z
气冲冲=nổi giận đùng đùng/tức điên người/giận đùng đùng|z
气呼呼=thở phì phì/thở hồng hộc/thở hổn hển/thở phì phò|z
气咻咻=thở hồng hộc/thở hổn hển/khí hưu hưu|z
气哼哼=hầm hừ/hầm hừ tức giận|z
气喘嘘嘘=hơi thở dồn dập/thở hào hển/thở hổn hển|z
气嘟嘟=tức xì xì|z
气抖冷=tức lạnh run|z
气昂昂=khí phách hiên ngang/khí thế bừng bừng|z
气歪=tức điên|z
气焰熏天=khí diễm ngút trời/kiêu ngạo|z
水晶般=như thủy tinh|z
水汪=thủy uông|z
水汪汪=ngập nước/long lanh nước/thủy uông uông/nước long lanh|z
水淋淋=toàn là nước/ướt đẫm|z
水烫=phỏng|z
水飘=thủy phiêu|z
永凡=Vĩnh Phàm|z
永恒=vĩnh hằng/vĩnh viễn/mãi mãi/đời đời bền vững/Vĩnh Hằng|z
汗涔涔=đẫm mồ hôi|z
汗淋淋=mồ hôi nhỏ giọt/mồ hôi đầm đìa|z
汗漉漉=đẫm mồ hôi/mồ hôi đầm đìa|z
汗褂儿=áo lót/áo cộc|z
汲深绠短=tài hèn sức mọn/Múc nước giếng sâu mà dây kéo lại quá ngắn. Tỉ dụ gánh vác việc quá sức mình. § Nguồn gốc: ◇Trang Tử 莊子: Trữ tiểu giả bất khả dĩ hoài đại/cảnh đoản giả bất khả dĩ cấp thâm 褚小者不可以懷大/綆短者不可以汲深|z
汹汹=rào rạt/khí thế to lớn/náo nhiệt/ồn ào/hung hăng|z
沉伦=trầm luân|z
沉浑=trầm hồn|z
沉熠=Trầm Dập|z
沉甸甸=trĩu nặng/nặng trịch/nặng trình trịch/trầm điện điện|z
油乎乎=bóng nhẫy/đầy dầu/du hồ hồ|z
油亮亮=trơn sang sáng|z
油汪汪=béo ngậy/nhiều mỡ/sáng bóng/bóng loáng|z
油然=thản nhiên/tự nhiên/bốc/bay/thăng hoa/tự nhiên nảy sinh/du nhiên|z
油煎火燎=cực kỳ lo lắng|z
油绿=màu xanh bóng|z
油腻腻=bóng mỡ|z
油黑=đen bóng|z
泠然=thánh thót/véo von|z
泪汪汪=nước mắt lưng tròng/rưng rưng nước mắt/ứa nước mắt|z
泪涟涟=nước mắt lã chã/nước mắt ròng ròng|z
泰然=thản nhiên/bình thản/bình tĩnh/ung dung/thái nhiên|z
泱泱=mênh mông/to lớn/khí phách to lớn|z
洁丝=Jess|z
洁净=sạch sẽ/làm sạch/sạch sẽ|z
洁拉=Kyoshila|z
洁白=trắng noãn/trắng tinh/trắng toát/trong trắng/trong sạch/tinh khiết/thanh khiết/thuần khiết|z
洁芸=Khiết Vân|z
洋洋洒洒=lưu loát/phong phú/dương dương sái sái|z
活泼泼=hoạt bát bát|z
活溜=lung lay/không kiên cố/linh hoạt/nhanh nhẹn|z
活的=sống/công việc|z
活脱脱=hiển nhiên/hoạt thoát thoát/nhanh nhẹn|z
浅淡=nhạt nhẽo/hời hợt/nhạt/lợt|z
浅白=trắng nhạt|z
浅黑=đen nhạt|z
浑噩=ngây ngô/đần độn/ngu dốt/dốt nát/hồn ngạc|z
浑浑=mơ màng|z
浑浑噩噩=ngơ ngơ ngác ngác/đần độn/ngu đần/vô tri vô giác/ngây ngô dại dột/hồn hồn ngạc ngạc/đần độn u mê|z
浑然=toàn vẹn/hồn nhiên/trọn vẹn/nguyên vẹn/hoàn chỉnh/hoàn toàn|z
浓浓=nồng đậm/nồng nặc|z
浓绿=nồng lục|z
浓黑=đen đặc/đen đậm/đen ngòm|z
浩茫=mênh mông/bát ngát/vô biên/đầy/nhiều|z
涓涓=chảy nhỏ giọt|z
涓滴=giọt nước/một giọt/một tí/một chút/từng li từng tí/giọt nhỏ|z
涔涔=chảy ròng ròng/ròng ròng/rả rích/tầm tã/dầm dề/giàn giụa/ràn rụa/đầm đìa/nhễ nhại/trời âm u/buồn rầu/ủ dột/u sầu|z
涟洏=ràn rụa/sướt mướt|z
淅沥沥=tí tách|z
淅淅沥沥=tí tách tí tách|z
淡冷=lãnh đạm|z
淡淡=nhàn nhạt/thản nhiên/nhạt/lợt/mờ/lờ mờ/lăn tăn/nhấp nhô/gợn sóng|z
淡淡地=nhàn nhạt|z
淡然=lạnh nhạt/đạm nhiên/thản nhiên/lãnh đạm/dửng dưng/hờ hững/không chú ý|z
淡红=đỏ nhạt/màu hồng|z
淡绿=xanh nhạt/lục nhạt|z
淡若=nhạt như|z
淡蓝=lam nhạt|z
淡雅=thanh nhã/trang nhã/nền nã|z
淡青=xanh nhạt/màu xanh nhạt|z
淡黄=vàng nhạt|z
淡黑=đen nhạt|z
混混噩噩=mơ mơ hồ hồ/trộn lẫn|z
清幽=thanh u/đẹp và tĩnh mịch/thanh tịnh và đẹp đẽ|z
清微天=Thanh Vi Thiên|z
清清亮亮=trong veo|z
清清楚楚=rõ ràng/tinh tường/rành mạch/thanh thanh sở sở/rõ rõ ràng ràng|z
清清爽爽=nhẹ nhàng thoải mái/nhẹ nhàng mà sung sướng|z
清清白白=thanh bạch/trong sạch|z
清零=về không/thành số 0/thanh linh|z
温吞=nguội/không lạnh không nóng/không trôi chảy/không ăn nhập gì/ôn thôn|z
湛然=trầm tĩnh/trạm nhiên|z
湛着=đứng|z
湛蓝=xanh thẳm/trạm lam/xanh thắm/xanh da trời|z
湛蓝湛蓝=xanh thẳm|z
湿乎乎=ướt hồ hồ/ướt đẫm|z
湿冷=ướt lạnh|z
湿地=vùng đất ngập nước/đất ngập nước/thấp địa|z
湿淋=ẩm ướt|z
湿淋淋=ướt đẫm/ướt sũng/ướt dầm dề|z
湿漉=ướt sũng|z
湿漉漉=ướt sũng/ướt dề/ướt đầm dề/ướt át/ướt rượt/ướt sườn sượt/ướt nhẹp|z
湿热=nóng ướt/ấm|z
溜光=bóng loáng/bóng lộn/láng mượt/hết sạch/không còn gì/hết nhẵn|z
溜冰=trượt băng/trượt tuyết/trượt pa-tanh/lưu băng|z
溜圆=căng tròn/lưu viên/tròn xoe|z
溜平=nhẵn nhụi/nhẵn thín|z
溜弯=tản bộ|z
溜来溜去=trồi lên trượt xuống/lưu lai lưu khứ/qua lại|z
溜溜=linh lợi/bóng bẩy|z
溜边=dựa vào/tránh/lánh|z
滑不唧溜=trơn như mỡ/trơn như đổ mỡ/trơn như thoa mỡ|z
滑溜=trơn trượt/rán/chiên/trơn nhẵn/trơn bóng/bóng láng/nhẵn bóng/hoạt lưu|z
滑溜溜=trơn mượt/trơn tuồn tuột|z
滑漉漉=trơn trườn trượt|z
滔天=ngập trời/cuồn cuộn ngất trời/tày trời/ngút trời|z
滔滔=cuồn cuộn/thao thao/cuần quận/dào dạt/liên tiếp/liên tiếp không ngừng/cuồn cuộn|z
滚圆=tròn vo/tròn xoe/tròn lẳn/tròn vành vạnh/tròn trùng trục|z
滚快=cút nhanh|z
滚来滚去=lăn qua lăn lại|z
滚滚=cuồn cuộn/lăn đều/liên tục/ào ào/như nước/không dứt|z
滚烫=nóng hổi/nóng bỏng/nóng hầm hập|z
滚热=nóng bỏng/nóng hổi/nóng hầm hập/cổn nhiệt|z
滚粗=kút ra/cuộn thô|z
滚边=đường viền/viền/viền mép|z
滚远点=cút xa một chút|z
满满当当=tràn đầy/đầy ắp|z
满脚=đầy chân|z
滴溜儿=tròn/tròn xoe/tròn vành vạnh/tròn vo/quay tít/chảy xiết|z
滴溜溜=quay tròn/xoay tít/cuộn tròn/cuộn chảy/tích lưu lưu/xoay tròn|z
滴粉搓酥=da mặt trắng mịn|z
滴翠=xanh/xanh tươi|z
漂漂亮亮=thật xinh đẹp/ngon lành cành đào|z
漆暗=tất ám|z
漆漆=chăm chú|z
漆红=sơn đỏ|z
漆黑=đen nhánh/đen kịt/đen như mực|z
漠然=hờ hững/thờ ơ/không để ý/thản nhiên|z
漫天=đầy trời/khắp bầu trời/không hạn độ/thấu trời|z
潇潇=rả rích/Tiêu Tiêu/mưa lất phất/mưa bụi/mưa phùn|z
潇潇洒洒=tiêu tiêu sái sái|z
潮呼呼=ẩm sì sì|z
潸潸=lã chã/tuôn rơi/lưng tròng|z
潸然=lã chã/ròng ròng|z
潺=sàn|z
潺弱=yếu kém|z
潺湲=lững lờ|z
潺潺=róc rách|z
澄净=trong vắt/trong sạch|z
澄莹=trong sáng|z
澄蓝=lam trong|z
濛濛=mênh mông/hãy nói|z
火光冲天=ánh lửa ngút trời|z
火冒=lửa bốc/lửa giận bốc|z
火冰=hỏa băng|z
火烫=nóng/rất nóng/nóng như thiêu/nóng vô cùng/uốn tóc/hỏa năng|z
火燎=lửa cháy|z
火的=lửa/hỏa|z
火红=hỏa hồng/lửa đỏ/đỏ choét/đỏ rực/đỏ như lửa/hưng thịnh/phồn thịnh/náo nhiệt/sôi nổi/hoả hồng|z
火辣=nóng bỏng/cay|z
火辣辣=nóng bỏng/nóng rát/hỏa lạt lạt/hừng hực/đau rát/rát/nhức/đau nhức/nhức nhối/nóng bừng/nóng ruột/sốt ruột/lời lẽ sắc bén/mạnh mẽ/đầy sức thuyết phục|z
灰冷=nguội lạnh/chán nản/ngán ngẩm|z
灰常=vô cùng/phi thường|z
灰扑扑=xám xịt/bụi bẩn|z
灰暗=u ám/ảm đạm/u tối/không rõ ràng/xám xịt|z
灰朦朦=xám xìn xịt|z
灰沉沉=ảm đạm/u ám|z
灰溜=hôi lưu|z
灰溜溜=xám xịt/xám ngắt/xám xì/xám xì xám xịt/ảo não/chán chường/ỉu xìu/chán nản/hôi lưu lưu|z
灰白=xám trắng/trắng xám/muối tiêu/màu xám|z
灰红=đỏ xám|z
灰绿=xanh xám|z
灰苍苍=xám mênh mang|z
灰蒙=mông mông bụi bụi|z
灰蒙蒙=tối tăm mờ mịt|z
灰躯糜骨=thịt nát xương tan|z
灰黄=vàng xám|z
灰黑=xám đen/nâu đen/tro đen|z
灼急=lo lắng/lo nghĩ/cảm thấy lo lắng|z
灼灼=sáng rực/sáng quắc/sáng sủa/sáng|z
灼烈=hừng hực|z
灼烫=nóng bỏng|z
灼热=nóng rực/nóng bỏng|z
灼然=sáng tỏ|z
灿灿黄=vàng tươi/rực|z
炎黄=Viêm Hoàng|z
炯亮=long lanh sáng ngời|z
炯炯=sáng ngời/lấp lánh/long lanh|z
烁烁=nhấp nháy/lấp lánh|z
烂漫=rực rỡ/sặc sỡ/lộng lẫy/hồn nhiên/chân chất/lạn mạn|z
烂灿=xán lạn|z
烂然=rạng rỡ/rỡ rỡ/rực rỡ|z
烂熟=rục/nhừ/mềm rục/thuộc lòng/thuộc như cháo/thuộc nằm lòng/lạn thục|z
烂糊=nhừ/nát/rục|z
热乎=nóng hổi/nóng hầm hập/nhiệt hồ|z
热乎乎=nóng hầm hập/nóng hổi|z
热呼呼=nóng hừng hực/ấm áp|z
热气腾腾=nóng hôi hổi/nóng hổi|z
热烘烘=nóng hừng hực/nóng rực|z
热烫=nóng bỏng|z
热热闹闹=vô cùng náo nhiệt/vô cùng - náo nhiệt/tưng bừng/sôi nổi/vui vẻ/nhiệt nhiệt nháo nháo|z
热腾腾=nóng hổi/nóng hầm hập|z
热辣辣=nóng rát/bỏng/nóng ran/nóng bỏng|z
焕然=rực rỡ/trở thành|z
焗油=hấp dầu|z
煞白=trắng bệch/tái mét/tái xanh/xanh xao|z
熊扑=hùng phác|z
熙攘=rộn ràng|z
熠熠=rạng rỡ/lấp lánh|z
狗彘不若=không bằng chó lợn/không bằng heo chó|z
狠巴巴=hằn học/hung ác|z
狭仄=chật hẹp|z
狭长=hẹp dài|z
猩红=tinh hồng/màu đỏ tươi/đỏ tươi/đỏ thắm|z
猩红热=bệnh tinh hồng nhiệt|z
环堵萧然=phòng trống không/phòng nghèo nàn|z
琅嬛=lang hoàn|z
琅玕=đá đẹp|z
琅琊=Lang Gia|z
琐琐碎碎=vụn vặt|z
瑟瑟=run rẩy/lạnh run/tiếng lách tách/xào xạc/run lẩy bẩy/run bần bật|z
瑰丽=mỹ lệ/đẹp đẽ/đẹp hiếm có/tuyệt đẹp/đẹp lạ thường/lộng lẫy/tráng lệ/nguy nga/côi lệ|z
瑰异=đẹp lạ thường/vô cùng đẹp/hoa lệ/tráng lệ/nguy nga/lộng lẫy|z
璀=thôi|z
璀璨=óng ánh/sáng chói/ánh sáng ngọc/lóng lánh/rực rỡ/lộng lẫy|z
瓜瓞绵绵=con đàn cháu đống/dưa hấu kéo dài|z
甚平=Jinbe|z
甚急=quá gấp|z
甚浓=rất đậm/rất đặc/vô cùng|z
甚祥=rất rõ ràng|z
甚笃=rất sâu đậm/rất dày|z
甜丝丝=ngọt lịm/ngọt/vui vẻ/vui sướng/hạnh phúc|z
甜依=Điềm Y|z
甜津津=ngon ngọt/ngọt lịm/ngọt như mía lùi|z
甜滋滋=ngọt ngào|z
甜甜地=ngọt ngào|z
甜甜蜜蜜=điềm điềm mật mật|z
甜蜜蜜=ngọt ngào|z
疏疏落落=sơ sơ lạc lạc|z
疙疙瘩瘩=không trôi chảy/vướng víu/rắc rối/khó khăn/nan giải/trở ngại/gay go/gập ghềnh/không thuận lợi/ngật ngật đáp đáp/gập ghềnh nhấp nhô|z
疯疯癫癫=điên điên khùng khùng/như điên như dại/hoá rồ hoá dại|z
疯疯颠颠=điên điên khùng khùng|z
疯癫=điên/bị điên/phong điên/điên cuồng|z
疯的=bị điên/điên|z
疯颠=bị điên|z
病怏怏=có vẻ bệnh|z
病恹恹=ốm yếu/đau yếu/bệnh thoi thóp/bệnh tật triền miên|z
病歪歪=bệnh tật/đau bệnh|z
病病歪歪=ốm đau bệnh tật/còm cõi quặt quẹo|z
病笃=bệnh nặng/bệnh trầm trọng|z
痒酥酥=tê ngứa|z
痛地=đau đến|z
痛痛快快=thống thống khoái khoái/sung sướng/thẳng thắn|z
痛的=đau|z
痴呆=si ngốc/ngu/ngu ngốc|z
痴痴=si ngốc|z
痴痴地=si ngốc|z
瘦小=nhỏ gầy/bé gầy/gầy đét/gầy loắt choắt/gầy nhỏ|z
瘦溜=mảnh mai/mảnh dẻ/gầy nhom/gầy còm|z
瘦瘦=gầy gò/gầy teo|z
瘦黄=vàng vọt|z
瘪塌塌=ốm/gầy|z
瘪瘦=mỏng/mảnh/ốm/gầy|z
白不呲咧=phai màu/bạc phếch/nhạt phèo/thôi màu/bạc màu/nhạt/lạt|z
白乎乎=trắng xoá|z
白刷刷=trắng loá|z
白惨惨=trắng toan toát|z
白晃晃=sáng choang/sáng trưng/trắng sáng|z
白疼=yêu thương/bạch thương|z
白白净净=trắng tinh/bạch bạch tịnh tịnh/trắng nõn nà|z
白白胖胖=trắng trắng mập mập/béo trắng|z
白皑皑=trắng phau phau/trắng xoá/trắng phau|z
白苍苍=xanh xao/nhợt nhạt/xanh xám|z
白茫=bạch mang|z
白茫茫=trắng xoá/mịt mù/trắng mênh mông/trắng xóa|z
白辛苦=uổng công khổ cực|z
白里透红=trong trắng lộ hồng/trong bạch lộ hồng|z
白闪闪=trắng chói|z
皎好=trắng sáng|z
皎月=trăng sáng|z
皎洁=trong sáng/sáng tỏ/sáng trong/trong trắng|z
皎白=sáng trong/sáng tỏa/sáng vằng vặc|z
皎皎=sáng trong/sáng vằng vặc/sáng ngời|z
皑=ngai|z
皑皑=trắng ngần/trắng như tuyết/trắng tinh/trắng xoá/trắng xóa|z
皱巴巴=dúm dó/nhiều nếp nhăn|z
皱的=nhíu|z
皱皱巴巴=nhăn nhăn nhúm nhúm/trứu trứu ba ba/nhăn nhúm|z
盈盈=doanh doanh/uyển chuyển/nhẹ nhàng/dịu dàng/trong suốt/trong vắt/trong trẻo/dáng đẹp/tràn đầy/yêu kiều|z
盎然=dạt dào/chan chứa/tràn trề/dồi dào/đầy/đầy dẫy|z
直勾勾=trực câu câu/trừng trừng|z
直愣=sững sờ, ngẩn người|z
直愣愣=trực lăng lăng/thẳng tắp|z
直挺=ưỡn thẳng|z
直挺挺=thẳng tắp/thẳng đờ/trực đĩnh đĩnh|z
直撅撅=thẳng tắp/thẳng đứng/thẳng đuột|z
直溜=thẳng tắp/thẳng đứng/thẳng|z
直溜溜=thẳng tắp/thẳng đứng|z
直盯盯=chăm chú|z
直直地=thẳng tắp|z
直瞪瞪=nhìn thẫn thờ/nhìn thất thần|z
直闪=trực thiểm|z
相媲美=cùng so sánh/cùng sánh vai|z
着着实实=xác xác thực thực|z
瞄来瞄去=ngắm tới ngắm lui|z
短平快=đập bóng/ngắn ngày/ngắn hạn|z
短短=ngắn ngủi/ngắn ngủn/ngắn/rất ngắn/ngăn ngắn|z
短粗=nhỏ bé/vạm vỡ/thấp đậm|z
短骨=xương ngắn|z
矮墩墩=thấp lè tè/lùn tịt/mập lùn/béo lùn/bè bè|z
矮小=thấp bé/lùn tịt/còi cọc/nhỏ xíu/nhỏ thấp|z
矮粗=to lùn|z
破旧=cũ nát/cũ rách|z
破破烂烂=rách rách rưới rưới/rách tung toé|z
硬挺=gắng gượng/cố chịu/cắn răng chịu đựng|z
硬撅撅=cứng/cứng ngắc/máy móc/cứng đơ/cứng nhắc|z
硬梆梆=mất thăng bằng/rắn câng câng|z
硬磕=chơi liều|z
硬蹭=cứng cọ|z
碧幽=Bích U|z
碧绿=xanh biếc/bích lục/biếc/biếc xanh/xanh ngát/xanh ngắt|z
碧蓝=xanh lam/xanh biếc|z
磕巴=nói lắp/nói cà lăm/ngắc ngứ/ấp úng/người nói lắp/người nói cà lăm|z
磕磕巴巴=lắp ba lắp bắp/dập đầu/Lắp ba lắp bắp|z
磕磕撞撞=loạng choạng/lảo đảo|z
磕磕绊绊=gập ghềnh/mấp mô/xóc/dằn xóc/khập khiễng/khó khăn/trắc trở/cản trở/trở ngại/gập ghềnh trắc trở|z
磕绊=khái bán|z
磨磨蹭蹭=lề mà lề mề/ma ma thặng thặng/phiền phiền nhiễu nhiễu|z
磨蹭=lề mề/mài cọ/bần thần/ma thặng/ngơ ngác/lê nhẹ/đi chầm chậm/lê chầm chậm/quấy rầy/làm phiền/lèo nhèo/kì kèo/mè nheo|z
神祇=thần linh/thần thánh/thiên thần|z
神秘兮兮=thần thần bí bí/vô cùng thần bí|z
秀婷=Tú Đình|z
秃秃=trơ trọi|z
稀哩哗啦=hi lý hoa lạp|z
稀巴烂=nhão nhoẹt/hi ba lạn/nhão nhoẹt/nát bét|z
稀溜溜=loãng tuếch/rất loãng|z
稀稀拉拉=thưa thớt/lác đác/lơ thơ/lưa thưa|z
稀稀疏疏=rất thưa thớt/thưa thớt trống vắng|z
稀稀落落=thưa thớt/lất pha lất phất|z
稀糟=tệ hại/tồi tệ/nát|z
稀里哗啦=ào ào/khóc như mưa/hi lý hoa lạp|z
稀里糊涂=mơ mơ hồ hồ/đần độn, u mê/hi lý hồ đồ|z
稳稳地=vững vàng/vững vàng mà|z
空悠=không rời|z
空气清新=không khí trong lành|z
空洞洞=trống trơn/trống không/rỗng/trống huơ trống hoác/vắng vẻ/trống rỗng/trống huơ trống hoác|z
空空洞洞=trống rỗng|z
空空荡荡=trống rỗng|z
空荡荡=trống rỗng/vắng vẻ/trống không|z
空落落=vắng vẻ/hiu quạnh/cô đơn/trống vắng/trống trải/trống không|z
端的=quả nhiên/đích xác/quả thực/thực/thực ra/đích thực/rốt cuộc/cuối cùng/đầu đuôi/diễn biến/(rốt cuộc) quả nhiên|z
端端正正=đoan đoan chính chính/đoan đoan chính chính/nghiêm túc|z
笃实=ngay thẳng/thật thà/chân thành/thiết thực/vững vàng/chắc chắn|z
笃笃=thành khẩn|z
笑吟吟=mỉm cười/cười mỉm/cười dài/cười mím chi/cười tủm tỉm|z
笑呵呵=cười ha hả/cười ha ha|z
笑哈哈=cười ha hả|z
笑嘻嘻=cười hì hì/cười mỉm/cười mỉm chi|z
笑天=Tiếu Thiên/cười trời|z
笑死=chết cười/cười ngạo/cười chết|z
笑盈盈=cười nhẹ nhàng/cười khanh khách/cười dịu dàng|z
笑眯眯=cười tủm tỉm/cười híp mắt/cười tít mắt|z
笑闹=cười đùa/cười đùa ầm ĩ|z
笔挺=thẳng/phẳng phiu/thẳng thớm/thẳng đứng/bút đĩnh/thẳng tắp|z
笔直=thẳng tắp/trực tiếp/không quanh co, úp mở/ngay thẳng/chính trực/thẳng thắn/chân thực|z
简简单单=vô cùng đơn giản/đơn giản|z
簌=tốc|z
簌簌=rì rào/tuôn rơi/vi vu/lã chã|z
粉嘟嘟=mũm mĩm hồng hồng/mập mạp trắng trẻo|z
粉嫩=phấn nộn/béo mập/trắng mịn/trắng nõn|z
粉扑扑=phấn phác phác/nhào phở|z
粘糊糊=dinh dính|z
粼=lân|z
粼粼=lăn tăn/trong trẻo|z
糊糊涂涂=mơ hồ/hồ đồ/ngớ ngẩn|z
糊里糊涂=mơ hồ/hồ đồ/hồ lý hồ đồ/ngơ ngơ ngác ngác|z
糟糕透顶=hỏng bét cực độ/vô cùng gay go|z
紧巴巴=căng thẳng/căng/bó sát/bó chặt/túng thiếu/túng bấn/khó khăn|z
紧盯=nhìn chằm chằm/theo dõi chặt chẽ/nhìn|z
紧绷=căng cứng/buộc chặt/căng thẳng|z
紧绷着=căng thẳng|z
紧绷绷=chật căng/bó chặt/căng thẳng/cau có/nhăn nhó|z
紫彤=Tử Đồng|z
累的=mệt|z
絮叨=nói dông dài/nói đâu đâu|z
絮絮叨叨=lải nhà lải nhải/cằn nhằn/già chuyện|z
红喷喷=hơi đỏ/đo đỏ|z
红彤彤=đỏ rực/au/đỏ au/hồng đồng đồng/đỏ hồng hồng|z
红扑扑=đỏ bừng/đỏ sẫm/hồng phác phác/đỏ bừng bừng|z
红红的=hồng hồng|z
红茫=hồng mang|z
纷纭=xôn xao/rối ren/rối rắm/phân vân|z
细瘦=nhỏ gầy|z
细白=tế bạch|z
细眯=tế mị|z
细细地=tinh tế|z
细细长长=nhỏ nhỏ mảnh mảnh|z
细若=yếu ớt/nhỏ như|z
细高挑儿=thân hình cao nhồng/cao lều khều/mảnh khảnh/gầy và cao/thon thon|z
绊手绊脚=vướng chân vướng tay/vướng cản/làm trở ngại/chặn lối/ngáng đường|z
结结实实=rắn rắn chắc chắc/kết kết thật thật/chặt chẽ vững vàng|z
结结巴巴=lắp bắp/nói lắp/cà lăm/lắp ba lắp bắp|z
绝佳=tuyệt hảo/tuyệt cao|z
绝颠=đỉnh cao nhất|z
绯红=ửng đỏ/đỏ ửng/đỏ tươi/đỏ rực|z
绵绵=rả rích/liên tục/kéo dài|z
绵软=mềm mại/êm/mềm nhũn/miên nhuyễn|z
绿茸茸=xanh rờn/xanh rì|z
绿莹莹=xanh mơn mởn/xanh xanh/xanh biếc|z
缄口无言=ngậm miệng không nói/im lặng không nói gì|z
缕丝=sợi tơ|z
缕空=sợi 3D|z
缕缕=từng sợi/hết sợi này đến sợi khác/lũ lũ|z
缠缠绵绵=dai dẳng triền miên/triền miên|z
缤=tân|z
缤纷=rực rỡ/lả tả/sặc sỡ/rối rắm|z
缥妓=tìm gái|z
罗罗嗦嗦=nói dai như giẻ rách|z
美滋滋=đắc ý/vui thích/mỹ tư tư|z
羞的=xấu hổ/thẹn thùng|z
羞答答=xấu hổ/ngượng ngùng/hổ thẹn|z
羞红=đỏ bừng|z
羸=luy|z
羸弱=suy nhược/gầy yếu|z
羸得=giằng co|z
羸顿=gầy tọp/gầy còm/mệt mỏi/mệt lả|z
翩然=nhanh nhẹn/Phiên Nhiên|z
老糊涂=lão hồ đồ/già mà hồ đồ|z
老老实实=thành thành thật thật/lão lão thật thật/đàng hoàng|z
肥滚滚=mập tròn quay|z
胀红=trướng hồng|z
胖乎乎=mập mạp/bụ bẫm|z
胖嘟嘟=múp míp/béo ị|z
胖墩儿=bụ bẫm/mập mạp|z
胖墩墩=béo lùn chắc nịch/lùn mập|z
胖瘦=mập gầy/bàn sấu|z
胖胖=mập mạp|z
脆绿=thúy lục|z
脏乎乎=bẩn thỉu|z
脏兮=bẩn thỉu|z
脏兮兮=vô cùng bẩn/bẩn thỉu|z
脏的=bẩn/tạng|z
腻歪=dính nhau/chán ngán|z
腻腻歪歪=nị nị oai oai/ngấy xiêu vẹo|z
臭乎乎=thum thủm/thôi thối/hôi hôi|z
臭哄哄=xú hống hống|z
臭烘烘=thối hoắc/thối ình/thối tha/hôi hám|z
臭的=thúi|z
舌灿莲花=lưỡi chói hoa sen/lưỡi rực rỡ hoa sen|z
舒舒服服=thư thư phục phục|z
般若=Bàn Nhược/bát nhã/trí huệ ̣/Bàn nhược|z
良莠=tốt xấu/lương dửu|z
芭芭拉=Barbara/Ba Ba Lạp|z
花花绿绿=xanh xanh đỏ đỏ/màu sắc rực rỡ/loè loẹt/sặc sỡ/nhiều màu sắc/màu sắc sặc sỡ/hoa hoa lục lục|z
芳艳=phương diễm|z
芸芸=đông đảo/muôn nghìn|z
苍白=tái nhợt/trắng xanh/thương bạch|z
苍苍=mênh mang/bạc phơ/trắng xoá/xanh ngắt/xanh biếc/xanh thăm thẳm/bao la/mênh mông/bạc trắng|z
苍茫=mênh mông/bao la mờ mịt/Thương Mang/trời mênh mông/mênh mang/bao la/mờ mịt/thương mang|z
苍茫大地=mặt đất bao la|z
苍黄=nhợt nhạt/xanh xám/xanh xao/vàng vọt/võ vàng/sạm/vàng úa/xanh bủng/biến hoá khôn lường/biến ảo/sự đời đổi thay/hốt hoảng/hoảng loạn|z
茫然=mờ mịt/mù tịt/chả biết gì/không biết gì/mù mờ/ngỡ ngàng|z
茫白=trắng mờ|z
茫茫=mênh mông/mang mang/mịt mờ/mù mịt|z
茫茫然=mang mang nhiên|z
茵茵=Nhân Nhân|z
茸茸=mượt mà/mềm mại|z
荡然=sạch sành sanh/sạch trơn/sạch bong/sạch nhách/không còn gì/đãng nhiên/sạch sành sanh|z
荡荡悠悠=loạng choạng/lắc lư|z
荧荧=lấp lánh/lóng lánh|z
莽撞=lỗ mãng/mãng chàng/cục cằn/liều lĩnh|z
莽苍=mênh mang/mênh mông|z
莽莽=mênh mông/rậm rạp/um tùm/bao la|z
莽莽撞撞=lỗ mãng|z
萧凛=Tiêu Lẫm|z
萧飒=vắng lặng/không náo nhiệt|z
葱白=xanh nhạt/thông bạch|z
葱绿=xanh tươi/xanh lá mạ/xanh nõn chuối/xanh um/xanh ngát|z
葱翠=xanh biếc/xanh ngát/xanh ngắt/thông thúy|z
葱茏=xanh um/xanh tươi/xanh tốt|z
葱葱=sum suê|z
葱郁=thanh thúy tươi tốt/xanh um/xanh tươi/xanh ngát/um tùm|z
蒙哄=đánh lừa/lừa bịp/lừa gạt|z
蒙蒙胧胧=mơ mơ màng màng|z
蓊郁=rậm rì/rậm rạp|z
蓝汪汪=xanh mênh mang/xanh đầm đìa|z
蓬茸=rậm rạp/um tùm|z
蔫不唧=uể oải/thẫn thờ/ủ rũ/lặng lẽ/làm thinh/nín thinh|z
蔫呼呼=uể oải chậm chạp|z
蔫坏=xấu tính|z
虚眯=hơi khép|z
虚闪=hư thiểm|z
虚飘飘=lâng lâng/chuếnh choáng/bộ dạng lâng lâng không vững|z
蜡白=trắng bệt/trắng nhợt/xanh xám|z
蜡黄=vàng như nến/vàng như nghệ/nhợt nhạt như sáp/tái xám/vàng bủng/vàng ệch/vàng vọt/vàng khè|z
蠕蠕=nhúc nhích/ngọ nguậy/ngọ ngoạy/lổm ngổm/lển nghển|z
血幽=huyết u|z
血戾=huyết lệ|z
血沉=huyết trầm/máu lắng|z
血淋淋=đẫm máu/máu chảy đầm đìa/tàn khốc|z
血糊糊=máu me nhầy nhụa|z
血里糊拉=máu thịt be bét|z
袅=niểu|z
袅娜=thướt tha/dịu dàng/niểu na/lả lướt|z
袅袅=lượn lờ/vấn vít/phất phơ/tha thướt/du dương/réo rắt/ngân nga|z
袅袅娜娜=lượn lờ mềm mại/yểu điệu thướt tha|z
袅袅婷婷=thướt tha/lả lướt|z
褴=lam|z
褴褛=lam lũ/rách rưới/tả tơi|z
规规矩矩=quy củ|z
触目恸心=nhìn thấy mà đau lòng|z
认认真真=nghiêm túc/nhận nhận chân chân/nghiêm túc cẩn thận|z
讪讪地=ngượng ngùng|z
讷讷=lúng ta lúng túng/chẳng nói lên lời|z
详详细细=rõ ràng rành mạch/tỉ mỉ|z
调解纠纷=hòa giải tranh chấp/Hòa giải tranh chấp|z
谐谑=hài hước|z
贼溜=tặc lưu|z
贼溜溜=gian giảo|z
贼秃=tặc ngốc|z
赤幽=Xích U|z
赤条条=trần truồng/trần như nhộng/loã lồ/khoả thân|z
赤热=nóng bỏng/nóng rực/nóng như thiêu đốt|z
赤红=xích hồng/đỏ thẫm/đỏ đậm/đỏ/đỏ ngầu|z
赤裸=trần trụi/xích lõa/trần truồng|z
赤裸裸=trần trụi/xích lỏa lỏa/trần truồng/loã lồ/trơ trụi|z
赤足=chân trần/chân đất/chân không|z
赤黑=xích hắc|z
赫然=thình lình/bất ngờ/bỗng nhiên/thịnh nộ/nổi giận/bỗng chốc/bỗng đâu/nổi cơn thịnh nộ/đùng đùng/đỏ ửng|z
赳赳=oai hùng/oai phong|z
超高热=nhiệt độ siêu cao|z
跌跌撞撞=lảo đảo/chân nam đá chân chiêu|z
跳踉=náo loạn/ngang ngược tàn ác/dối trên gạt dưới|z
跳闪=khiêu thiểm|z
踉跄=lảo đảo/loạng choạng/nghiêng ngả|z
踉踉跄跄=thất tha thất thểu/lảo đảo|z
踏踏实实=chân thật/con đường thực tế/đạp đạp thật thật|z
踏青=đạp thanh/đi chơi trong tiết thanh minh/đạp thanh (*đi chơi trong tiết thanh minh)|z
踧踖不安=nhấp nhỏm không yên/bất an|z
踹出去=đạp ra ngoài|z
踽踽=lẻ loi/lủi thủi/thui thủi/một mình|z
蹑在=âm thầm theo|z
蹑手蹑脚=rón rén/rón ra rón rén|z
蹑足=khẽ bước|z
软乎乎=mềm hồ hồ/mềm mại|z
软塌塌=dặt dẹo|z
软绵=mềm mại/nhuyễn miên|z
软绵绵=mềm nhũn/mềm mại/mềm/yếu đuối/yếu/yếu ớt|z
软酥=mềm nhũn|z
轻依=tựa khẽ|z
轻刮=cạo nhẹ/khẽ nhéo|z
轻勾=cong lên|z
轻吟=ngâm khẽ/khẽ rên/ngâm khẽ|z
轻哼=hừ nhẹ|z
轻啼=khẽ hót/khinh đề/hót nhỏ|z
轻悄悄=nhẹ nhàng|z
轻手轻脚=nhẹ chân nhẹ tay/khinh thủ khinh cước/nhanh chân nhanh tay/tay chân nhẹ nhàng/rón rén|z
轻抽=kéo nhẹ|z
轻拉=khẽ kéo/nhấc|z
轻撞=va nhẹ|z
轻盈=nhẹ nhàng/mềm mại/uyển chuyển/dịu dàng/thoải mái/ung dung|z
轻轻地=nhẹ nhàng|z
轻轻松松=dễ dàng|z
轻重缓急=nặng nhẹ/gấp gáp hay thong thả|z
轻闪=chợt khẽ hiện|z
轻闲=nhẹ nhàng/nhàn hạ|z
轻飘=lướt nhẹ/bay nhè nhẹ|z
轻飘飘=nhẹ nhàng/bay bổng/khinh phiêu phiêu/nhẹ bay/nhanh nhẹ/nhanh nhẹn/ thoải mái/tự tại/nhẹ nhõm|z
辛然=Tân Nhiên|z
辛辛苦苦=tân tân khổ khổ/vất vất vả vả/nhọc nhằn khổ sở|z
辛辣=cay độc/chua cay/sâu cay/chanh chua|z
辣乎乎=cay xè/cay xé/nóng ran|z
辣手摧花=lạt thủ tồi hoa/không thương hương tiếc ngọc|z
辣辣=cay cay/cay/cay và nóng|z
辣辣的=cay|z
辣酥酥=cay cay/hơi cay/the the|z
迅疾=nhanh chóng|z
远远地=xa xa/xa xa mà|z
连哄=hống liên tục|z
连磕=dập đầu liên tiếp/liền dập đầu|z
迢=điều|z
迢远=xa xôi/xa xăm|z
迢迢=xa xôi/vạn dặm/xa xăm|z
迤逦=dĩ lệ/quanh co khúc khuỷu|z
迳直=thẳng|z
迷津=sai lầm/bến mê/con đường lầm lạc|z
迷濛=sương mù/mập mờ|z
迷瞪=mê hoặc|z
迷茫=mê mang/mê man/bao la mờ mịt/mênh mông mịt mù/man mác/mơ màng|z
迷蒙=mông lung/sương mù/che chắn/sương mù,che chắn|z
迷迷瞪瞪=mê mê trừng trừng|z
迷迷糊糊=mơ mơ màng màng|z
迷迷蒙蒙=mê mê mang mang/mông mông lung lung|z
透亮儿=ánh sáng xuyên qua|z
通幽=thông u/tĩnh mịch|z
通红=đỏ bừng/rất đỏ/đỏ rực/đỏ chói/đỏ chót|z
逛来逛去=đi lang thang/đi vơ vẩn/dạo tới dạo lui|z
逶=uy|z
逶迤=uốn lượn/quanh co/uốn khúc/uốn quanh|z
逼仄=chật chội/chật hẹp|z
逼的=ép|z
邋邋=lôi thôi|z
邋里邋遢=lôi tha lôi thôi/lôi thôi lếch thếch|z
酥麻麻=tê dại|z
酸死=chua chết|z
酸溜溜=chua chua/vị chua/chua/mệt mỏi/chua xót/xổ nho/chơi chữ|z
酸甜苦辣=ngọt bùi cay đắng/toan điềm khổ lạt/chua ngọt đắng cay/đắng cay ngọt bùi|z
酸辣=chua cay|z
醉的=say/say đích|z
醉醺醺=say khướt/say bí tỉ|z
释然=thoải mái/thư thái/thích nhiên|z
重恙=bệnh nặng|z
重重叠叠=chồng chất/trùng điệp/trùng trùng điệp điệp|z
重重地=nặng nề mà/nặng nề|z
金光灿烂=kim quang xán lạn/ánh vàng/ánh vàng chói lọi|z
金光闪闪=kim quang lóng lánh/vàng chói lọi|z
金闪闪=vàng óng ánh/vàng óng|z
铁黑=sắt đen|z
锃=sáng loáng|z
锃亮=bóng lưỡng/bóng loáng/sáng loáng|z
错的=sai|z
错综=rắc rối/đan chéo nhau/phức tạp/rối beng/khó hiểu|z
长吟=trường ngâm/ngâm nga/rả rích|z
长啼=gáy dài/hót dài/hú dài|z
长清=Trường Thanh|z
长短=dài ngắn/độ dài/trường độ/chiều dài/biến cố/bất trắc/đúng sai/tốt xấu/thị phi/này nọ/dù sao/dù thế nào|z
长舒=thở phào|z
长长的=thật dài/dài|z
长长短短=dài dài ngắn ngắn|z
闪亮=lóe sáng/anh ánh/lóng lánh|z
闪灼=le lói|z
闪着光=lóe ánh sáng|z
闪闪=lập loè/lòe lòe/lấp lánh|z
闷哼=kêu rên|z
闷闷地=buồn buồn|z
闹别扭=giận dỗi/làm mình làm mẩy|z
闹哄=ồn ào/làm ào ào/ào ào|z
闹哄哄=hò hét ầm ĩ/ầm ầm|z
闹嚷嚷=ồn ào/ầm ĩ|z
闹热=náo nhiệt|z
闹闹=nhốn nháo|z
闹闹哄哄=ầm ĩ|z
阘茸=hèn mọn/ti tiện/đê hèn|z
阴沉沉=âm u|z
阴狠=âm tàn/âm ngoan/hung tàn|z
阴阴沉沉=âm âm u u|z
随大溜=theo mọi người/theo số đông/theo đàn|z
随随便便=tùy tiện/tùy tùy tiện tiện|z
隐然=mờ mờ ảo ảo/thấp thoáng/ẩn nhiên|z
隐疾=ẩn tật/bệnh không tiện nói ra|z
隐秘处=nơi bí ẩn|z
隐约=mơ hồ/lờ mờ/láng máng/phảng phất/thấp thoáng|z
隐逸=ẩn dật/ở ẩn|z
隐隐=ẩn ẩn/mơ hồ/lâm râm/âm ỷ/mờ mờ ảo ảo|z
隐隐然=mờ mờ ảo ảo|z
隐隐约约=loáng thoáng/rập rờn/rập rà rập rờn/lờ mờ/lúc ẩn lúc hiện|z
雄浑=hùng hồn|z
雄纠纠=hung hăng|z
雄赳赳=hùng dũng oai vệ|z
雪浓=Cheryl|z
雪白=tuyết trắng/trắng như tuyết|z
零零=lẻ loi|z
零零散散=vụn vặt lẻ tẻ|z
零零星星=linh linh tinh tinh/lẻ tà lẻ tẻ|z
零零碎碎=vụn vụn vặt vặt/linh linh toái toái|z
零零落落=vô số/lác đa lác đác|z
雾切=vụ thiết|z
雾蒙蒙=sương mù mông lung/vụ mông mông|z
雾隐=ẩn trong khói|z
雾霭=sương mù|z
霏微=mịt mù/mịt mùng|z
霏霏=tầm tã/cuồn cuộn/mù mịt/mù trời/Phi Phi|z
霭霭=ải ải/dày đặc/Tiều Thượng/Nhiều mây|z
靉靆=u ám|z
青幽=thanh u|z
静寂=tĩnh lặng/vắng teo/vắng ngắt/vắng lặng/im lìm|z
静彤=Tĩnh Đồng|z
静悄悄=im ắng/yên tĩnh/yên lặng/tĩnh mịch/lặng lẽ|z
静逸=tĩnh lặng/Tĩnh Dật|z
静静地=yên tĩnh ngồi/lặng lẽ|z
非常简单=vô cùng đơn giản|z
非浅=không cạn|z
非薄=không mỏng|z
鞋底抹油=bôi mỡ đế giày|z
顶呱呱=đỉnh cao|z
顺溜=có thứ tự/trôi chảy/thuận lợi/nghe theo/vâng theo/thuận lưu|z
颀=kỳ|z
颀长=cao/cao to/cao lớn|z
颓然=chán nản/cụt hứng/mất hứng|z
颠簸不破=nghiêng ngả không phá|z
颠颠=vui vẻ/vui sướng|z
颤巍巍=run rẩy/run lẩy bẩy/chiến nguy nguy|z
颤悠=nhún nhảy|z
颤悠悠=run rẩy|z
颤抖地=run rẩy|z
颤颤巍巍=run run rẩy rẩy/chiến chiến nguy nguy|z
飒=táp|z
飒然=ào ào/táp nhiên|z
飒爽=hiên ngang/mạnh mẽ|z
飒飒=ào ào/rào rào/xào xạc/vi vu|z
飘地=rơi phủ vào đất|z
飘悠=lững lờ/bồng bềnh/lả tả/lượn lờ|z
飘来荡去=trôi tới trôi lui|z
飘来飘去=bay tới bay lui|z
飘洋=phiêu dương|z
飘红=phiêu hồng|z
飘零=phiêu linh/rơi chầm chậm/rơi lả tả/lênh đênh/trôi giạt|z
飘飘=bồng bềnh/phiêu phiêu|z
飘飘悠悠=rung rinh/đu đưa|z
飘飘然=lâng lâng/nhẹ nhõm/phơi phới|z
飘飘荡荡=phiêu phiêu đãng đãng/trôi nổi bồng bềnh|z
飞短流长=thêm mắm thêm muối/bôi tro trát trấu/bịa đặt|z
飞黄腾踏=lên như diều gặp gió/vàng đạp|z
馄饨面=mì vằn thắn|z
香喷喷=thơm ngào ngạt/thơm ngát/thơm phức|z
馥郁=mùi thơm ngào ngạt/thơm phưng phức/hương thơm ngào ngạt/hương thơm nồng nàn/ngào ngạt|z
骂的=mắng|z
骂骂咧咧=hùng hùng hổ hổ/nói kháy/chửi mát|z
骇异=hãi dị/kinh ngạc/kinh sợ/kỳ lạ/quái lạ|z
骇然=hãi nhiên/hoảng sợ/ngạc nhiên/ngơ ngác/lấy làm lạ/run sợ|z
骨灵冷火=Cốt Linh Lãnh Hỏa|z
骨碌=lăn lông lốc/lăn/trở mình/cốt lục|z
骨碌碌=nhanh như chớp/cuồn cuộn/lộn vòng/đảo qua đảo lại/tới tấp/vội vã|z
高高低低=cao thấp|z
鲜红=đỏ tươi/đỏ thắm|z
麻辣=tê cay|z
麻辣烫=bún thập cẩm cay|z
麻酥酥=tê tê/hơi tê tê|z
麻麻黑=chập choạng/vừa tối/mờ tối/nhá nhem|z
黄奕=Hoàng Dịch|z
黄猄=con hoàng kình/con cheo|z
黄瘦=vàng ốm|z
黑不溜秋=đen thui/đen sì/đen thui thủi/đen nhẻm/đen như củ tam thất|z
黑乎乎=đen sì/đen thùi lùi|z
黑压压=đen nghịt/đông nghịt/đông nghẹt/đông nghìn nghịt/đen ngòm/đen nghìn nghịt/tối om om|z
黑咕隆咚=tối om/tối mò/tối đen/tối như bưng|z
黑幽幽=đen thẫm|z
黑暗=hắc ám/tối/tối tăm/đen tối/tối om/không có ánh sáng/thối nát/lạc hậu/hủ bại/bóng tối|z
黑板刷=đồ bôi bảng|z
黑沉=hắc trầm|z
黑沉沉=đen kịt/tối om/u ám/mù mịt/đen sịt/tối giăng giăng/tối om om|z
黑溜溜=đen bóng/hắc lưu lưu|z
黑漆漆=tối như mực/tối đen/tối đen như mực/đen thùi|z
黑熊=gấu đen/gấu chó|z
黑瘦=đen gầy|z
黑白=đen trắng/hắc bạch/Hắc Bạch/trắng đen/phải trái/thiện ác|z
黑直长=đen thẳng dài|z
黑糊糊=đen sì/đen sì sì/đen thui/đen nhẻm/đen kịt/tối om/tối thui/tối mịt/tối mò/tối om om/đen mờ/lờ mờ/mịt mờ/đen nghịt/mịt mùng|z
黑红=đỏ thẫm|z
黑绿=hắc lục|z
黑腾腾=đen/hắc đằng đằng|z
黑茫茫=tối mờ mịt/mịt mùng/tối đen như mực|z
黑黑=đen nhánh/đen sẫm|z
黑黝=đen thui|z
黑黝黝=đen nhánh/đen bóng/đen láy/tối đen/đen kịt/tối mịt/nhìn không rõ/tối như bưng/tối mịt mù|z
黑黢黢=đen sì/đen thui/đen nhẻm/đen như mực/tối như bưng/đen sì sì|z
默片=phim câm|z
默默地=yên lặng/lặng lẽ/yên lặng mà|z
黝=ửu|z
黝黑=đen nhánh/đen kịt/ngăm đen/đen tuyền/đen/đen thui|z
黝黯=đen thui/đen|z
黢黑=tối đen/tối om|z
黧=lê|z
黧黑=đen|z
黯旧=bạc màu cũ kỹ|z
黯淡=ảm đạm/tối tăm/u ám|z
黯然=ảm đạm/buồn bã/âm u/vẻ âm u/u ám/u tối/ngán ngẩm/ủ ê/chán nản/nản lòng/thất vọng|z
鼎灵=Đỉnh Linh|z
鼎盛=cường thịnh/đang thịnh/hưng thịnh/đang lên|z
鼎足=chân vạc/thế chân vạc|z
鼎里=trong đỉnh|z
鼓囊囊=túi|z
鼓溜=phình ra|z
鼓鼓囊囊=căng phồng/phình ra/cộm ra/cổ cổ nang nang|z
齐刷刷=đồng loạt|z
齐齐整整=tề tề chỉnh chỉnh/gọn gàng|z
