乸=nả|zg
亱=dạ/ban đêm|zg
仐=tán/kim|zg
伃=dư|zg
伾=phi|zg
侂=thác|zg
侚=tuẫn|zg
侹=đĩnh|zg
俉=ngộ|zg
俤=đệ|zg
倓=đàm|zg
傎=điên|zg
傔=khiểm|zg
僃=bị|zg
僎=soạn|zg
僙=quang|zg
僽=sậu|zg
僾=ái|zg
儅=đang|zg
儓=đài|zg
儛=vũ|zg
儴=nhương|zg
兎=thố|zg
兛=thiên|zg
兩=lưỡng|zg
凟=độc|zg
刄=lạng|zg
刌=thổn|zg
刓=ngoan|zg
刱=sáng|zg
刵=nhĩ|zg
剅=lâu|zg
剹=lục|zg
剺=ly|zg
劀=qua|zg
劥=khanh|zg
勚=duệ|zg
勣=tích|zg
勼=cưu|zg
匄=cái|zg
匚=phương|zg
厀=tất|zg
厔=chất|zg
厳=nghiêm|zg
叚=giả|zg
吢=khấm|zg
咷=đào|zg
唊=giáp|zg
唫=ngậm|zg
啑=xiệp|zg
啴=xiển|zg
喍=sài|zg
嘦=chiếu|zg
噐=khí|zg
噚=tầm|zg
噭=khiếu|zg
嚃=đạp|zg
嚱=hi|zg
圁=ngân|zg
圌=thùy|zg
圞=loan|zg
圵=đáng|zg
坺=bạt|zg
垍=ký|zg
埜=dã|zg
堌=cố|zg
堽=canh|zg
塕=ổng|zg
塮=tạ|zg
壎=huân|zg
壔=đảo|zg
夆=phùng|zg
夌=lăng|zg
夬=quái|zg
奡=ngạo|zg
姞=cật|zg
媢=mạo|zg
媥=piān|zg
嫕=ế|zg
宨=tiǎo|zg
屟=tiệp|zg
峝=đỗng|zg
崪=tụy|zg
嶅=ngao|zg
嶒=tằng|zg
嶲=tây|zg
嶽=nhạc|zg
巠=kinh|zg
帊=bạc|zg
帡=bình|zg
帵=oan|zg
幰=hiển|zg
廆=hội|zg
廏=cứu|zg
弍=nhị|zg
徫=vĩ|zg
忈=đao|zg
忋=cái|zg
恑=ngụy|zg
悕=hy|zg
悰=tông|zg
惄=nịch|zg
惼=biển|zg
愯=song|zg
慱=đoàn|zg
憸=tiêm|zg
懽=hoàn|zg
扅=di|zg
抃=biến|zg
捼=noa|zg
摥=thương|zg
撦=xả|zg
擣=đảo|zg
擫=áp|zg
攷=khảo|zg
敧=khi|zg
斈=học|zg
斝=giả|zg
斸=trọc|zg
斾=bái|zg
旂=kỳ|zg
旉=phu|zg
旓=sao|zg
旟=dư|zg
昡=huyền|zg
暠=cảo|zg
杅=vu|zg
枑=hộ|zg
枴=quải|zg
柂=đà|zg
栱=củng|zg
桲=bột|zg
梲=chuyết|zg
椓=trạc|zg
椷=giam|zg
楢=do|zg
楶=tiết|zg
榑=phù|zg
榼=khạp|zg
槥=tuệ|zg
槱=dửu|zg
櫍=chất|zg
欃=sàm|zg
欋=cù|zg
欝=uất|zg
欿=khảm|zg
歜=xúc|zg
歰=sáp|zg
歾=một|zg
殠=xú|zg
殻=xác|zg
毦=nhĩ|zg
沴=lệ|zg
泑=ửu|zg
泒=cô|zg
涘=sĩ|zg
湑=tư|zg
湦=sanh|zg
滘=khiếu|zg
滪=dự|zg
滶=ngao|zg
滺=du|zg
漑=cái|zg
澑=lựu|zg
澯=xán|zg
澽=cự|zg
濺=tiên|zg
灂=tiếu|zg
灳=linh|zg
煇=huy|zg
煔=thiểm|zg
煚=cảnh|zg
爟=quán|zg
牂=tang|zg
牋=tiên|zg
狖=dứu|zg
狥=tuẫn|zg
猨=viên|zg
猺=dao|zg
獮=tiển|zg
玹=xuân|zg
甎=chuyên|zg
畯=tuấn|zg
畽=thoản|zg
疌=tiệp|zg
疎=sơ|zg
疭=túng|zg
痏=vị|zg
瘏=đồ|zg
瘚=quyết|zg
癎=giản|zg
盬=cổ|zg
眎=thị|zg
眘=thận|zg
矒=mông|zg
矰=tăng|zg
矼=cang|zg
砃=đá trắng|zg
砫=trụ|zg
砮=nỗ|zg
碯=não|zg
祹=Tạo|zg
禋=nhân|zg
稆=lữ|zg
稟=bẩm|zg
穊=ký|zg
窰=diêu|zg
窵=điếu|zg
竚=trữ|zg
竫=tĩnh|zg
笴=cảm|zg
筈=quát|zg
箇=cá|zg
箎=trì|zg
箑=tiệp|zg
箚=tráp|zg
箾=sao|zg
篛=nhược|zg
篨=trừ|zg
篲=tuệ|zg
簠=phủ|zg
籖=thiêm|zg
籰=dược|zg
紅=hồng|zg
絁=thi|zg
絓=quái|zg
綪=khiếm|zg
緈=trực|zg
緎=vực|zg
緪=căng|zg
繂=luật|zg
繈=cưỡng|zg
繖=tản|zg
繨=đáp|zg
繵=triền|zg
繻=nhu|zg
纁=huân|zg
绹=đào|zg
罛=cô|zg
罳=ty|zg
羇=ki|zg
羱=nguyên|zg
翣=sáp|zg
翫=ngoạn|zg
耇=cẩu|zg
耈=cẩu|zg
聧=khuê|zg
肧=phôi|zg
胏=chỉ|zg
腁=biền|zg
膓=tràng|zg
膙=cưỡng|zg
臛=hoắc|zg
舓=chỉ|zg
苖=địch|zg
苙=lập|zg
苽=cô|zg
荓=bình|zg
荙=đạt|zg
菴=am|zg
菼=thảm|zg
蒍=thân cây súng|zg
蒱=bồ|zg
蓨=điệu|zg
蔨=quyển|zg
蔪=tiêm|zg
蕋=nhị|zg
蕠=như|zg
蕥=nhã|zg
薖=oa|zg
薢=giải|zg
藷=thự|zg
蘤=hoa|zg
虖=hô|zg
虙=mật|zg
蚖=ngoan|zg
蜋=lang|zg
蝝=duyên|zg
蟕=chủy|zg
袠=trật|zg
袵=nhẫm|zg
褉=hạt|zg
襃=bao|zg
襆=bộc|zg
覻=thứ|zg
誌=chí|zg
誰=thùy|zg
謡=dao|zg
謯=trớ|zg
讙=hoan|zg
讟=độc|zg
貆=hoan|zg
貙=sơ|zg
貭=chất|zg
賵=phúng|zg
贠=viên|zg
赮=hạp|zg
赸=sán|zg
跮=sí|zg
躧=sỉ|zg
軆=thể|zg
軨=linh|zg
輋=xa|zg
辀=chu|zg
辌=lương|zg
辡=biện|zg
迍=truân|zg
邟=kháng|zg
郩=hào|zg
酺=bô|zg
醁=lục|zg
醊=chuyết|zg
醡=trá|zg
釄=mi|zg
鋆=vân|zg
鍑=phúc|zg
鍱=diệp|zg
鏕=ao|zg
鏣=tên dụng cụ|zg
鐏=tỗn|zg
鐩=tùy|zg
鑞=lạp|zg
鑨=lung|zg
鑪=lô|zg
铘=gia|zg
铻=ngữ|zg
锧=chất|zg
镕=dung|zg
閛=phanh|zg
阛=hoàn|zg
陼=chử|zg
隞=ngao|zg
隟=khích|zg
隲=chất|zg
雘=hoạch|zg
霙=anh|zg
霫=tập|zg
霱=duật|zg
靬=kiền|zg
鞡=lạp|zg
鞬=kiện|zg
韂=xiếm|zg
韘=thiếp|zg
頵=quần|zg
顑=khảm|zg
颣=loại|zg
飜=phiên|zg
饎=sí|zg
駞=đà|zg
駻=hãn|zg
騑=phi|zg
骔=tông|zg
骽=thối|zg
髃=ngung|zg
髢=thế|zg
髴=phất|zg
鬐=kỳ|zg
鬡=ninh|zg
魛=đao|zg
魟=hồng|zg
鮿=triếp|zg
鰂=tặc|zg
鱇=khang|zg
鱍=cá quẫy đuôi nhảy|zg
鱬=mặt người thân cá|zg
鱲=liệp|zg
鲀=đồn|zg
鳒=kiêm|zg
鳸=hỗ|zg
鴈=nhạn|zg
鴒=linh|zg
鴽=như|zg
鵻=giai|zg
鶊=canh|zg
鶗=đề|zg
鷁=nghịch|zg
鷞=sương|zg
鸀=hắc|zg
麙=hàm|zg
麹=khúc|zg
黓=dặc|zg
黡=yểm|zg
黤=yểm|zg
鼄=chu|zg
鼑=đỉnh|zg
齆=úng|zg
