一=vừa|m
万=vạn|m
与=cùng/dữ/và/giống như/cho|p
丐=cái|g
丕=phi|g
丗=thế|yg
丣=dậu|yg
两=hai/lượng/lưỡng|m
为=vì/làm/là/vi/vì là/thành|p
久=lâu/cửu|a
乓=bang/pằng|o
也=cũng/vậy/cũng/thì|d
乡=hương/thôn quê|n
书=sách/thư/viết|n
乩=kê|x
买=mua/mãi/bán|v
乱=loạn/bậy|d
乸=nả|zg
事=sự tình/sự/chuyện|n
亍=xúc|x
于=tại/cho/vu/với/hơn|p
亓=kỳ|nr
些=chút/ta/chút ít/những/nhiều|q
亦=cũng/diệc|d
亱=dạ/ban đêm|zg
人=người/nhân|n
亿=ức/trăm triệu|m
仃=đình|x
仅=vẻn vẹn/chỉ|d
仉=chưởng|nr
仌=băng|yg
从=từ/theo/tòng|p
仑=luân|g
仕=sĩ|n
他=hắn/nó/khác/她|r
仝=đồng|nr
仞=trượng|q
仟=thiên|m
仨=ba|m
仫=mu|x
们=nhóm/môn/các/cửa/bọn họ|k
仳=tỷ|x
价=giá/giới/giá cả|n
伃=dư|zg
伛=ủ|v
伞=dù/cái dù/tán/ô|n
伢=trẻ con|n
伥=trành|n
伧=sinh|x
伴=bạn|v
伸=duỗi với|v
伾=phi|zg
但=nhưng/vậy|c
佗=đà|g
佚=dật/ẩn|vg
佟=đông|nr
你=ngươi/cậu|r
佥=thiêm|g
佬=lão|ng
佯=dương/giả vờ|v
佰=bách|m
佶=cát|g
佻=điệu|g
佾=dật|g
使=làm/dùng/khiến/sử/làm cho/khiến cho/sử (khiến cho)/sứ|v
侂=thác|zg
侄=điệt/chất|n
侉=khoa|n
侑=hựu|g
侔=mâu|g
侚=tuẫn|zg
侩=quái|g
侪=sài|g
侬=nông/anh|g
侭=tận|yg
侹=đĩnh|zg
侻=thoái|x
便=liền/dễ/lại/tiện|d
促=gấp rút|v
俅=cầu|x
俉=ngộ|zg
俍=lương|y
俎=trở|nr
俐=lợi|x
俑=tượng/tượng (chôn chung với người chết)|ng
俜=binh|x
俣=vũ|x
俤=đệ|zg
俨=nghiễm|v
俩=hai/lưỡng|m
俪=lệ|g
修=tu/xây/sửa|v
俯=cúi/phủ/cúi xuống|v
俳=bài|ng
俺=ta/yêm/ta đây/ore|r
倄=giáo|yg
倌=quan|g
倒=ngược lại/ngã/đảo/đổ/lộn/ngược/cũng/rót|v
倓=đàm|zg
倔=bướng bỉnh|a
倘=thảng/nhưng|c
倬=trác|g
倮=khỏa|g
债=nợ/khoản nợ/trái|n
偎=tựa/ôi|v
做=làm/tố|v
停=ngừng/đình/dừng|v
偬=tổng|x
偷=trộm/thâu/lén|v
偻=lũ|x
偾=phẫn|g
傀=khôi|n
傅=phó|nr
傎=điên|zg
傔=khiểm|zg
傞=ta|y
傥=thảng|c
傧=tấn|n
傩=na|g
傲=ngạo|a
傺=sế|x
僃=bị|zg
僇=lục|yg
僎=soạn|zg
像=giống/tượng/giống như|v
僖=hi|g
僚=liêu|n
僦=tựu|g
僬=tiêu|x
僭=tiếm|g
僮=đồng|n
僳=túc|x
僽=sậu|zg
僾=ái|zg
儅=đang|zg
儆=cảnh|g
儇=uyên|g
儓=đài|zg
儛=vũ|zg
儡=lỗi|x
儤=bạo|yg
儴=nhương|zg
兇=hung|a
光=quang/chỉ riêng/ánh sáng/sạch/chỉ|n
免=miễn|v
兎=thố|zg
兑=đổi/đoái/đoài|v
兕=tê giác|g
党=đảng|n
兛=thiên|zg
兢=căng|i
入=nhập/vào/đi vào|v
六=sáu/lục/ngưu|m
兮=này|y
其=nó/nàng/kỳ/hắn/ngoài/của nó/|r
兼=kiêm|v
再=lại/tái/nữa/sẽ|d
冐=mạo|yg
冒=bốc lên/mạo|v
冖=mịch|y
写=viết/tả/ghi|v
军=quân|n
冢=mộ|ng
冹=phu|yg
冼=tiển|nr
冽=liệt|g
凇=tùng|x
减=giảm|v
凑=góp/đụng/tập hợp/gom góp/thấu/họp/tiếp cận|v
凟=độc|zg
几=mấy/hầu như/vài|m
凷=khối|yg
出=ra/xuất|v
函=văn kiện/hàm|n
凾=hàm|x
凿=đục|v
刃=lưỡi đao/nhận|ng
刄=lạng|zg
切=cắt|v
刈=ngải|vg
刌=thổn|zg
刎=vẫn|g
划=vạch/hoạch/vẽ/hoa/họa|v
刓=ngoan|zg
刖=ngoạt|g
删=xóa/xóa|v
刮=cạo/phá/quát|v
到=đến/đáo/được|v
刱=sáng|zg
刲=khuê|x
刳=khô|g
刵=nhĩ|zg
刽=quái|n
剀=cai|x
剅=lâu|zg
剐=róc thịt/quả|v
剒=thố|yg
剙=sang|x
剜=khoét|v
剞=kỷ|x
剡=diệm|v
剥=lột/bóc/tróc/bóc lột/bác|v
割=cắt/cát|v
剹=lục|zg
剺=ly|zg
剿=diệt/tiêu diệt|v
劀=qua|zg
劁=tiêu|v
劂=quyết|x
劐=hoạch|y
劝=khuyên/khuyến/khích lệ|v
功=công/công lao|n
劢=mại|g
劬=cù|g
劭=thiệu|g
劻=khuông|y
劾=hặc|g
勒=siết/lặc/cương/đè nén/ghìm cương|v
勖=úc|g
勗=úc|g
勚=duệ|zg
勣=tích|zg
勯=dan|y
勰=hiệp|g
勳=huân|ng
勼=cưu|zg
勿=chớ/vật|d
匄=cái|zg
包=bao/túi|v
匆=thông|z
匍=bồ|v
匏=bào|x
匐=bò xổm|x
匕=dao găm/chủy|n
匚=phương|zg
匦=quỹ|g
匳=liêm|x
匼=hạp|y
匾=biển|n
卄=nhập|y
卉=hủy|ng
卖=bán/mại|v
卞=biện|nr
占=chiếm/chiêm|v
卣=dữu|g
卭=ngang|yg
却=lại/nhưng|d
卵=trứng/noãn|n
卸=gỡ/đẩy/cởi/tá/tháo|v
卹=tuất|x
卺=cẩn|g
卼=ngột|yg
厀=tất|zg
厅=sảnh|n
厍=xá|g
厔=chất|zg
厣=áp|g
厥=quyết|r
厩=cứu|n
厳=nghiêm|zg
厶=khư|g
去=đi/khứ|v
厾=đốc|x
叁=tam/ba|m
又=lại/hựu/vừa|d
及=cùng/và/cập/kịp/tới|c
叔=thúc|n
取=lấy/thủ|v
受=thụ/chịu/bị/được|v
叚=giả|zg
叟=tẩu|g
叠=chồng/xếp|v
句=câu/cú|q
叫=gọi/để/bảo/làm/khiếu/kêu|v
叭=bá|o
可=nhưng/có thể/cũng/khả/đáng/thể|v
叵=phả|v
叻=lặc|g
吃=ăn/cật/đồ ăn|v
各=các/tất cả/đều/mỗi/mỗi người|r
吆=yêu/hét|v
向=hướng/hướng về phía/hướng về/xưa đến nay|p
吒=tra|g
吓=dọa/hách/hù dọa/sợ/doạ|v
吕=Lữ|nr
吖=a/úi chà|x
吗=sao/ư/mạ/không/chưa/à|y
吟=ngâm|v
吠=sủa/phệ|vg
吡=ti|n
吢=khấm|zg
吣=tẩm|v
听=nghe/thính|v
吮=mút|v
启=khải|v
吲=oành|x
吴=ngô|nr
吵=ầm ĩ/nhao nhao/sảo/ồn ào|v
吸=hút/hấp/hít|v
吹=thổi/xuy|v
吻=hôn/vẫn/mép/môi|v
吼=rống|v
吾=ngô/ta|r
呀=nha/à/ạ|y
呈=hiện/hiện lên/trình|v
呉=ngô|yg
告=cáo/kiện/nói với|v
呋=phu|n
呓=nghệ|n
呖=kíu/lịch|o
呗=thôi/quá|y
呙=oa|nr
呛=sặc/sang/hắc|v
呤=lánh/đinh|x
呦=u/ôi|e
呲=thử|v
呶=nao|g
呷=uống|v
呸=phi|e
呻=thân|v
咂=chép miệng|v
咄=đốt/ô hay|i
咆=bào|v
咋=thế nào/động/người/sao|r
和=cùng/và/hòa/như|c
咐=phó|x
咙=lung|x
咚=đông|o
咛=ninh|x
咝=ti/ư|o
咢=ngạc|y
咣=cạch|o
咤=trá|x
咦=a/ồ/di|e
咧=liệt/rồi/nhếch|v
咫=chỉ|n
咱=ta|r
咴=hí|x
咷=đào|zg
咿=y|o
哂=mỉm cười/cười|vg
哄=hống/dỗ/lừa/dỗ dành|v
哆=run|v
哉=ư/quá thay|y
哌=phái|n
哎=ai|e
哔=tất|n
哙=khoái|g
哜=tễ|g
哝=nông|x
哞=mu/bò....ò.../tiếng bò rống/ò/Ùm...ụm bò....ò...tiếng bò rống|o
哧=xoẹt/xoạt|o
哭=khóc/khốc|v
哳=triết|x
哿=cả|g
唊=giáp|zg
唑=tọa|x
唓=xa|x
唔=ngô/A.../đừng/a|y
唕=tạo|yg
唢=tỏa|n
唣=tao|x
唪=phủng|g
唫=ngậm|zg
唳=lệ/Lê-eeee-eezz~!|g
唷=hừm|x
唼=xiệp|x
啃=gặm/khẳng|v
啈=hanh|x
啉=lâm|x
啑=xiệp|zg
啕=đào|g
啗=đạm|y
啡=phê|x
啤=bia|n
啥=cái gì/gì/cái đó|r
啦=rồi/nữa/lạp/rồi|y
啭=chuyển|g
啴=xiển|zg
啵=ba|y
啶=định|x
啷=lang|x
啻=chỉ|g
啾=thu/chụt|x
喁=ngung|g
喂=uy/cho ăn/này/đút|v
喈=dê|x
喊=hô/hảm/quát/gọi/kêu|v
喋=điệp|i
喌=châu|x
喍=sài|zg
喒=tàm|x
喘=thở/thở gấp|v
喟=vị|g
喭=ngạn|y
喱=li|x
喵=meo/meo ô/meo meo/Meow/miêu|o
喹=khuê|n
喾=khốc|g
嗁=đề|x
嗉=tố|n
嗌=ách|g
嗑=gặm|v
嗒=cạch|o
嗔=giận|v
嗖=sưu/vèo/vù|o
嗟=ta|v
嗣=tự|ng
嗨=này/hải/high|e
嗪=tần|g
嗬=ôi|e
嗯=ừm/ân/ừ/dạ|e
嗲=ỏn ẻn/điệu|l
嗳=ai|e
嗵=oành|o
嗾=thốc|g
嘁=hứ|o
嘏=hỗ|g
嘐=hao|yg
嘛=mà/ma/thôi/đây/đi/được/nha/sao|y
嘞=lặc|y
嘣=băng|o
嘦=chiếu|zg
嘧=mật|x
嘬=mút/toát|v
嘭=bành/thình thịch/oành|o
嘹=liệu|a
噇=trảng|yg
噍=tiếu|vg
噐=khí|zg
噒=liên|x
噘=quyết/cong|v
噙=chứa|v
噚=tầm|zg
噣=trác|y
器=khí/ (cụ)|n
噫=y|e
噭=khiếu|zg
噱=cược|n
嚃=đạp|zg
嚅=nhu|x
嚆=hao|x
嚏=hắt xì/hắt hơi/đế|n
嚓=xoạt|o
嚔=đế|y
嚚=ngân|yg
嚯=hoắc/ồ|e
嚱=hi|zg
嚷=trách móc/nhượng/cho/kêu gào|v
嚼=nhai|v
回=về/hồi/quay về/lần/trả lời|v
囟=tín|n
囤=độn|v
囫=hốt|d
囱=song|x
囵=luân|x
囹=linh|n
国=nước/quốc|n
图=đồ/hình/cầu|n
囿=câu nệ/hữu|vg
圃=phố|ng
圄=ngữ|x
圉=ngữ|g
圊=thanh|g
圌=thùy|zg
圐=khố|y
圛=dịch|y
圞=loan|zg
圢=đinh|yg
在=tại/đang/ở/再/lại|p
圪=khất|n
圬=ô|g
圯=di|g
圹=khoáng|ng
圻=kỳ|g
圾=ngập|x
均=đồng đều/quân/cùng/đều/đều|d
坋=phận|y
坌=bộn|g
坐=ngồi/tọa|v
坝=đập/bá|n
坞=ổ|ng
坟=mộ phần/phần/phần mộ|n
坠=rơi|v
坡=sườn núi|n
坫=điếm|g
坭=nê|g
坯=phôi|n
坳=thung lũng|g
坶=mẫu|x
坺=bạt|zg
坻=trì|g
垃=rác|n
垌=lan/động|g
垍=ký|zg
垓=cai|g
垝=quỷ|y
垟=dương|y
垠=ngần|ng
垡=phạt|g
垣=viên|ng
垤=điệt|g
垧=thưởng|m
垩=ác|g
垮=đổ/suy sụp/sụp đổ|v
垯=đáp|y
垴=não|g
垸=viện|ng
垾=hàn|x
埂=canh|ng
埋=chôn/mai/vùi|v
埏=duyên|g
埒=liệt|g
埔=bộ|g
埕=trình|g
埘=thì|n
埙=huân|ng
埜=dã|zg
埠=phụ|ng
埤=bì|x
埯=yểm|g
埴=thực|g
埸=dịch|g
埽=tảo|g
堆=chồng/đống/chồng chất/đôi/đắp|v
堇=cận|n
堋=bằng|g
堌=cố|zg
堕=đọa/rơi rụng|v
堞=điệp|g
堠=hậu|g
堤=đê|n
堧=nhuyên|yg
堩=hằng|yg
堵=chắn/chận|v
堽=canh|zg
塄=lăng|g
塌=sập/lõm xuống/sụp/giường/榻~|v
塍=thăng|g
塕=ổng|zg
塟=táng|yg
塥=cách|g
填=lấp/điền|v
塬=nguyên|ng
塮=tạ|zg
塾=thục|n
墀=trì|g
墁=mạn|v
墅=thự|x
墈=khám|y
墉=dung|g
墓=mộ|n
墚=lương|g
增=tăng|v
墟=khư|ng
墼=kích|x
壎=huân|zg
壑=khe|ng
壔=đảo|zg
壬=nhâm|m
夆=phùng|zg
备=chuẩn bị/bị|v
夌=lăng|zg
多=nhiều/thêm/cỡ nào/đa|m
夣=mộng|y
夬=quái|zg
夷=di|ng
夺=đoạt|v
夼=khoảng|g
奁=liêm|g
奖=thưởng/tưởng/khen|n
奘=trang|g
奡=ngạo|zg
她=nàng/mụ/nàng/他|r
妈=mẹ/mụ|n
妒=ghen|v
妗=cấm|g
妤=dư|x
妪=ẩu|g
妫=quy|g
妯=trục|n
妹=muội|n
姆=mẫu/mu|x
姊=tỷ|n
姐=tỷ/tả|n
姒=tự|g
姘=phanh|n
姝=thù|g
姞=cật|zg
姣=giảo/tướng mạo|z
姨=di|n
姹=xá|i
娀=tung|y
娅=á|x
娆=nhiêu|x
娌=lý|x
娘=nương/mẹ/mẹ|n
娠=thần|g
娣=đệ|g
娩=vãn|vg
娰=nữ|yg
娲=oa|x
娶=cưới/lấy/thú/lấy|v
婊=biểu|n
婕=tiệp|x
婢=tỳ|n
婧=tịnh/nhu|g
婪=lam|x
婵=thiền|n
婶=thẩm|n
婷=đình|x
婺=vụ|ns
婿=tế/con rể|ng
媕=am|x
媢=mạo|zg
媥=piān|zg
媪=ảo|g
媲=bễ|v
媵=thiếp|g
媸=xuy|g
媾=cấu|v
嫁=gả/giá|v
嫒=ái|x
嫕=ế|zg
嫘=luy|g
嫜=chương|g
嫠=ly|g
嫦=thường|n
嫫=mô|g
嫱=tường|g
嫿=họa|x
嬖=bế|g
嬲=điểu|g
嬷=ma|n
字=chữ/tự|n
存=tồn|v
孢=bào|n
孬=nhút nhát|n
孰=ai|r
孱=mềm yếu|a
孵=ấp trứng/ấp|v
孺=trẻ con/nhụ|n
孻=nai|yg
孼=nghiệt|yg
宂=nhũng|yg
它=nó/tha/khác|r
宄=quĩ|x
宓=mật|nr
宕=đãng|g
审=thẩm|v
宥=hựu|g
宨=tiǎo|zg
害=hại|v
宸=thần|g
寀=thái|yg
寅=dần|mg
寨=trại|ng
尀=phả|yg
尉=úy|nr
尒=nhĩ|yg
尕=ca|ns
尜=giát|x
尝=nếm/từng/thường|v
尤=càng|d
尥=liệu|v
尬=giới/ngượng|x
就=liền/thì/tựu/ắt/thành/chính|d
尴=lúng túng khó xử|a
尹=doãn|nr
尻=khào|g
局=cục/(ván) cục|n
屁=cái rắm|n
屉=thế|n
屎=phân/cứt/thỉ|n
屙=a|g
属=thuộc|v
屟=tiệp|zg
屡=nhiều lần|d
屣=tỷ|g
屦=lũ|g
屿=tự|ng
岈=nha|g
岌=ngập|i
岍=khiên|g
岑=sầm|nr
岖=khu|x
岗=cương vị/tốp|n
岙=Áo|g
岛=đảo|n
岢=khả|g
岣=cẩu/câu|g
岵=hỗ|g
岽=đông|g
岿=vị|i
峁=mão/Mão|g
峃=học|yg
峄=dịch|g
峋=tuân|x
峒=động|g
峝=đỗng|zg
峤=kiệu|g
峦=loan|g
峧=giao|y
峪=dụ|g
峻=tuấn|ag
崃=lai|g
崄=hiểm|x
崔=thôi|nr
崞=quách|g
崤=hào|g
崦=yêm|x
崩=sập/băng/sụp đổ/vỡ|v
崪=tụy|zg
崮=cố|g
崴=uy|v
崽=con/tể|n
嵇=kê|nr
嵊=thặng|g
嵋=mi|g
嵌=khảm|v
嵕=tông|yg
嵘=vanh|x
嵛=du|g
嵝=lũ/Lũ|g
嵫=tư|x
嵬=ngôi|g
嵯=tha|x
嵷=tung|x
嶅=ngao|zg
嶒=tằng|zg
嶓=Bá Trùng|yg
嶝=đặng|g
嶲=tây|zg
嶷=nghi|g
巂=tây|yg
州=châu|n
巠=kinh|zg
巯=khưu|g
已=đã/thôi/dĩ|d
巳=tị|mg
巽=tốn|g
巾=khăn|ng
币=tệ/tiền|n
市=thành phố/thị/chợ/mua/thị trường|n
帆=buồm|n
帊=bạc|zg
帏=vi|n
帑=nô|g
帔=bí|g
帙=trật|q
帚=cây chổi|ng
帡=bình|zg
带=mang/đái/đeo/kéo/vùng/đai/lẫn|v
帧=tấm/tránh|q
帮=giúp/bang/đám/mép|v
帵=oan|zg
帻=trách|g
幂=mịch|n
幄=ác|g
幔=màn/mạn|n
幞=phốc|g
幡=cờ/lá cờ/phiên|ng
幰=hiển|zg
并=cũng/đồng thời/tịnh|c
幺=yêu|nr
庀=phỉ|g
庅=người|yg
床=giường/sàng|n
庋=kỹ|g
序=tự|n
庑=vũ|ng
庖=bào|ng
店=cửa hàng|n
庙=miếu|n
庠=tường|g
庳=bí|g
庵=am|ng
庶=thứ|n
庿=miếu|yg
廆=hội|zg
廏=cứu|zg
廑=cần|g
廒=ngao|g
廖=liêu|nr
廛=triền|g
廨=giải|g
廪=lẫm|g
廴=dẫn|y
廷=đình/triều đình|g
廿=hai mươi|m
开=mở/lái/khai/nở/sôi/nổ/chạy|v
弁=biện|g
弃=vứt bỏ|vg
弄=làm/làm cho/kiếm/lộng/chuẩn bị/chơi|v
弌=nhất|yg
弍=nhị|zg
弒=thí|vg
引=dẫn/rút/rời xa/thên|v
弟=đệ|n
弧=cung/hình cung/cầu vòng|n
弭=nhị|nr
弸=bằng|y
弼=bật|g
归=về/thì/thuộc về/quy|v
彖=thoán|g
彗=tuệ|n
彘=trệ|g
彳=xích|x
彷=bàng|v
征=chinh/trưng thu|v
徂=tồ|g
徉=dương|x
後=sau/hậu|nr
徕=lai|x
徘=bồi|v
徙=tỷ|vg
徜=thảng|v
徧=biến|yg
徫=vĩ|zg
徭=dao|n
徼=kiếu|g
必=tất/nhất định/tất nhiên|d
忈=đao|zg
忋=cái|zg
忌=kị|v
忏=sám|v
忑=lo lắng|x
忒=quá|d
忖=nghĩ kĩ|v
志=chí|n
忘=quên|v
忙=bận bịu/vội vàng/bề bộn/mang|v
忝=thẹn|vg
忡=xung|x
忤=ngang ngược|ag
忪=chung|x
忭=biện|g
忮=kỹ|g
忱=thầm|ng
忺=hiêm|y
忾=hi|g
忿=phẫn|a
怄=âu|v
怊=siêu|g
怎=sao/chẩm|r
怏=ưởng|z
怓=nao|x
怕=sợ/phạ|v
怖=sợ|vg
怙=hỗ|g
怦=phanh/thịch|o
怩=ngượng nghịu/ny|x
怫=phật|g
怼=đỗi/oán/đánh/đập/chọc|g
怿=dịch|g
恂=tuân/Tuân|g
恌=khiêu|y
恑=ngụy|zg
恔=hiệu|y
恚=khuể|g
恡=lận|x
恧=nục|g
恨=hận|v
恫=đỗng|vn
恰=vừa/đúng/vừa lúc|d
恺=khải|g
恽=uẩn|nr
恿=dũng|x
悃=khổn|g
悌=đễ/kính|g
悒=ấp|z
悕=hy|zg
悛=thuân|g
悝=khôi|g
悫=khác|ag
悯=mẫn|g
悰=tông|zg
悱=phỉ|vg
悻=hãnh|d
惀=luân|y
惄=nịch|zg
惆=trù|a
惕=kính sợ|g
惚=hốt|x
惝=thảng|x
惦=nghĩ về/nhớ|v
惧=sợ|v
惮=đan/sợ|vg
想=nghĩ/muốn/nhớ/tưởng|v
惹=gây/nhạ/làm cho/rước lấy/chọc|v
惼=biển|zg
愀=thiểu|x
愆=khiên|g
愍=mẫn|g
愎=phức|g
愣=sững sờ/cứ thế/lỗ mãng|v
愫=tố|g
愿=nguyện/nguyện vọng|v
慆=thao|y
慊=khiểm|g
慑=nhiếp|vg
慝=thắc|g
慞=chương|x
慱=đoàn|zg
憍=kiêu|y
憔=tiều|a
憝=đỗi|g
憬=cảnh|v
憷=sợ hãi|g
憸=tiêm|zg
懂=hiểu/đổng/u mê/bối rối|v
懊=áo|v
懋=mậu|g
懑=muộn|g
懔=lẫm|g
懽=hoàn|zg
戋=tiên|x
戏=hí/hí kịch/kịch|n
或=hoặc/có lẽ/có thể|c
戗=thương|v
戚=thích|nr
戟=kích|ng
戡=kham|vg
戢=tập|nr
戤=ngái|g
戥=đẳng|v
截=đoạn/chặn/tiệt|v
戬=tiển|g
戭=diễn|yg
戳=đâm/trạc/dãy|v
扃=quynh|g
扅=di|zg
扉=phi|n
扊=diễm|x
才=mới/tài|d
扒=đào/bới ra|v
打=đánh/đả|v
扔=ném/nhưng/vứt|v
扢=cột|y
扣=trừ/chụp/khấu trừ/cài|v
执=chấp|v
扪=môn|i
扫=quét|v
扭=xoay/uốn éo/nữu/quay tay|v
扮=đóng vai/đóng/giả trang/phẫn/quấy/nhào đều|v
扯=kéo/xé/xả|v
找=tìm/hoa|v
抃=biến|zg
把=đem/thanh/bả/ván|p
抓=bắt/trảo/trảo/gãi/|v
抟=đoàn|v
抠=móc/gảy/keo kiệt|v
抡=vung mạnh/kén/chọn/xoay|v
抢=đoạt/thưởng/cướp|v
抨=phanh|v
披=khoác/khoác trên vai|v
抬=nhấc/khiêng/giơ lên/sĩ/đánh/mang|v
抱=ôm/bão|v
抷=cụ|y
抹=bôi/xóa/mạt/vệt|v
抻=thân|v
抽=rút/quất/trừu/nảy/lấy ra/nhổ/đánh/hút|v
拄=trụ|v
担=gánh|v
拆=phá/hủy đi/sách|v
拇=mẫu/ngón cái|n
拈=nhặt|v
拊=phụ|g
拌=trộn lẫn|v
拍=đập/đấu/quay/chụp/phách/đánh|v
拎=xách|v
拔=nhổ/bạt/rút/nhổ/rút ra|v
拜=bái/lạy/bye|v
拟=mô phỏng/nghĩ/nghĩ ra|v
拣=lấy/chọn/kiếm|v
拥=ủng/cầm giữ|v
拦=cản/ngăn đón/lan/ngăn|v
拧=vặn/nhéo/vắt/ninh|v
拨=phát/gẩy|v
择=chọn/chọn|v
拱=ủi/cúi lưng/nhú|v
拴=buộc|v
拶=tạt|g
拽=túm/chảnh/túm|v
拾=nhặt/mười|v
拿=cầm/nã/nắm|v
挂=treo/hack|v
挈=khiết|g
按=theo/theo như/án/vỗ/ấn/chứng cứ/theo : đè|p
挓=tra|y
挜=á|yg
挝=qua|x
挞=thát|g
挟=mang/hiệp/cầm/kẹp|v
挠=cào/gãi/quấy nhiễu/cong|v
挣=kiếm/giãy/tranh/tránh/giãy (kiếm được)|v
挤=chen/lách vào|v
挥=vung|v
挨=chịu/lần lượt/ai/kề bên|v
挲=vuốt/sa|x
挽=kéo/xắn/vãn|v
捂=che/ô/bưng bít|v
捃=quấn|g
捅=đâm/chọc/thống/thọt|v
捆=trói/khổn/buộc/bó|v
捉=bắt/hái/tróc/nắm bắt|v
捋=vuốt/gỡ|v
捌=bát|m
捍=hãn|v
捎=mang hộ|v
捏=bóp/nắm/niết/nặn|v
捐=quyên|v
捕=bắt/bổ|v
捞=vớt/kiếm/lao/mò|v
捡=nhặt/kiểm/kiếm|v
捣=đảo|v
捧=nâng/phủng/thổi phồng|v
捩=liệt|g
捭=bãi|y
捼=noa|zg
掀=vén/nhấc lên/nhấc|v
掂=ước lượng|v
掇=xuyết|g
掊=bồi|g
掎=kỷ|g
掐=bóp/véo/kháp/bấm|v
掖=dịch|v
掘=đào/móc|v
掠=cướp/lướt|v
掣=xiết|v
控=khống|v
推=đẩy/thôi|v
掩=che đậy/ dấu/yểm/che/đậy/dấu|v
掬=cúc|v
掭=thiệm|v
掮=kiên|n
掰=tách ra|v
掴=tát|v
掷=ném/trịch/quăng|v
掸=phủi|v
掾=duyện|g
揄=du|g
揉=vò/văn vê/nhu/thuận/vân vê/nhào nặn|v
揌=tai|yg
揍=đánh/tấu|v
揎=tuyên|v
描=tô lại/copy|v
提=xách/nói/lấy/nâng/đề/dẫn/nhắc đến|v
揖=vái chào/ấp|vg
揠=yết|i
握=nắm/ác/cầm|v
揣=thăm dò/ước lượng/sủy/đo|v
揩=lau|v
揪=nắm chặt/tóm/nhéo|v
揲=thiệt|g
揽=ôm/ôm đồm|v
搁=đặt|v
搂=ôm/lâu/vơ/quơ/kéo|v
搅=quấy/khuấy|v
搋=trĩ|v
搓=xoa/chà xát|v
搔=gãi|v
搛=kiêm|v
搞=làm/kiếm/trị/cảo/làm cho|v
搠=sóc|v
搡=đẩy/táng|v
搦=nạch|g
搬=chuyển/đem/bàn/dọn sạch/mang/dời|v
搭=dựng/đáp/đi|v
搴=khiên|g
携=mang theo/dắt|v
搽=bôi|v
搿=cách|g
摁=nhấn|v
摅=sư|g
摆=bày/bãi/mở|v
摔=quẳng/ngã/suất/đánh ngã/té|v
摠=tổng|yg
摭=trích|g
摴=sư|x
摹=mô|v
撂=đặt xuống|v
撄=anh|g
撑=chống đỡ/căng cứng/xanh/no/đủ/chống|v
撕=xé/tê/nhắc/kéo|v
撖=hàn|g
撞=đụng/chàng/khua/va|v
撤=rút/rút lui/triệt|v
撦=xả|zg
撩=vẩy/trêu chọc|v
撸=lột/tuốt/cách chức/triệt/vén|n
撺=thoán|v
撼=lay|v
擂=lôi|v
操=thao/sử dụng|v
擎=giơ cao|v
擐=hoàn|g
擒=cầm/bắt/tóm|v
擘=phách/ngón cái|g
擞=tẩu|x
擢=trạc|g
擣=đảo|zg
擤=lau|v
擦=xát/lau/xoa/sát/cọ xát lấy|v
擫=áp|zg
攉=hoắc|v
攗=quấn|yg
攘=cướp/bài trừ|vg
攥=nắm|v
攷=khảo|zg
放=thả/phóng/để/đuổi/bỏ/chiếu|v
敉=mị|g
敚=đoạt|yg
敝=tệ|r
敞=mở|v
敧=khi|zg
敫=kiểu|g
敲=gõ/xao/đập|v
敷=thoa|v
斄=ly|yg
斋=trai/chay|ng
斌=bân|nr
斐=phỉ|j
斑=ban/lốm đốm/Madara|n
斓=lan|x
斛=hộc|q
斝=giả|zg
斟=châm|v
斠=dác|yg
斡=oát|v
斫=chước|vg
斸=trọc|zg
斾=bái|zg
旁=bên cạnh/bàng/cạnh/bên|f
旂=kỳ|zg
旃=chiên|g
旄=mao|g
旆=bái|g
旉=phu|zg
旌=tinh|n
旎=nỉ|x
旐=triệu|x
旒=lưu|g
旓=sao|zg
旗=cờ/flag/kỳ|n
旟=dư|zg
旣=ký|yg
旮=ca/mọi ngóc ngách|n
旯=xó|x
旰=cán|g
昀=quân/vân|g
昃=trắc|g
昕=hân|g
昝=tảm|nr
映=chiếu/ánh|v
昡=huyền|zg
昧=giấu/muội|v
是=là/thị/đúng/vâng/phải|v
昱=dục|g
昴=mão/Subaru|g
昶=sưởng|g
显=hiển/lộ ra/lộ vẻ/hiện ra|v
晁=Triều/triều|nr
晃=lắc/hoảng/lay động/sáng ngời|v
晏=yến|nr
晒=phơi/phơi nắng|v
晔=diệp|g
晕=choáng/chóng mặt/vựng/vầng sáng/ngất/choáng váng|v
晖=huy|nr
晗=hàm|g
晛=hiện|yg
晟=thịnh|g
晡=giờ Thân|g
晤=ngộ|vg
晰=tích/rõ ràng|g
晷=quỹ|g
暇=rảnh|g
暌=khuê|vg
暕=giản|y
暖=ấm/noãn/ấm áp|a
暠=cảo|zg
暵=hán|yg
暹=xiêm|x
暾=thôn|g
曙=thự|n
曛=huân|g
曦=hi|nr
曩=nẵng|g
更=càng/canh/đổi/lại thêm/hơn|d
曷=hạt|g
曹=tào|nr
曾=từng/tằng/bèn|d
有=có/hữu|v
朊=nguyễn|g
朐=cù|g
朕=trẫm|g
朱=đỏ thắm|nr
杀=giết/sát|v
杅=vu|zg
杈=chạc/xoa|n
杌=ngột|g
杞=kỷ|ns
来=đến/tới/lai|v
杩=mã|x
杲=cảo|nr
杷=ba|x
杼=trữ|g
枇=tỳ|n
枉=uổng|vg
枋=phương|g
枌=phần|yg
析=tích|vg
枑=hộ|zg
枘=nhuế|g
枢=trụ cột/khu|n
枣=táo/tảo/cây táo|n
枥=lịch|g
枧=kiển|g
枨=tranh|g
枪=thương/súng/phát đạn/đạn|n
枲=tỷ|yg
枴=quải|zg
枵=hiêu|g
枷=gông/cái gông|n
枸=cẩu|n
枻=duệ|yg
柁=đả|g
柂=đà|zg
某=nào đó/mỗ//một|r
柒=thất|m
柢=để|g
柰=nại|g
柲=bí|yg
柷=chúc|y
柹=thị|x
栉=trất|g
栊=long|g
栌=lô|x
栎=lịch|ng
栏=cột/thanh/lan|n
栔=cắt|y
栩=hủ|i
栱=củng|zg
栲=khảo|n
栳=lão|x
栾=loan|nr
桄=quáng|n
桉=án|n
桊=quyên|g
桎=chất|n
桠=nha|n
桡=nạo|n
桢=trinh/Trinh|g
桤=khởi|g
桥=cầu/kiều|n
桨=mái chèo|n
桲=dụng cụ đập lúa|zg
桴=phù|g
桷=giác|g
桿=que|q
梃=đĩnh|n
梏=cùm|g
梐=bệ|x
梗=ngạnh|v
梠=lữ|yg
梢=sao/ngọn|ng
梨=lê|n
梲=chuyết|zg
梳=chải/chải đầu/sơ|v
棂=linh|g
棋=cờ/quân cờ|n
棐=phỉ|yg
棚=lều/rạp|n
棫=vực|y
棬=khuyên|yg
棰=trùy|v
棵=khỏa/cây/gốc cây|q
椁=quách|g
椋=lương|x
椎=chùy|n
椐=cư|g
椒=tiêu/ớt|ng
椓=trạc|zg
椠=tạm|g
椤=la|x
椭=thỏa|n
椴=đoạn|n
椶=tông|yg
椷=giam|zg
椹=châm|x
楂=tra|x
楗=kiện|g
楘=mộc|y
楝=luyện|n
楢=do|zg
楣=mi|g
楦=tuyên|ng
楫=tiếp|ng
楸=thu|g
楹=doanh|q
楼=lâu/lầu|n
榄=lãm|g
榇=sấn|g
榈=lư|x
榍=xiè|x
榑=phù|zg
榔=lang|n
榫=chuẩn|n
榭=tạ|g
榱=suy|g
榷=các|g
榻=giường/giường|n
榼=khạp|zg
槁=khô héo|g
槊=sóc/giáo|g
槌=chùy|ng
槎=tra|ng
槔=cao|x
槟=tân|n
槥=tuệ|zg
槱=dửu|zg
槲=sồi|n
槽=rãnh/cái rãnh|ng
槿=cẩn/cẩn (hoa dâm bụt)|x
樗=xư|g
樘=đường|q
樛=cù|yg
樨=tê|x
樯=tường|ng
樽=tôn|ng
樾=việt|g
橄=cảm|n
橅=mô|y
橇=khiêu|g
橐=bễ thổi lửa|o
橘=quýt/quất|n
橛=cọc/quyết|n
橡=cao su|n
橤=nhị|x
橥=trư|g
橧=tăng|yg
橹=mái chèo/lỗ/thuẫn|ng
橼=duyên|x
檎=cầm|x
檐=mái hiên nhà|ng
檫=sát|g
檬=mông|x
檮=đào|yg
櫍=chất|zg
櫜=cao|x
櫼=tiêm|y
欂=đấu cùng|y
欃=sàm|zg
欋=cù|zg
欝=uất|zg
欠=thiếu/thiếu nợ/khiếm/ngáp/nợ|v
欤=dư|y
欷=hi|x
欿=khảm|zg
歆=hâm|g
歇=nghỉ|v
歜=xúc|zg
歪=lệch nghiêng|v
歰=sáp|zg
歾=một|zg
殂=chết|g
殄=điễn|g
殇=thương/chết non|vg
殍=biễu|x
殒=vẫn|v
殓=liễm|vg
殛=cức|g
殠=xú|zg
殪=ế|g
殳=thù|nr
殻=xác|zg
毁=hủy|v
毂=cốc|x
毌=quán|yg
毖=bí|g
毙=đánh chết/giết|v
毪=mâu|g
毳=thuế|g
毵=tam|x
毹=du|x
毽=kiến|n
氄=nhũng|yg
氅=áo  khoác/áo cừu/áo khoác|g
氆=phổ|n
氇=lỗ|x
氍=cù|n
氐=để|g
氓=manh|x
气=khí/chọc tức/tức giận/tức/giận|n
氕=ách|g
氖=nãi|n
氘=đao|g
氚=xuyên|g
氛=phân|n
氡=đông|g
氢=hydro|n
氤=nhân|n
氦=heli|n
氨=an|n
氩=á|n
氪=khắc|g
氮=nitơ/nitrogen|n
氯=lục|n
氲=uân|x
水=nước/thủy|n
求=cầu/tìm/trách/xin/ngang/van|v
汆=thộn|v
汊=xá|n
汍=hoàn|yg
汎=phiếm|yg
汐=tịch/Tịch|g
汞=thủy ngân|n
汩=cốt|o
汫=tỉnh|y
汰=bỏ/thái|vg
汳=biện|yg
汽=hơi/khí|n
沌=độn|x
沏=pha/ngâm vào nước|v
沘=tỉ|yg
沤=ngâm ủ|v
沩=Viên|g
沪=hỗ|j
沫=mạt/bọt|n
沱=đà|ns
沴=lệ|zg
油=dầu/du/mỡ|n
治=trị/quản lý|v
沽=cô|j
泅=tù|v
泐=lặc|g
泑=ửu|zg
泒=cô|zg
泓=hoằng/dòng|q
泔=cam|n
泖=mão|g
泛=hiện/hiện lên/hiện ra|v
泞=nính|g
注=chú/rót|v
泮=phán|nr
泯=mẫn|vg
泲=tể|yg
洇=nhân|v
洌=liệt|g
洎=kịp|g
洏=nhi|yg
洗=tẩy/tắm/rửa/giặt rửa/giặt|v
洙=thù|g
洞=động/lỗ|n
洧=vị|g
洫=hức|g
洮=thao|ns
洱=nhị|ns
洳=như|x
洵=tuân|g
洹=hoàn|g
派=phái|v
浃=tiếp|g
浇=tưới/giội/dội|v
浈=trinh|g
浍=quái|g
浏=lưu|ns
浞=trác|v
浠=hy|g
浣=hoán|vg
浯=ngô|g
浸=thấm/ngâm|v
涌=tuôn ra/trào|v
涔=sầm|g
涘=sĩ|zg
涞=lai|g
涡=cơn xoáy|n
涣=hoán|v
涧=khe|ng
涩=chát chát|a
涪=phù|ns
涫=loan|g
涯=nhai|ng
淄=truy|ns
淇=kỳ|g
淌=trôi/chảy|v
淖=náo|g
淘=đãi/vo/nghịch|v
淙=tông|o
淝=phì|g
淞=tùng|g
淟=điến|x
淠=tụy|g
淹=chìm|v
渌=lục|g
渍=nước đọng|v
渐=dần/dần dần/tiệm|d
渗=thấm|v
渝=du/Du - Tứ Xuyên|j
渠=mương/kênh mương|n
渫=tiết|g
渭=vị|ns
湃=phái|x
湎=miện|x
湑=tư|zg
湓=bồn|g
湔=tiên|g
湦=sinh|zg
湩=chúng|y
湫=tưu/thấp trũng hồ nước|g
湽=truy|y
溁=oanh|yg
溅=tung tóe/tiên/bắn tung tóe|v
溆=tự|g
溉=khái|vg
溏=đường|g
溓=liễm|yg
溜=trượt/lưu/chuồn mất/dải/chạy|v
溟=minh|g
溥=phổ|nr
溧=lật|g
溱=trăn|g
溴=xú|ng
溽=nhục|n
滁=trừ|ns
滂=bàng|a
滇=điền|j
滏=phũ|g
滓=cặn|g
滕=đằng|nr
滗=tiết|v
滘=khiếu|zg
滟=diễm|x
滠=nhiếp|g
滢=oánh|g
滦=loan|j
滪=dự|zg
滹=hô|ns
滺=du|zg
漉=lộc|v
漑=cái|zg
漤=lãm|v
漩=tuyền|n
漭=mãng|x
漯=tháp|ns
漱=thấu|v
漶=hoán|x
潆=oanh|x
潍=duy|ns
潓=huệ|yg
潘=phan|nr
潦=lạo|a
潭=đầm|n
潴=trư|v
潸=san|i
潺=sàn|z
澈=triệt|g
澌=ti|g
澍=chú|g
澑=lựu|zg
澶=thiền|g
澼=phích|yg
澽=cự|zg
濂=liêm|g
濆=phần|yg
濉=tuy|g
濎=đỉnh|y
濑=lại|ns
濞=tị|x
濠=hào|g
濯=rửa/trạc|vg
瀵=phẫn|g
瀹=thược|g
灂=tiếu|zg
灏=hạo|g
灒=tiễn|y
灞=bá|x
灭=diệt|v
灯=đèn|n
灳=linh|zg
灶=lò|n
灸=cứu|g
灾=tai/tai họa|n
炅=cảnh|g
炒=xào/rang|v
炔=khuyết|n
炕=giường/kháng/khô ráo/nướng/sấy/hé ra/mở ra|n
炖=hầm/hầm cách thủy/đôn/cách thủy|v
炜=vĩ|nr
炝=sang|v
炬=bó đuốc|g
炭=than|n
炷=trụ|q
炻=thạch|x
烀=luộc|v
烃=hĩnh|n
烊=dương|x
烟=khói/thuốc/yên/thuốc lá|n
烨=diệp|nr
烫=bỏng/nóng/sấy/hâm/bị phỏng|v
烬=tẫn|g
烯=ankin|x
烷=hoàn|n
烹=nấu|v
焊=hàn/hạn|v
焐=ngộ|v
焓=hàm|g
焖=hầm/muộn|v
焘=đảo|nr
焙=bồi|v
焮=hân|y
焯=trác|v
焱=diễm|g
煅=nung|v
煇=huy|zg
煎=sắc/rán/pha/sắc thuốc|v
煔=thiểm|zg
煚=cảnh|zg
煤=than đá|n
煦=húc/húc|nr
煨=nướng/nướng (lò nóng)|v
煮=nấu/chử/đun/luộc|v
煳=hồ|a
煺=thoái|v
煽=phiến|v
熄=tắt|v
熇=hốc|x
熘=lựu|v
熬=chịu/nấu/ngao/rang khô|v
熯=hãn|y
熳=mạn|x
熵=entropy|g
燔=phần|g
燠=úc|ag
燧=toại|n
燮=tiếp|g
燹=tiển|g
爆=bạo|v
爝=tước|x
爟=quán|zg
爬=bò/ba/gãi/cào|v
爰=viên|g
爸=cha/ba|n
爹=cha/đa|n
爿=tường|q
牂=tang|zg
版=bản/hãy|n
牋=tiên|zg
牌=bài/nhãn hiệu|n
牒=điệp|g
牙=răng/nha|n
牝=tẫn|n
牦=ly|n
牮=tiến|g
牯=cổ|n
牵=dắt/khiên|v
牷=toàn|yg
牺=hi|v
牾=ngộ|vg
牿=cố|yg
犂=lê|yg
犄=cơ|n
犊=nghé/độc|ng
犋=cụ|q
犏=thiên|x
犟=cưỡng|a
犴=ngạn|x
犷=hung ác|a
犸=voi ma mút|x
狁=duẫn|x
狃=nữu|g
狈=bái|x
狍=bào|n
狒=phí|n
狓=phi|y
狖=dứu|zg
狗=chó/cẩu/con chó|n
狥=tuẫn|zg
狲=tôn|x
狳=dư|x
狷=quyến|x
狺=ngân|x
狻=toan|x
狾=chế|yg
猁=lỵ|x
猃=hiểm|g
猊=sư tử|x
猖=xương|a
猘=chế|y
猞=xá|n
猢=hồ|n
猨=viên|zg
猪=heo/lợn/trư|n
猬=vị|g
献=hiến|v
猱=nhu|g
猲=yết|yg
猺=dao|zg
獍=kính|g
獒=ngao|g
獗=quyết|x
獠=liêu|n
獧=quyến|yg
獬=giải|x
獭=rái cá|g
獯=huân|x
獾=chồn|g
玅=diệu|y
率=suất/tỷ số/dẫn đầu/suất (*tỉ lệ)|v
玍=ca|y
玑=cơ|g
玖=cửu|m
玡=nha|y
玢=phân|x
玫=hồng/đẹp|n
玮=vĩ|nr
玳=đại|n
玹=xuân|zg
玺=tỉ/tỉ (ngọc tỉ)|ng
玼=tần|y
珀=phách|nrt
珈=già|g
珉=mân|nr
珏=giác|g
珐=pháp|n
珑=lung|x
珙=củng|g
珧=diêu|g
珷=vũ|y
球=cầu/bóng|n
琊=gia|g
琏=liễn|g
琚=cư|nr
琛=sâm|g
琢=mài/dũa|v
琦=kỳ|nr
琨=côn|g
琬=uyển|g
琮=tông|g
琰=diễm|g
琴=đàn/cầm/Gin|n
琵=tỳ|n
瑁=mạo|x
瑉=mân|y
瑗=viện|g
瑚=hô|x
瑛=anh|g
瑭=đường|g
瑮=lật|x
瑯=lang|yg
瑲=thương|y
瑷=ái|x
瑾=cẩn|nr
璀=thôi|z
璁=thông|g
璃=ly|x
璇=tuyền|g
璋=chương|g
璎=anh|n
璐=lộ|nr
璜=hoàng|nr
璞=phác|nr
璨=xán|g
璩=cừ|nr
璪=tảo|yg
瓒=toản|nr
瓴=linh|g
瓶=bình|n
瓿=bẫu/vò/bình|g
甍=manh|g
甎=chuyên|zg
甏=bảnh|ng
甓=bích|g
甙=đại|g
甥=sinh/cháu trai|n
甩=vung/súy/vứt/vẫy/bỏ rơi|v
甫=vừa/phủ|d
申=thân|v
电=điện|n
甾=tai|g
畀=tí|g
畆=mẫu|yg
畈=phán|q
畎=quyến|g
畔=bờ/bên|ng
留=lưu|v
畚=bổn|n
畛=chẩn|g
畯=tuấn|zg
畲=xa|j
畴=trù/dự định|g
畹=uyển|ns
畽=thoản|zg
疃=thoản|g
疋=sơ|g
疌=tiệp|zg
疎=sơ|zg
疐=chí|y
疔=đinh|n
疖=tiết|n
疙=ngật|n
疚=day dứt|g
疟=ngược|n
疠=lệ|g
疡=dương|g
疣=vưu|g
疤=sẹo|n
疥=giới|n
疬=lịch|x
疭=túng|zg
疮=đau nhức/loét|n
疰=chú|x
疱=pháo|n
疳=cam|n
疴=a|g
疵=tỳ|n
疸=đản|x
疽=thư|g
痀=câu|yg
痂=vảy|n
痄=chá|n
痈=ung|n
痉=kinh|vn
痊=hết bệnh|v
痌=thông|yg
痍=di|g
痏=vị|zg
痒=ngứa/nhột/dương/ốm|a
痔=trĩ|n
痖=á|g
痞=du côn|n
痢=lỵ|n
痣=nốt ruồi|n
痤=tọa|n
痨=lao|n
痪=hoán|x
痫=giản|x
痰=đàm|n
痱=phi|n
痹=tý|ng
痺=tí|ng
痼=cố|n
瘀=ứ|g
瘁=tụy|vg
瘃=chúc|x
瘅=đản|x
瘏=đồ|zg
瘐=dũ|x
瘕=hà|g
瘗=ế|g
瘘=lũ|g
瘚=quyết|zg
瘛=xiết|x
瘢=ban|n
瘥=ta|yg
瘩=đáp|x
瘪=xẹp/quắt|a
瘫=co quắp/than/tê liệt|v
瘰=lỗi|n
瘳=sưu|nr
瘴=chướng|n
瘵=ốm|g
瘼=mạc|g
瘾=nghiện|n
瘿=anh|g
癀=hoàng|x
癎=giản|zg
癔=ý|n
癜=điến|g
癞=lại|n
癣=tiển|n
癯=cù|g
皆=đều/đều là/giai/toàn là/cũng/tất cả|d
皈=quy|v
皊=linh|y
皋=cao|g
皑=ngai|z
皙=tích|g
皤=bà|g
皦=kiểu|yg
皮=da/lì lợm/vỏ/lì|n
皲=quân|v
皿=mãnh/bồn|x
盂=vu|g
盉=hoà|y
盍=hạp|g
盎=áng|q
盏=ngọn/chén nhỏ/ngọn đèn|q
盐=muối|n
盔=nón trụ|n
盥=quán|b
盬=cổ|zg
盯=chằm chằm/trành/nhìn chăm chú/nhìn chòng chọc|v
盱=hu|ns
省=bớt/tỉnh/tiết kiệm|n
眄=miện|vg
眇=mù|g
眈=đam|x
看=nhìn/khán/xem|v
眍=khu|v
眎=thị|zg
眘=thận|zg
眚=sảnh|ng
眠=ngủ|vg
眢=oan|g
眦=khóe mắt|g
眭=khôi|nr
眯=híp mắt|v
眵=si|g
眶=vành mắt|ng
睁=trợn|v
睂=mi|y
睃=thoa|v
睇=liếc/thê|vg
睍=hiển|yg
睐=liếc/lãi|g
睑=kiểm|g
睠=quyến|y
睡=ngủ/thụy|v
睦=hòa thuận|ag
睨=nghễ|vg
睫=tiệp|n
睬=không hỏi|v
睽=khuê|g
睾=cao|n
瞀=mậu|g
瞅=nhìn|v
瞌=khạp|v
瞍=tẩu|g
瞒=giấu/giấu diếm/man/lừa gạt/dấu diếm|v
瞚=thuấn|yg
瞟=nghiêng mắt nhìn|v
瞢=măng|g
瞧=nhìn/tiều/trông trộm/coi|v
瞪=trừng|v
瞰=khám|g
瞵=lân|vg
瞶=quý|y
瞽=cổ|g
瞿=cù|nr
矍=quắc|a
矗=súc|v
矙=khám|y
矬=tọa|n
矰=tăng|zg
矶=ki/mỏm đá/ki|g
矸=canh|n
矼=cang|zg
矿=mỏ|n
砀=nãng|g
砂=cát/sa|n
砃=đá trắng|zg
砉=hoạch|o
砍=chặt/khảm/chém|v
砑=nhạ|g
砖=gạch/cục gạch|n
砘=đôn|v
砜=phong|g
砝=kiếp|n
砣=đà|v
砦=trại|g
砫=trụ|zg
砬=lạp/đá|g
砮=nỗ|zg
砰=phanh/ầm/bịch/phịch|o
破=phá|v
砷=thân|n
砸=nện/tạp/đập bể/đập|v
砹=Astatine|g
砻=xay lúa|v
砼=đồng|n
础=sở|ng
硇=nao|ns
硌=cấn|v
硎=hình|g
硐=đồng|g
硒=tây|n
硖=giáp|g
硗=khao|x
硝=tiêu|n
硪=ngã|g
硫=lưu huỳnh/lưu|n
硭=mang|x
硼=bằng|n
碇=đĩnh|g
碉=điêu|n
碑=bia|n
碓=đối|g
碘=i-ốt|n
碚=bối|g
碛=thích|g
碜=sầm|x
碥=biển|g
碯=não|zg
碰=đụng/bính/va/chọi/chạm/phanh|v
碲=đế|g
碶=thế|yg
磎=khê|yg
磔=trách|g
磕=đập/dập đầu|v
磙=quả lăn|n
磬=khánh|ng
磲=cừ|x
磴=đặng|q
磷=lân|n
礀=tư thế|yg
礁=đá ngầm san hô|n
礅=đôn|g
礓=cương|x
礞=mông|x
礤=sát|x
礮=pháo|yg
礴=bạc|x
社=xã|n
祀=tự|g
祃=mã|y
祆=hiên|x
祉=chỉ/Chỉ|ng
祊=banh|y
祓=phất|g
祗=chi|g
祚=tộ|g
祜=hỗ|g
祟=túy/ma|g
祧=thiêu|g
票=phiếu/vé/phiếu vé|n
祯=trinh/Trinh|g
祲=tẩm|y
祸=họa|n
祹=Tạo|zg
祺=kỳ/Kỳ|g
禀=bẩm|v
禊=hễ|g
禋=nhân|zg
禑=Từ|yg
禠=ti|x
禧=hi|g
禳=nhương|a
禺=ngu|g
离=cách/rời/ly|v
秆=thân/cán|ng
秊=niên|x
秕=bỉ|n
秣=mạt|g
秤=cái cân/cân|n
秫=thuật|n
称=xưng/hiệu/danh hiệu/cân|v
秸=cành cây|n
稂=lang|g
稃=phù|g
稆=lữ|zg
稌=đồ|y
税=thuế|n
稗=bại|ng
稞=khoa|n
稠=nhiều|a
稣=tô|g
稷=tắc|g
稺=trĩ|x
穉=trĩ|yg
穊=ký|zg
穑=sắc|x
穰=nhương|g
穸=tịch|x
穹=khung|n
窀=truân|x
窃=trộm|vg
窄=hẹp/chật vật|a
窆=biếm|g
窊=oa|yg
窎=điếu|yg
窒=tắc nghẽn|v
窕=điệu|x
窖=hầm|n
窠=khoa|n
窨=ấm|v
窬=du|g
窭=cũ|g
窰=diêu|zg
窵=điếu|zg
竂=lều|y
站=đứng/trạm|v
竚=trữ|zg
竝=tịnh|y
竟=lại/mà/cánh/ắt/rốt cuộc/nhất định/cuối cùng/càng|d
竦=tủng|g
竫=tĩnh|zg
竺=trúc|nr
竽=vu|g
竿=can|ng
笃=đốc/soạt|ag
笄=kê|g
笆=ba|n
笈=tráp/cấp|g
笊=tráo|n
笕=kiển|g
笙=sênh/sinh|n
笞=quất/si|vg
笤=điều|n
笪=đát|nr
笫=chỉ|g
第=thứ|m
笮=trách|g
笳=già|g
笴=cảm|zg
笾=biên|g
筀=quế|yg
筅=tiển|x
筈=quát|zg
等=chờ/các/các loại/mấy người/mấy/bằng/mấy cái/vân vân|u
筋=gân|n
筌=thuyên|g
筏=bè/phiệt|ng
筑=trúc/xây|v
筝=tranh|n
筮=thệ|g
筱=tiêu|g
筲=sao|g
筵=tiệc lễ|n
筻=cánh|g
签=ký/lá thăm|v
箇=cá|zg
箍=quấn/đai/siết/cô|v
箎=trì|zg
箐=tinh/thiến|g
箑=tiệp|zg
箔=bạc|n
箕=ki|g
算=tính/toán/tính toán/coi là|v
箚=tráp|zg
箝=kiềm|n
箢=uyên|x
箦=trách|g
箨=thác|g
箫=tiêu|ng
箬=nhược|n
箭=tiễn/mũi tên/tiến|n
箾=sao|zg
篁=hoàng|g
篌=hầu|x
篙=cao|ng
篚=phỉ|g
篛=nhược|zg
篦=bề|n
篨=trừ|zg
篪=trì|g
篲=tuệ|zg
篾=miệt|n
簋=quỹ|ng
簌=tốc|z
簏=lộc|g
簑=thoa|y
簖=đoán|g
簟=điệm|g
簠=phủ|zg
簧=lò xo|n
籀=trứu|g
籁=lại|ng
籍=tịch|ng
籖=thiêm|zg
籝=doanh|yg
籧=cừ|x
籰=dược|zg
籴=địch|v
籼=tiên|n
粃=chủy|yg
粑=ba|g
粕=phách|g
粜=thiếu|v
粝=lệ|g
粞=tê|g
粟=túc/túc (hạt kê)|nr
粢=tư|g
粤=Quảng Đông/Việt(quảng đông)|j
粥=cháo|n
粪=phân/cứt/phẩn|n
粮=lương/lương thực|n
粰=phu|x
粱=lương|nr
粲=sán|a
粳=canh|n
粹=túy|ng
粼=lân|z
糇=hầu|g
糈=tư|g
糌=ta|n
糱=nghiệt|y
絁=thi|zg
絏=tiết|yg
絓=quái|zg
絜=kiết|y
絫=lũy|x
絷=trập|g
絻=miễn|yg
綪=khiếm|zg
緎=vực|zg
総=tổng|yg
緑=lục|yg
緪=căng|zg
縰=sỉ|yg
縻=mi|g
繂=luật|zg
繇=diêu|p
繐=huệ|yg
繖=tản|zg
繙=phiên|y
繨=đáp|zg
繵=triền|zg
繻=nhu|zg
纁=huân|zg
纇=lỗi|y
纚=sỉ|y
纡=quanh co|g
纥=hột|x
纩=khoáng|g
纫=nhân|g
纲=cương|n
纶=luân|x
纸=giấy/chỉ/tử|n
纾=thư|g
线=tuyến/dây/đường/sợi dây|n
绀=cám|g
绁=tiết|g
绂=phất|g
绉=trứu|n
绋=phất|g
绌=truất|g
绎=dịch|g
绐=đãi|g
绒=nhung|n
绔=khố|x
绕=quấn/nhiễu/cuộn/ôm trọn/lượn quanh|v
绗=hàng|v
给=cho/cấp/bị|p
绛=giáng/đỏ thẫm|b
绠=cảnh|g
绡=tiêu|g
绢=lụa|n
绦=thao|n
绨=đề|g
绪=tự|ng
绱=thượng|v
绲=cổn|v
绶=thụ|ng
绹=đào|zg
绺=túm|q
绻=quyển|x
绾=quán|v
缀=xuyết|v
缁=truy|g
缃=tương|g
缇=đề|g
缈=miểu|x
缉=tập|v
缋=hội|g
缌=ti|g
缏=biền|g
缑=câu|g
缒=trúy|v
缗=xâu|q
缚=trói/trói buộc|vg
缛=nhục|g
缟=cảo|g
缠=quấn/triền/dây dưa|v
缡=ly|g
缢=treo cổ|g
缣=kiêm|g
缤=tân|z
缥=phiêu|a
缧=luy|x
缨=anh|ng
缩=co lại/lui|v
缬=hiệt|g
缭=quấn|v
缮=thiện|v
缯=tăng|g
缲=sào|v
缳=hoán|g
缴=giao nộp|v
缵=toản|g
缸=vạc/vại|n
罂=anh|n
罄=khánh|vg
罋=úng|x
罔=võng|g
罘=chúng|g
罛=cô|zg
罟=cổ|g
罡=cương|x
罨=yểm|g
罩=che đậy/tráo/cái lồng|v
罳=ty|zg
罾=tăng|g
罿=đồng|x
羇=ki|zg
羊=dê|n
羚=linh|n
羝=đê|g
羟=thưởng|n
羧=các-bô-xít cooh|x
羱=nguyên|zg
羲=hi|g
羸=luy|z
羹=canh|ng
羼=sạn|g
羿=nghệ|nr
翊=dực|g
翌=dực|t
翕=hấp|v
翘=vểnh/vểnh lên/kiều|v
翟=địch/Trạch (họ)|nr
翡=phỉ|n
翣=sáp|zg
翦=tiễn|nr
翫=ngoạn|zg
翮=cách|g
翱=cao|v
翳=ế|g
翻=lật/trở mình|v
者=người/giả/cái|k
耇=cẩu|zg
耈=cẩu|zg
耋=điệt|g
而=mà|c
耍=đùa nghịch/đùa giỡn/đùa bỡn|v
耑=chuyên|yg
耒=lỗi|ns
耔=tỷ|y
耖=sao|n
耘=vân|vg
耠=hoát|v
耥=thang|x
耧=máy gieo hạt|g
耨=nậu|g
耩=giảng|g
耪=bảnh|v
耱=ma|g
耵=đinh|x
聂=Nhiếp/Niếp|nr
聃=đam|g
聍=ninh|x
聘=mời/sính|v
聧=khuê|zg
聩=hội|g
肄=dị|v
肈=triệu|yg
肉=thịt|n
肋=sườn/(sườn) lôi thôi|n
肓=hoang|x
肛=giang/chống/hậu môn|n
肜=dung|g
肟=ốc|g
肠=ruột/tràng|n
肧=phôi|zg
肪=phương|x
肫=truân|g
肭=nạp|x
肮=khảng|a
肱=quăng/cánh tay|n
肴=đồ ăn|g
肷=hàm|g
肺=phổi|n
胀=trướng|a
胂=thân|g
胃=dạ dày|n
胄=trụ|g
胍=qua|g
胏=chỉ|zg
胗=truân|g
胙=tạc|g
胚=phôi|n
胛=giáp|n
胝=chi|x
胞=bào|n
胠=khư|yg
胤=dận|g
胥=tư|nr
胧=lung|x
胨=đống|g
胩=ca|g
胪=lư|g
胭=son|n
胱=quang|x
胴=thân mình|n
胹=nhi|yg
胺=án|n
胼=biền|n
胾=chí|yg
脆=giòn|a
脎=thỏa|g
脑=não|n
脒=mễ|g
脓=mủ/nùng: mủ|n
脔=luyến|g
脗=vẫn|yg
脘=quản|g
脚=chân/cước|n
脝=hanh|yg
脞=thỏa|g
脩=tu|n
脬=phao|x
脯=mứt|g
脲=niệu|g
脶=loa|yg
脾=tỳ|n
腁=biền|zg
腆=ưỡn|v
腑=phủ|g
腙=tông|g
腠=thấu|ng
腧=thú|n
腩=nạm|x
腭=ngạc|n
腮=má/mang/quai hàm|n
腰=eo/thắt lưng|n
腱=kiện|n
腲=uỷ|y
腺=tuyến|n
腻=dính/ngán/chán|v
腼=điến|a
腿=chân|n
膂=lữ|n
膊=cánh tay|g
膑=tẫn|g
膓=tràng|zg
膙=cưỡng|zg
膛=thân/lồng ngực/thang/ngực|ng
膜=màng|n
膞=thuần|y
膦=hợp chất hữu cơ|g
膨=bành|v
膪=troại|x
膺=ưng|vg
臁=liêm|g
臛=hoắc|zg
臢=châm|y
臧=tang|nr
臬=nghiệt|nr
致=gây nên/gửi tới/dồn|v
臾=du|x
舀=múc/cầm|v
舂=giã|v
舃=tích|y
舌=lưỡi|n
舐=liếm|vg
舔=liếm|v
舘=quán|y
舜=thuấn|g
舡=hang|g
舣=nghĩ|g
舨=bản|x
舩=thuyền|yg
般=bàn/giống như/vậy|u
舭=tỉ|x
舱=khoang thuyền/khoang|n
舳=trục|x
舴=trách|x
舵=đà/tay lái|n
舶=thuyền đi biển|ng
舸=khả|g
船=thuyền|n
舻=lô|g
舾=tây|n
艄=sao|n
艉=vĩ|g
艋=mãnh|x
艎=hoàng|x
艏=thủ|g
艚=tào|g
艟=đồng|x
艮=cấn|g
艳=diễm/tươi đẹp|a
艿=nãi|x
芈=mị|o
芍=thược|n
芎=khung|x
芏=đỗ|x
芑=khỉ|g
芘=tỷ|x
芟=sam|v
芡=khiếm|n
芨=cập|n
芩=cầm|nr
芪=kỳ|x
芫=nguyên|n
芮=nhuế|nr
芰=kỵ|g
芴=vật|g
芼=mạo|y
芽=mầm/mầm mỏ|n
芾=phất|x
苁=thung|x
苄=biện|x
苈=lịch|x
苊=ách|g
苋=hiện|n
苌=trường|nr
苎=trữ|n
苒=nhiễm|x
苓=linh|x
苕=điều|n
苖=địch|zg
苙=lập|zg
苜=mục|n
苡=dĩ|g
苣=rau diếp|x
苤=phiết|n
苫=thiêm|v
苯=bổn|n
苷=đại|x
苻=phù|nr
苽=cô|zg
茆=lữu|nr
茉=mạt|n
茌=trì|nr
茎=thân/hành|n
茏=lung|x
茑=điểu|g
茔=oanh/phần|ng
茖=các|y
茗=minh/trà|ng
茚=ấn|g
茛=cấn|x
茬=gốc rạ/mảnh vụn (gốc)|q
茭=giao|n
茯=phục|n
茱=thù|n
茴=hồi|n
茶=trà|n
茹=như|nr
茺=sung|x
茼=đồng|n
荀=Tuân/tuần|nr
荃=thuyên|g
荇=hạnh|x
草=cỏ/cây cỏ/thảo|n
荐=tiến|vg
荑=đề|g
荘=trang|x
荙=đạt|zg
荛=nhiêu|g
荜=tất|x
荡=đãng|v
荦=lạc|g
荨=tầm|n
荩=tẫn|g
荬=mại|x
药=thuốc/dược|n
荽=tuy|x
莆=phủ|ns
莓=dâu|g
莛=đình|g
莜=du|n
莠=xấu|ag
莩=phu|x
莰=khảm|g
莳=thì|x
莶=hiêm|x
获=lấy được|v
莸=du|g
莺=oanh|ng
菀=uyển|x
菅=gian|nr
菇=nấm|ng
菌=khuẩn|n
菔=bặc|x
菖=xương|n
菘=tùng|g
菜=đồ ăn/rau/món ăn/thái|n
菟=thố|n
菠=cải bó xôi|n
菤=quyển|y
菩=bồ|n
菪=đãng|x
菰=cô|g
菴=am|zg
菹=trư|g
菼=thảm|zg
萁=ki|g
萄=đào|x
萆=tỳ|x
萋=thê|x
萎=héo|v
萏=đạm|x
萑=hoàn|g
萘=đồ|g
萜=thiếp|g
萤=huỳnh|n
萱=huyên|n
萸=du|x
葆=bảo|vg
葑=phong|g
葖=đột|n
葙=tương|x
葛=cát|nr
葩=ba/hoa|ng
葭=gia|g
葸=tỷ|g
葺=tập|g
蒇=siển|g
蒈=khải|g
蒉=quỹ|nr
蒌=lâu|x
蒍=thân cây súng|zg
蒎=phái|g
蒗=lang|g
蒜=tỏi|n
蒯=khoái|nr
蒱=bồ|zg
蒲=Bồ|nr
蒴=sóc|g
蒹=kiêm|g
蒺=tật|n
蓁=trăn|x
蓉=dung|j
蓍=thi|g
蓐=nhục|g
蓑=thoa|n
蓖=tỳ|n
蓟=kế|nr
蓠=ly|x
蓣=dự|x
蓦=đột nhiên|d
蓨=điệu|zg
蓿=túc|x
蔓=mạn|v
蔡=thái|nr
蔪=tiêm|zg
蔷=tường|n
蔸=đâu|q
蔹=liêm|x
蔻=khấu|x
蔼=ái|g
蔽=che|v
蕈=khuẩn|g
蕋=nhị|zg
蕖=cừ|x
蕙=huệ|ng
蕞=tối|x
蕠=như|zg
蕤=nhuy|x
蕾=nụ/lôi|nr
薁=áo|x
薅=kéo/hao|v
薇=vi|g
薖=oa|zg
薛=tiết|nr
薜=bệ|nr
薢=giải|zg
薤=giới|g
薧=hảo|y
薨=hoăng|g
薮=tẩu|g
薰=huân/hun|v
薶=mai|y
薷=nhu|x
薹=đài|n
藂=tùng|yg
藓=tiển|n
藜=lê|g
藷=thự|zg
藿=hoắc|n
蘅=hành|x
蘘=nhương|n
蘤=hoa|zg
蘧=cừ|x
蘩=phiền|g
蘸=chấm/trám|v
虏=bắt/bắt làm nô lệ|ng
虑=lo|vg
虖=hô|zg
虙=mật|zg
虢=quắc/Quắc|nr
虫=trùng|n
虮=kỷ|g
虱=rận/sắt|n
虺=hủy|x
虻=manh|g
虼=khát|x
虾=tôm/hà|n
虿=sái|g
蚂=mã|n
蚋=nhuế|g
蚍=tỳ|i
蚓=dẫn|x
蚖=ngoan|zg
蚜=nha|n
蚝=hào|n
蚣=công|x
蚤=bọ chét/tảo|g
蚧=giới|x
蚨=phù|x
蚪=đẩu|x
蚯=khâu|n
蚰=du|n
蚱=con ve|n
蚴=ấu|g
蚶=ham|n
蚺=trăn|x
蛄=cô|x
蛆=giòi/thư|n
蛇=rắn/xà|n
蛉=linh|x
蛋=trứng/đản|n
蛎=lệ|g
蛐=con dế|n
蛑=mâu|x
蛔=hồi|n
蛘=dạng|g
蛞=khoát|x
蛩=cung|g
蛭=đỉa/điệt|g
蛱=kiệp|x
蛲=nhiêu|n
蛳=si|x
蛴=tề|x
蛸=sao|x
蛹=kén|g
蛾=nga|n
蜃=thận/thận (*con trai)|n
蜇=đốt/triết|v
蜈=ngô|n
蜉=phù|n
蜊=lỵ|x
蜋=lang|zg
蜍=thừ|x
蜒=diên|x
蜓=đình|x
蜗=oa|n
蜘=tri/nhện|n
蜚=phỉ|v
蜜=mật|n
蜞=kỳ|x
蜡=sáp/đèn cầy|n
蜢=châu chấu/mãnh|x
蜥=thằn lằn/rắn mối|n
蜩=điêu|g
蜮=vực|g
蜰=phì|yg
蜱=tỳ|g
蜴=dịch|x
蜻=tinh|n
蜾=quả|n
蝇=ruồi/dăng|ng
蝈=quắc|n
蝌=khoa|n
蝙=biên|n
蝝=duyên|zg
蝠=bức/dơi|x
蝣=du|x
蝤=tù|x
蝥=mâu|x
蝮=phúc/rắn hổ mang|n
蝰=khuê|n
蝲=lạt|n
蝴=hồ|n
蝻=nam|n
蝼=lâu|n
蝽=xuân|g
螂=lang|x
螃=bàng|n
螅=tức|x
螈=nguyên|x
螋=sưu|x
螗=đường|g
螟=minh|n
螨=mãn|g
螫=nọc độc|v
螬=tào|x
螳=đường|n
螵=phiêu|x
螽=chung|x
蟀=xuất|x
蟁=văn|x
蟆=mô|x
蟊=mâu|g
蟋=tất|n
蟑=chương|n
蟕=chủy|zg
蟛=bành|x
蟥=đỉa|x
蟪=huệ|x
蟮=thiện|x
蟺=thiện|y
蠂=châu chấu|y
蠃=lỏa|x
蠊=liêm|x
蠍=hiết|ng
蠓=mông|n
蠖=oách|x
蠛=miệt|x
蠨=tiêu|yg
蠭=phong|y
蠹=mọt/con mọt|n
蠼=quặc|x
血=máu/huyết|n
衄=nục|g
衋=hực|y
衒=huyễn|yg
衔=ngậm/hàm/liên tiếp|v
衕=đồng|y
衙=nha|n
衫=áo|ng
衮=cổn|g
衲=nạp|g
衺=tà|y
衿=khâm|g
袁=viên|nr
袂=tay áo/mệ|ng
袄=áo|g
袅=niểu|z
袈=ca|n
袠=trật|zg
袢=phán|v
袤=mậu|g
被=bị/được/chăn|p
袭=tập/tập (kích)|v
袯=tơi nón|x
袱=phục|g
袵=nhẫm|zg
袷=giáp|x
袺=kết|y
袼=cách|x
裆=háng/đang/đũng quần|n
裉=khẳng|g
裒=bầu|g
裔=duệ|nr
裘=cầu/áo lông|nr
裟=sa|x
裢=hầu bao|x
裣=liêm|x
裥=cán|n
裨=tì/bì|n
裰=chuyết|g
裱=phiếu|v
裳=váy/Thường|ng
裴=bùi|nr
裹=khỏa|v
裼=tích|g
褉=hạt|zg
褊=biển|ag
褎=tụ|y
褙=bối|g
褚=chử/Chử|nr
褛=lũ|x
褡=đáp|n
褦=nại|x
褧=quýnh|yg
褪=cởi|v
褰=khiên|g
褴=rách tả tơi|z
褵=ly|g
襁=cưỡng|x
襃=bao|zg
襆=bộc|zg
襍=tập|yg
襞=bích|g
襟=vạt áo|n
襦=nhu|g
襻=phán|v
要=muốn/yếu/phải/quan trọng/nếu/sắp|v
覃=đàm|nr
覉=ki|yg
覻=thứ|zg
见=thấy/gặp/kiến/xem|v
觇=siêm|g
觉=cảm giác/giấc|v
觊=mong muốn|v
觋=hích|g
觌=địch|g
觎=du|x
觏=cấu|vg
觑=dò xét/nhìn trộm|v
觚=cô|ng
觞=thương/chén|v
解=giải/hiểu/am hiểu/mổ|v
觯=chí|g
觳=hộc|x
訇=oanh/hoanh|x
訾=tí|nr
詈=lỵ|g
詖=bí|x
詟=triệp|yg
詹=chiêm|nr
誖=bội|yg
諔=xúc|y
謇=kiển|g
謡=dao|zg
謦=khánh|x
謯=trớ|zg
謷=ngao|y
譈=đỗi|yg
譛=trấm|y
譬=thí|v
讙=hoan|zg
讟=độc|zg
讣=phó|n
讦=kiết|g
讧=hồng|g
讨=lấy/đòi|v
让=để/nhường/bảo|v
讪=ngượng/ngượng ngập|v
讫=cật|g
讯=tin tức/nhanh/tin|ng
讴=âu|v
讵=cự|d
讶=quái lạ|v
讼=tụng|vg
访=thăm/tìm hiểu|v
诂=cổ|g
诃=ha|g
诅=rủa/trớ|v
识=biết/thức|v
诌=sưu|vg
词=từ|n
诒=di|g
诓=lừa gạt/gạt/lừa|v
诖=quái|g
诗=thơ/thi|n
诘=cật|v
诙=khôi|vg
诛=tru/giết|v
诜=sân|x
话=lời nói/nói|n
诠=thuyên|v
诣=nghệ|v
诤=tránh|vg
该=nên/cai/cái kia|r
诧=sá/kinh ngạc|a
诩=hủ|g
诮=tiếu|g
诲=hối|vg
说=nói/thuyết|v
诶=ài/ấy/ôi chao|e
请=mời/xin/thỉnh/xin mời|v
诼=trác|g
诽=phỉ|v
课=khóa|n
诿=ủy|vg
谀=du|g
谁=ai/người đó/người nào/thùy/đó/kẻ đó|r
谂=thẩm|g
谄=siểm/nịnh|v
谅=lượng|v
谇=tối|g
谊=nghị|ng
谌=kham|nr
谍=điệp|n
谏=gián|vg
谑=hước|g
谒=yết|vg
谔=ngạc|x
谖=huyên|g
谘=ti|g
谚=ngạn|n
谜=mê/câu đố|n
谝=biển|g
谟=mô|g
谠=đảng|g
谡=tắc|g
谧=mật|g
谫=tiễn|g
谮=trấm|g
谯=tiêu/tiếu|nr
谰=lan|n
谳=nghiện|g
谵=chiêm|n
谶=sấm|n
豆=đậu|n
豌=oản|n
豚=đồn|n
豢=nuôi|vg
豨=hi|n
豮=phần|y
豳=bân|g
豸=trĩ|g
豻=ngan|yg
貂=chồn/điêu|n
貅=hưu|x
貆=hoan|zg
貉=con chồn|ng
貊=mạch|g
貔=tỳ|n
貘=heo vòi|g
貙=sơ|zg
貭=chất|zg
賵=phúng|zg
贋=nhạn|yg
贔=bí|x
贠=viên|zg
财=tài|n
账=sổ sách/món nợ|n
货=hàng/hóa|n
贬=biếm/giáng chức/cách chức|v
贮=trữ|v
贰=nhị|m
贶=huống|g
贼=tặc/trộm/kẻ trộm|n
贽=chí|g
贾=giả/cổ|nr
赀=ti|g
赁=nhẫm|v
赂=lộ|ng
赅=cai|vg
赆=tẫn|g
赊=nợ/xa|v
赍=tê|g
赐=ban thưởng/ban cho/thưởng|v
赒=chu|yg
赓=canh|nr
赔=bồi|v
赙=phụ|vg
赚=kiếm/lừa/kiếm lời/lợi nhuận|v
赜=trách|g
赠=tặng|v
赡=thiệm|vg
赢=thắng/doanh|v
赬=xanh|yg
赭=giả|n
赳=củ|x
赴=phó|v
赵=triệu/Triệu|nr
起=lên/khởi/dậy/cái|v
赸=sán|zg
趄=nghiêng|v
超=siêu/cực kỳ/Chao|v
趑=tư|v
趔=liệt|v
趱=toản|g
趸=độn|vg
趺=phu|g
趼=nghiễn|g
趿=mang|v
跄=loạng choạng|x
跅=thác|y
跆=đài|n
跎=đà|x
跏=già|x
跑=chạy/bào|v
跔=câu|y
跖=chích|g
跗=phụ|n
跚=san|x
跞=lịch|x
跣=tiển|g
跤=giao|ng
跧=thuyên|y
跪=quỳ/quỵ|v
跫=cung|x
跬=khuể|g
跮=sí|zg
跳=nhảy/khiêu/đập|v
跸=tất|g
跹=tiên|x
跺=đập mạnh/giẫm|v
跻=tễ|v
跽=kỵ|g
踅=tuyệt|v
踊=dũng|ad
踌=trù|v
踏=đạp|v
踔=trác|g
踝=mắt cá chân/mắt cá|n
踞=ngồi/cứ|vg
踟=trì|v
踢=đá/thích|v
踣=té ngã|g
踬=chí|vg
踮=điểm/nhón chân|v
踯=trịch|v
踱=bước đi thong thả|v
踵=chủng|g
踹=đạp/đoán/đuổi|v
踺=kiện|n
蹂=chà đạp|v
蹈=đạo|vg
蹉=tha|v
蹊=hề|a
蹋=đạp|v
蹒=bàn|v
蹙=nhàu|vg
蹦=nhảy|v
蹩=biệt|a
蹬=đạp/đặng|v
蹭=cọ/chà xát/đi từ từ/chùi/sượt|v
蹯=phiền|g
蹰=trù|x
蹲=ngồi xổm/ngồi chồm hổm/tồn|v
蹴=xúc|g
蹶=quyết|g
蹼=màng|n
蹿=nhảy lên|v
躃=tích|y
躅=trục|x
躇=trừ|x
躏=lận|x
躐=liệp|g
躔=triền|g
躜=toàn|g
躧=sỉ|zg
躩=khước|yg
躲=tránh/trốn/đóa|v
躺=nằm/thảng|v
軆=thể|zg
軏=nguyệt|yg
軨=linh|zg
輀=nhi|y
輈=chu|yg
輋=xa|zg
輘=lăng|x
輙=triếp|yg
轫=nhận|g
转=chuyển|v
轭=ách|g
轱=cô|n
轲=kha|x
轳=lô|x
轵=chỉ|g
轶=dật|n
轸=chẩn|g
轺=diêu|g
轼=thức|g
轾=chí|x
辀=chu|zg
辂=lộ|g
辇=liễn/xe kéo|g
辈=bối|n
辊=cổn|n
辋=võng|g
辌=lương|zg
辎=truy|n
辏=thấu|ng
辗=triển|v
辙=triệt|n
辚=lân|x
辞=từ|v
辟=tích|v
辡=biện|zg
辰=thần/Thìn|ng
达=đạt|v
辿=siêm|x
迁=dời/thiên|v
迍=truân|zg
迎=nghênh|v
迓=nhạ|g
返=trở lại/phản|v
迕=ngỗ|g
这=cái này/giá/này/vậy/đây|r
进=tiến/vào/tiến vào|v
迢=điều|z
迨=đãi|g
迩=nhĩ|g
迮=trách|nr
述=thuật|vg
追=truy/đuổi/theo đuổi|v
退=lui/thoái/thối/lùi|v
送=đưa/tặng/tiễn/tiễn đưa/tống|v
逃=trốn/đào|v
逅=cấu|x
逈=huýnh|y
透=thấu|v
逑=cầu|g
递=đưa/lần lượt|v
逖=địch|g
逗=đùa/đậu/trêu chọc/buồn cười/đậu|v
逛=đi dạo/cuống|v
造=tạo|v
逦=lệ|x
逭=hoán|vg
逯=lục|nr
逵=quỳ|g
逶=uy|z
逼=bức/ép|v
逾=hơn/vượt qua|vg
遄=thuyên|g
遆=đề|yg
遇=gặp/ngộ|v
遘=cấu|g
遛=lưu/dắt|v
遢=tháp|x
遮=che/chận|v
遴=lân|v
遹=duật|yg
避=tránh|v
邀=mời/yêu cầu/yêu|v
邃=thúy|ag
邑=ấp|ng
邓=đặng|nr
邝=quảng|nr
邡=phương|g
邢=hình|nr
那=kia/cái kia/vậy/cái nào/đâu/nào/đó|r
邦=bang|ng
邬=ô/ổ|nr
邯=hàm|ns
邰=thai/Thai|nr
邱=khâu|nr
邴=bỉnh|nr
邵=Thiệu|nr
邶=bội|g
邸=để/đệ|nr
邺=nghiệp|g
邾=chu|g
郅=chất|g
郇=tuân|nr
郏=giáp|nr
郐=cối|g
郛=phu|g
郜=cốc|nr
郝=hách|nr
郡=quận|n
郢=dĩnh|g
郦=ly|nr
郧=vân|g
郩=hào|zg
郫=bì|ns
郭=quách/Quách|nr
郸=đan|ns
都=đều/cũng/đô/thủ đô|d
郾=yển|g
鄄=quyên|g
鄋=sưu|y
鄗=hạo|yg
鄢=yên|nr
鄣=chướng|g
鄱=bà|ns
鄹=châu|g
酃=linh|g
酆=phong|nr
酎=trữu|g
酐=can|g
酒=rượu/tửu|n
酗=hú|v
酝=ủ|v
酡=đà|vg
酢=tạc|g
酤=cô|g
酩=mính|i
酮=đồng|g
酯=chỉ|ng
酲=trình|g
酴=đồ|g
酵=diếu|n
酶=môi|n
酹=lỗi|vg
酺=bô|zg
酽=nghiệm|a
酾=si|vg
醁=lục|zg
醆=trản|y
醇=thuần|ag
醊=chuyết|zg
醋=dấm/dấm chua/thố|n
醑=tữ|g
醒=tỉnh|v
醚=ê-te|n
醡=trá|zg
醢=hải|g
醪=lao|n
醮=tiếu|g
醯=dấm/ê|g
醱=bát|yg
醵=cự|g
醺=say/say rượu|g
釄=mi|zg
采=hái/khai thác/ngắt/thải|v
釉=men/men (gốm, sứ)|n
量=lượng/đo|n
釽=tịch|yg
鉅=cự|g
鉏=sừ|yg
銎=khung|g
銶=cầu|yg
鋆=vân|zg
鋈=ốc|g
鋭=duệ|y
錡=kỹ|yg
錾=tạm|v
鍑=phúc|zg
鍪=mâu|x
鍱=diệp|zg
鏊=ngao|n
鏕=ao|zg
鏖=ao|v
鏣=tên dụng cụ|zg
鐏=tỗn|zg
鑞=lạp|zg
鑢=lự|x
鑪=lô|zg
鑫=Hâm|nr
鑴=huề|y
钆=ca|g
钇=ất|g
钊=chiêu|g
钋=polonium|ng
钍=thổ|ng
钏=xuyến|nr
钐=cắt|g
钒=phàm|n
钕=nữ|g
钗=trâm/sai/thoa cài tóc/trâm (cài tóc)|ng
钙=canxi|n
钚=Plutonium/bất|n
钜=cự|g
钠=Natri|n
钡=bối|n
钣=bản|g
钤=kiềm|vg
钨=vonfram/ô/|n
钪=cang|g
钫=phương|g
钬=hoả|ng
钭=thẩu|nr
钯=ba|g
钰=ngọc|g
钲=chinh|g
钴=cỗ|ng
钷=phả|g
钹=chũm chọe/cái nón úp|n
钺=việt|ng
钽=đán|ng
钾=kali/giáp (Ka)|n
钿=điền|g
铀=Uranium/Urani|n
铂=bạch kim|n
铅=chì|n
铈=thị|n
铉=huyễn|g
铊=tha|g
铋=bí|g
铌=ni|ng
铍=phi|g
铎=đạc|nr
铐=còng tay|v
铑=lão|g
铒=nhĩ|g
铖=thành|g
铗=kiệp|g
铘=gia|zg
铛=keng/đang|o
铜=đồng|n
铝=nhôm|n
铞=điếu|x
铟=nhân|n
铠=khải|n
铡=trát/trảm|v
铤=đĩnh|i
铨=thuyên|g
铩=sát|g
铪=ha/cáp|g
铫=diêu|g
铬=crôm|n
铯=sắc|g
铰=giảo|v
铳=súng|ng
铷=như|g
铻=ngữ|zg
铼=lai|g
铽=thác|g
锁=khóa/tỏa|v
锃=sáng loáng|z
锅=nồi/oa|n
锇=nga|g
锌=kẽm|n
锎=khai|g
锏=giản|g
锑=đễ|ng
锓=tẩm|g
锔=cư|g
锕=a|g
锖=thương|x
锗=Germanium|n
锘=nặc|g
锛=bôn|v
锝=đắc|g
锞=quả|g
锟=côn|g
锢=cố|g
锣=la/cái chiêng|n
锧=chất|zg
锨=hân/xẻng|n
锩=quyển|v
锫=bầu|g
锬=đàm|g
锭=thỏi/đĩnh|q
锰=mangan|n
锲=khiết|i
锴=khải|g
锵=bang/thương/cheng/keng/BOANG...|o
锶=tư|ng
锷=ngạc|g
锸=tráp|n
锹=cái xẻng/thiêu|n
锾=hoàn|q
镁=Magiê|n
镄=phí|g
镅=Americium|g
镆=mạc|x
镉=Cadmium Cd|n
镍=niken|n
镏=lưu|n
镒=dật|q
镓=gia|g
镔=tấn|n
镕=dung|zg
镖=tiêu|n
镘=man|g
镚=băng|x
镛=dung|g
镝=đích|g
镞=thốc|ng
镡=đốc kiếm|nr
镢=quắc|n
镣=xích chân|n
镤=mộc|g
镥=lỗ|g
镦=đối|g
镧=lan|n
镨=phổ|g
镩=thoản|g
镫=đăng|g
镭=Radium|n
镯=vòng tay|n
镱=ý|g
镲=sát|n
镳=tiêu|g
镶=khảm/nạm|v
閛=phanh|zg
閦=súc|yg
閺=văn|y
闘=đấu|y
闚=khuy|y
闫=diêm/Diêm|nr
闭=bế/đóng/nhắm|v
闱=vi|g
闵=mẫn|nr
闶=khang|x
闹=náo|v
闺=khuê/khuê phòng|n
闼=thát|g
闾=lư|nr
阀=phiệt|n
阂=ngại|vg
阃=khổn|g
阄=cưu/cái thăm|ng
阇=đồ|n
阈=quắc|n
阊=xương|x
阋=huých|g
阌=văn|g
阍=hôn|ng
阏=át|x
阒=khuých|g
阕=khuyết|q
阚=hám|nr
阛=hoàn|zg
阜=phụ|ns
阢=ngột|x
阨=ách|yg
阪=dốc núi|ns
阮=nguyễn|nr
阱=tịnh|g
阼=tộ|g
阽=diêm|g
陈=trần|nr
陉=hình|g
限=hạn|v
陔=cai|g
陛=bệ|n
院=viện/sân|n
除=trừ|p
陧=niết|x
险=hiểm|a
陬=tưu|g
陲=thùy|g
陴=bì|g
陷=hãm/vùi lấp|v
陼=chử|zg
隅=góc|ng
隈=ôi|g
隍=hoàng|g
隖=ổ|yg
隗=ngỗi|nr
隙=khe hở|ng
隞=ngao|zg
隟=khích|zg
隤=đồi|y
隩=áo|x
隰=thấp|g
隲=chất|zg
隳=huy|g
隹=chuy|g
隼=chuẩn/chim cắt/lỗ/Chim Cắt|g
雉=trĩ|ng
雎=sư|g
雒=lạc|nr
雘=hoạch|zg
雠=thù|g
雨=mưa/vũ|n
雩=vu|g
雯=văn|nr
雹=bạc|ng
雾=sương mù/vụ|n
霁=tễ/nguôi|vg
霅=tráp|yg
霆=đình|g
震=chấn|v
霈=bái|g
霓=nghê|n
霖=lâm|nr
霙=anh|zg
霜=sương|n
霨=uý|y
霭=ai/sương|ng
霰=tản|n
霱=duật|zg
霹=sấm sét|n
霾=mai|g
靠=dựa vào/sát lại/kháo/cập/dựa vào|v
靡=mị|vg
靥=má lúm đồng tiền/lúm đồng tiền|g
靬=kiền|zg
靮=đích|yg
靳=cận|nr
靼=đát|x
鞅=ưởng|x
鞋=giày|n
鞒=kiều|g
鞡=lạp|zg
鞣=thuộc da|v
鞫=cúc|g
鞬=kiện|zg
鞯=tiên|x
鞲=câu|x
鞴=bị|x
鞾=ngoa|x
韂=xiếm|zg
韔=sướng|yg
韘=thiếp|zg
韪=vĩ|x
韫=uẩn|g
韭=hẹ/cửu|n
韮=phỉ|yg
音=âm|n
韵=vận|n
頫=phủ|y
顑=khảm|zg
顼=húc|g
颀=kỳ|z
颃=hàng|x
颇=có phần/khá|d
颉=hiệt|nr
颊=gò má|ng
颌=quai hàm|n
颏=hài|ng
颖=dĩnh|nr
颚=hàm|n
颞=nhiếp|n
颟=man|a
颡=tảng|g
颢=hạo/run|g
颣=loại|zg
颦=tần/nhăn mày|g
颧=quyền|n
飂=liêu|yg
飃=phiêu|y
飑=tiêu/đua|g
飒=táp|z
飓=cụ|n
飕=sưu/vù/vèo|o
飘=phiêu/tung bay/thổi/nhẹ nhàng|v
飜=phiên|zg
飧=sôn|g
飨=hưởng|vg
餈=tư|yg
餍=yếm|g
餮=thiết|x
餹=đường|x
饎=sí|zg
饔=ung|g
饦=thác|n
饧=đường|v
饨=đồn|x
饩=hí|g
饪=nhẫm|g
饫=ứ|g
饬=sức|g
饭=cơm/phạn|n
饴=di|n
饼=bánh/bính|n
饽=bánh ngọt điểm tâm|n
饿=đói/ngạ/đói bụng|v
馀=dư|g
馁=nỗi|vg
馄=hồn|n
馇=tra|x
馊=thiu|a
馋=thèm/tham|a
馐=tu|g
馑=cận|x
馒=man|n
馓=tản|ng
馔=soạn|g
馕=hướng|g
馗=quỳ|g
馘=quắc|g
馞=nồng đượm|y
駞=đà|zg
駻=hãn|zg
騑=phi|zg
驘=loa|y
驩=hoan|yg
驮=cõng/đà|v
驴=con lừa/lừa|n
驵=tảng|g
驸=phụ|n
驹=câu|ng
驺=sô|g
骀=đài|x
骂=mắng/chửi/mạ|v
骅=hoa|nr
骈=biền|n
骍=tuynh|y
骐=kỳ|g
骓=chuy|g
骔=tông|zg
骖=tham/ngựa kéo|v
骘=chất|g
骛=theo đuổi|g
骜=ngao|g
骝=lưu|g
骞=khiên|g
骟=phiến|v
骢=thông|g
骣=sản|g
骧=cất cao|vg
骰=xúc xắc/con xúc xắc|n
骱=giới|g
骶=đế|n
骷=khô|n
骸=xương cốt|n
骺=hậu|x
骼=cách|x
骽=thối|zg
髀=bễ|g
髁=khỏa|g
髂=khá|n
髃=ngung|zg
髅=lâu|x
髋=xương hông|n
髌=bận|n
髐=hiêu|y
髓=tủy|g
髡=khôn|g
髢=thế|zg
髦=mao|g
髫=thiều|g
髯=râu|ng
髴=phất|zg
髹=hưu|g
髻=búi tóc|g
鬄=thế|y
鬇=tranh|x
鬈=quyền|g
鬏=thu|g
鬐=kỳ|zg
鬛=liệp|y
鬟=hoàn|g
鬡=ninh|zg
鬪=đấu|y
鬯=sưởng|g
鬲=cách|ng
鬻=dục|vg
魃=bạt|x
魈=tiêu|x
魉=lượng|x
魑=Si|g
魛=đao|zg
魟=hồng|zg
魭=tra|yg
鮟=an|x
鮿=triếp|zg
鰂=tặc|zg
鱇=khang|zg
鱍=cá quẫy đuôi nhảy|zg
鱬=mặt người thân cá|zg
鱲=liệp|zg
鱻=tiên|y
鱼=cá/ngư|n
鱽=đao|y
鱿=vưu|n
鲀=đồn|zg
鲂=phường|g
鲅=cá thu|ns
鲆=bình|g
鲇=niêm|n
鲈=lư|g
鲋=phụ|g
鲌=cá thiểu|y
鲍=bảo|nr
鲎=hấu|g
鲐=thai|g
鲑=khuê|n
鲔=vị|g
鲚=tễ|g
鲛=giao|g
鲞=tưởng|g
鲟=tầm|g
鲡=ly|x
鲢=liên|n
鲣=kiên|n
鲥=thì|n
鲦=điều|x
鲧=Cổn|g
鲩=cán|g
鲫=tức|n
鲭=chinh|g
鲮=lăng|n
鲯=kỳ|y
鲰=tưu|g
鲱=phi|n
鲲=côn|n
鲳=xương|n
鲴=cố|g
鲵=nghê|g
鲶=niêm|n
鲷=điêu|g
鲺=sắt|g
鲻=tri|g
鲼=phẫn|g
鲽=điệp|g
鳃=mang|n
鳅=thu|x
鳆=phục|x
鳇=hoàng|ng
鳊=biên|n
鳌=ngao|g
鳍=vây cá|n
鳎=tháp|g
鳐=diêu|g
鳒=kiêm|zg
鳓=lặc|g
鳔=phiêu|n
鳕=tuyết|n
鳖=ba ba/rùa/con ba ba|n
鳘=mẫn|g
鳙=dung|n
鳜=quyết|n
鳝=thiện/lươn|n
鳞=vảy/lân|n
鳟=tỗn|n
鳡=cảm|yg
鳢=lễ|g
鳣=chiên|yg
鳸=hỗ|zg
鴈=nhạn|zg
鴒=linh|zg
鴞=hào|yg
鴽=như|zg
鵻=giai|zg
鶊=canh|zg
鶒=xích|y
鶗=đề|zg
鷁=nghịch|zg
鷞=sương|zg
鷰=yến|y
鸀=hắc|zg
鸑=nhạc|x
鸥=âu/hải âu|ng
鸨=bảo|n
鸪=cô|x
鸫=đông|g
鸬=lô|n
鸯=ương|x
鸱=si|g
鸲=cù|g
鸳=uyên|n
鸵=đà|n
鸶=tư|x
鸸=nhi|n
鸹=quát|x
鸺=hưu|x
鸾=loan|nr
鹁=bồ câu nhà|n
鹃=quyên|x
鹄=hộc|ng
鹅=ngỗng/nga/ngan|n
鹆=dục|x
鹇=nhàn|x
鹈=đề|n
鹉=vũ|x
鹊=chim khách/thước|ng
鹌=am|n
鹎=chim tu ti|g
鹏=bằng/Bằng|nr
鹑=chim cút|x
鹔=túc|x
鹕=hồ|x
鹗=ngạc|ng
鹘=cốt|x
鹛=mi|g
鹜=vụ|ng
鹠=lưu|y
鹣=kiêm|g
鹦=anh|n
鹧=chá|n
鹨=lưu|g
鹩=liêu|x
鹪=tiêu|n
鹰=ưng/Ưng|n
鹾=ta|g
麂=kỷ|n
麇=quân|g
麈=chủ|g
麋=nai|n
麒=kỳ|n
麓=lộc|ng
麝=xạ|n
麟=lân|ng
麴=khúc|nr
麸=phu|n
麹=đến nỗi|zg
麽=sao|x
麾=huy|n
黉=huỳnh|g
黍=thử|ng
黓=dặc|zg
黔=kiềm|j
黜=truất|v
黝=đen thui|z
黡=yểm|zg
黢=xuất|ag
黤=yểm|zg
黥=kình|g
黧=lê|z
黩=độc|v
黮=thảm|x
黹=chỉ|g
黻=phất|g
黼=phủ|g
黾=mãnh|x
鼄=chu|zg
鼅=tri|x
鼍=đà|g
鼐=nãi|g
鼑=đỉnh|zg
鼒=tỷ|x
鼗=đào|g
鼙=bề|x
鼚=xương|y
鼪=sinh|yg
鼬=chồn sóc/Itachi|n
鼯=ngô|n
齆=úng|zg
齎=tê|g
齞=nhe răng|yg
齿=răng|n
龀=sấn|g
龃=trở|n
龅=bao|n
龆=điều|g
龈=ngân|g
龉=ngữ|x
龊=bẩn thỉu|x
龌=ác|a
龚=cung|nr
龛=bàn thờ|ng
龠=dược|g
