小骚蹄子=tiểu tao hóa/con đ*ĩ nhỏ
圣母婊=thánh mẫu đĩ/Đức Mẹ/chó cái thần thánh
好满足=thật thỏa mãn
好湿啊=thật ẩm ướt
好好闻=thật dễ ngửi
泥泞蜜穴=lầy lội mật huyệt
大眼睛=mắt to
蚌口=sò khẩu/bạng khẩu
自己的花蕊=chính mình nhị hoa
爱爱=ân ái
纤细盈盈=tinh tế mềm mại
作践我=chà đạp ta/sỉ nhục ta
挺翘=cao vểnh
浑圆挺翘=tròn trịa vểnh
翘臀=vểnh mông
贴身丝袜=tất chân bó sát
泄完精=xuất tinh xong
肥臀=mông bự/mông lớn
前戏=màn dạo đầu
啪啪啪=bạch bạch bạch~/ba ba ba/pa pa pa
呀呀呀=ah ah ah
淫词浪语=dâm từ lãng ngữ
好骚=thật tao/thật dâm
下嘴唇=miệng môi dưới/môi dưới/bờ môi/bờ môi
腟腔=hốc âm đạo
小逼=tiểu bức/lồn nhỏ
肉逼=thịt bức/thịt lồn
骚屄=tao bi/dâm lồn/lồn lẳng lơ
诱人极=cực độ mê người
浪屄=đãng bi/lãng bi/sóng bi
浪言=phóng túng nói
遭不住=không chịu nổi
她的屁股眼=lỗ đít nàng/lỗ nhị của nàng
被罩杯=cúp áo vú
拧出水=vắt ra nước
那应该=vậy có lẽ
可以当=có thể làm/có thể coi là
一想象=tưởng tượng một chút
这么一想象=vừa tưởng tượng như vậy
控制不住=khống chế không được
时,=thời điểm
叹了口气=thở dài
伴随着=cùng với
黑着脸=đen mặt
美母=mỹ mẫu
小师妹=tiểu sư muội
正在看=đang nhìn
在一起=cùng một nơi
她的=nàng/của nàng
刺激不刺激=kích thích hay không
地下车库=hầm để xe
隐隐记=mơ hồ nhớ
风情万种地=phong tình vạn chủng
挑着眉角=nhướng mày
翻了个白眼=liếc mắt/trợn mắt/lật rồi cái bạch nhãn
得了便宜=được tiện nghi
什么时候=lúc nào
不能人=người không thể
咯!=rồi!
一开始=ban đầu
还会不会=sẽ còn hay không
生活滋润=sinh hoạt thỏa mái
说道最后=nói đến sau cùng
修长的双腿=đôi chân thon dài
开玩笑道=đùa giỡn nói
那我=vậy ta
直视着=nhìn thẳng
意识到=ý thức được
最终还=cuối cùng vẫn
似笑非笑地=như cười như không
以为你=cho là ngươi/tưởng rằng ngươi
淡笑着=cười nhạt
还了=trả
起来,=lên,
这个游戏=trò chơi này
上大一=học năm nhất
比较菜=tương đối dở/tương đối gà
你可知道=ngươi cũng biết
妈妈的=ma ma
今天过得咋样=ngày hôm nay thế nào
过了不久=không qua bao lâu/không lâu sau đó
怎么看我的=thấy ta thế nào
皱了皱眉头=khẽ nhíu mày
妈妈心理=tâm lý ma ma
这种情况=tình huống loại này
这么严重=nghiêm trọng như vậy
这条路=con đường này
吃了下去=ăn tiếp
很了解=hiểu rất rõ
这个小区=cái tiểu khu này
过门之后=sau khi qua cửa
他脚步=bước chân hắn
高墙间=giữa tường cao
里面请=mời vào trong
被称为=được gọi là
他面容=khuôn mặt hắn
瞳孔深处=sâu trong con ngươi
炯炯神采=thần thái lấp lánh
灰烬下=dưới tro tàn
未熄的暗火=ám hỏa chưa tắt
老人的身后=phía sau lão nhân
他身边=bên người hắn
微微行了一礼=hơi hơi thi lễ
此间的主人=chủ nhân nơi này
一把老骨头=một nắm xương già
何出此言=nói vậy là sao
手掌一摊=bàn tay mở ra
过了一会=một lát sau
抬了抬手=giơ tay lên
拱了拱手=chắp tay
还请=kính xin/còn mời
自己爹=cha mình
要小心=phải cẩn thận
烟杆子=tẩu thuốc
要亮=sắp sáng
自己的脑袋=đầu mình
而下一秒=mà một giây sau
下一秒=một giây sau
这一天=một ngày này
娶不起=không cưới nổi
升起,=mọc lên,
逐渐醒=dần dần tỉnh
揉着眼睛=dụi mắt
支起身子=nâng người lên
极远处=nơi cực xa
缩出来=rút ra
现成的=có sẵn
辅食=phụ thực
没过一会=không lâu sau
死人的=chết người đấy
没有毒=không có độc
洗好的=rửa xong
篝火旁=bên đống lửa
已经被=đã bị
懂事的=hiểu chuyện/có hiểu biết
不断地=không ngừng
一小节一小节=từng tiết từng tiết
白师姐=Bạch sư tỷ
熟得快=chín nhanh
野菜面=rau dại mì
吃了起来=bắt đầu ăn
做自己=tự làm
呲溜=Soạt
白姑娘=Bạch cô nương
小道爷=tiểu Đạo gia
没有错=không sai
走岔=đi lạc
碰头后=sau khi chạm mặt
这么长时间=thời gian dài như vậy
这些人=những người này
会不会=có thể hay không
当天晚上=buổi tối hôm đó
你鞋子=giày ngươi
的,=đâu,
披着衣服=khoác lên y phục
苦涩地抱怨=đau khổ oán giận
说完间=đang lúc nói xong
那声音=thanh âm kia
在靠近=đang tới gần
什么东西=thứ gì
看了一眼=nhìn thoáng qua
把手抽了出来=rút tay ra
应当没什么=hẳn là không có gì
就这么=cứ như vậy
跟了上去=đi theo
你喂=ngươi đút
强忍着=cố nén
去了弄清=đi làm rõ
暖了暖胃=làm ấm dạ dày
没有必要=không cần phải
应该的应该的=nên làm nên làm
哪里的话=lời nói ở đâu
这些小事=những việc nhỏ này
没什么大事=không có chuyện lớn gì
吃过人=ăn thịt người
不断迎合=không ngừng đón ý nói hùa
他一旁的=bên cạnh hắn
没必要=không cần phải
走不走=đi hay không
皇城以北=phía bắc hoàng thành
不死林=rừng Bất Tử
若换做=nếu đổi lại
一寸土地=một tấc đất
找到了=đã tìm được
直起身体=thẳng người lên
可爱之极=vô cùng đáng yêu
这些念头=những suy nghĩ này
明显的=lộ rõ
外在缺陷=khiếm khuyết bên ngoài
累累的花朵=chùm chùm những đóa hoa
对对对=đúng đúng đúng
一行人=một đoàn người
之前的模样=bộ dáng trước đó
山下小镇=tiểu trấn dưới núi
这山下小镇=tiểu trấn dưới núi này
赶集日=ngày họp chợ
唯一的区别=khác biệt duy nhất
那就是=đó chính là
凑了过去=tiến lại gần
高举手=giơ cao tay
座无虚座=không có chỗ ngồi
都在=đều đang
在专心=đang chuyên tâm
是不要=đừng là
您里面请=mời ngài vào trong
这么吃=ăn như vậy
刚开始的时候=lúc mới bắt đầu
别的什么人=người nào khác
站了起来,=rồi đứng dậy,
跟下去=đi theo
吸上了一口=hút vào một hơi
美美地=mỹ mãn/ngon lành là
就算了=coi như xong/bỏ đi/không tính
最喜欢=thích nhất
那样子=bộ dạng kia
丧良心=mất lương tâm
由你=tuỳ ngươi
好热闹=thật náo nhiệt
略思忖=thoáng suy nghĩ
给她赔不是=nhận lỗi với nàng
缓了缓=hòa hoãn
要因一时之气=nhất thời tức giận
你很好=ngươi được lắm
给你气受=làm ngươi tức giận
什麽=cái gì
好喜欢你=thật thích ngươi
後背=sau lưng
在嘀咕着=đang thầm thì
小情侣=tình nhân nhỏ
大学新生=tân sinh viên
像在=giống như đang
心跳加速=nhịp tim tăng nhanh
一见=vừa thấy/vừa thấy
还没睡=vẫn chưa ngủ
好会=thật biết
两只眼睛=hai mắt
睁得圆圆=mở tròn xoe
正朝着=hướng thẳng về
不要看=đừng nhìn/không được nhìn
裸的身体=khoả thân cơ thể
不要走=đừng đi
你的身体=thân thể ngươi
舒了一口气=thở phào một hơi/thở phào nhẹ nhõm
重要的=quan trọng
羞涩涩=xấu hổ
棵大树前=trước gốc cây lớn
一棵大树前=trước một cái cây lớn
特别的=đặc biệt
娇嗔道=hờn dỗi nói
我自己=ta tự mình
长的这么漂亮=lớn lên xinh đẹp như vậy
好不好嘛=được không
能不能=có thể hay không
好舒服=thật dễ chịu
不行吗=không được sao
这女人=nữ nhân này
当一条=làm một
哀求着=van cầu
好一个=hay cho một cái
做不做=làm hay không
断魂散=Đoạn hồn tán
好不热闹=vô cùng náo nhiệt
刚留头=mới để tóc
六小姐=Lục tiểu thư
二奶奶=Nhị nãi nãi
这么好的一个人=một người tốt như vậy
嘴上不把门=không biết giữ mồm miệng
小蹄子=con ranh/tiểu đề tử
一跛=khập khiễng
倒了热水=rót nước nóng
绞了帕子=vắt khăn
这些日子=những ngày này
绞了=vắt
尤自不知=không hề hay biết
留海=lưu hải/tóc mái
涩涩=chua chát
舍你其谁=ngoài ngươi còn ai
我起来=ta dậy
歪了下去=nghiêng xuống
倒下去=ngã xuống/đổ xuống
重生了=trùng sinh
厉声道=quát khẽ
有救了=được cứu rồi
哑声道=khàn tiếng nói
打了个寒颤=rùng mình một cái
小丫鬟=tiểu nha hoàn
而已了=mà thôi
弯着背=khom lưng
太医院=Thái y viện
忡怔=sững sờ
世医之家=thế y chi gia/đời đời hành y
记住了没有=nhớ rõ chưa
已牵记=đã nhớ kỹ
感叹道=cảm thán
冷静道=lạnh lùng nói
微波闪过=loé lên tia sáng
二小姐=Nhị tiểu thư
痛极反笑=đau đớn tới bật cười
交好的=giao hảo
谏死=lấy chết can gián
最是懂得=hiểu rõ nhất
小龄=Tiểu Linh
各位的支持=sự ủng hộ của các vị
自己的母亲=mẫu thân của mình
给我把剑放下=buông kiếm xuống cho ta
夏季天亮的早=sáng sớm mùa hạ
正卖力=đang ra sức
忠心为主=trung tâm vì chủ
数几代人=nhiều thế hệ
上数几代人=qua mấy thế hệ/qua nhiều đời
年纪最大=lớn tuổi nhất
三口之家=gia đình 3 người
前几年=mấy năm trước
其他孩子=đứa bé khác
别人家的孩子=con nhà người ta
闷蛋=người buồn chán
缠绵不止=triền miên không ngừng
膣道=âm đạo
尤其对于=đặc biệt đối với
不可言说的=không thể nói ra
这之前=trước đây
从没有过=chưa từng có
如此经历=trải nghiệm như vậy
才对=mới đúng
见她=thấy nàng/gặp nàng
房门前=trước cửa phòng
受不住=chịu không được
美字=mỹ tự
肉穴口=miệng lỗ thịt/nhục huyệt khẩu|n
丁香小舌=lưỡi nhỏ đinh hương
撞击着=va đập
角色颠倒=vai trò đảo lộn
乖徒儿=đồ nhi ngoan
听明白=nghe rõ
明白了=minh bạch rồi/hiểu rồi
是,=vâng,
可舍不得=thật không nỡ
不可赦=không thể tha thứ
设的套=sắp bẫy/đặt bẫy
嗯了一声=thở ra một hơi
目光侧了侧=ánh mắt nghiêng sang một bên
闪过了=chợt hiện lên
包裹的=bao khoả/bao bọc lấy
修长的腿=thon dài chân
冷着脸=lạnh mặt
站在原地=đứng nguyên tại chỗ
斟酌了几秒=cân nhắc vài giây
可否告知=có thể chỉ giáo
就这样=chỉ như vậy
别人眼=mắt người khác
打不过=đánh không được
就跑=liền chạy/bỏ chạy/chỉ chạy
可是当=thế nhưng khi
接下来一路=một đường tiếp theo
坐忘道=Tọa Vong Đạo
一次听到=lần đầu nghe tới
一般.=một dạng.
一般,=một dạng,
年逾=tuổi ngoài
话音一落=lời nói vừa dứt
对,=đúng,
富有弹性=đầy đàn hồi
给我滚下来=cút xuống cho ta
要塞进去=muốn nhét vào
关我什么=liên quan gì đến ta
行了一礼=thi lễ một cái
这间屋子=căn phòng này
这些年=những năm này
全天下=toàn thiên hạ
灵感型的=thiên về cảm hứng
万法傍身=vạn pháp hộ thân
一击=một kích
一击毙命=một kích chí mạng
啸个=rít gào
某一刻=một khắc nào đó
覆灭之日=ngày diệt vong
仅剩一气=chỉ còn thoi thóp một hơi
声低了些=thanh âm nhỏ đi chút
张大了嘴巴=há to miệng
缓慢地=chậm rãi
云巅=Vân Đỉnh
剑刃=lưỡi kiếm
一迈入=vừa bước vào
须臾间=trong khoảnh khắc
负手=chắp tay sau lưng
待我=đối đãi ta
不成?=hay sao?
淡蹙着眉=khẽ nhíu mày
眼看地=nhìn đất
使不上劲=không còn sức lực
小伎俩=tiểu xảo/mánh khoé nhỏ|n
迟疑间=trong lúc do dự
转过了身=quay người lại
在了原地=tại chỗ
垂地=rủ xuống đất
真气=chân khí|n
中了计=trúng kế
淌下=chảy xuống|v
要死了=sắp chết rồi
一跃=nhảy lên
飞星=sao băng
云空=Vân Không
云空山=Vân Không sơn
在里面=ở trong
点了点头=gật đầu nhẹ
没什么用=không có tác dụng
看起來=thoạt nhìn
曦园=Hi Viên
生的凑合=sống tạm bợ/sống qua ngày
难得的稀世=hiếm có khó tìm|i
鲜嫩鲜嫩=mềm mại mịn màng|a
女下男上=nữ dưới nam trên
掐准=bấm chuẩn
捣入=đâm vào/đảo nhập|v
插将=ra sức cắm|v
虚张着=khẽ hé mở|l
一声又一声=từng tiếng|l
微微低=khẽ hạ thấp/hơi cúi xuống|l
撅起=nhếch lên/vểnh lên|v
浅磨深插=cọ xát nông sâu|l
不自觉的颤抖=run rẩy không tự chủ|l
极度亢奋=phấn khích cực độ|l
倒抽连连=rút ra thụt vào liên hồi|l
一阵连响=một trận liền vang/một loạt âm vang|l
爽快的的=sảng khoái tột độ|l
倒吸着凉气=hít khí lạnh|l
疾舞=múa nhanh|x
一股股=từng luồng|m
触不及防=không kịp đề phòng|l
轻启=khẽ hé
温柔一吻=nhẹ nhàng hôn một cái/ôn nhu hôn một cái|l
一乐笑道=vui vẻ cười nói/nhất lạc tiếu đạo|l
一乐而道=vui vẻ nói/nhất lạc nhi dạo|l
一之心=nhất chi tâm|l
万法归一=vạn pháp quy nhất|l
梦呓般轻声道=nói khẽ như nói mê|x
算起来=tính ra|x
才是=mới phải/mới đúng|x
得很=đến cực kỳ|x
嘤嘤=ríu rít
不舍得=không nỡ/không đành lòng|l
卖可怜=làm bộ đáng thương|l
爱洁=thích sạch sẽ|l
不快活=không dễ chịu/không vui vẻ/không thoả mái|l
屁股沟=khe đít|n
嘴里边=trong miệng|l
胎中=trong bụng mẹ/trong thai|l
万中无一=một trong vạn/trong vạn không có|x
憔悴=tiều tụy/tiền tuỵ/hốc hác/võ vàng/khốn khổ|a
万中无一=một trong vạn/trong vạn không có|x
膣口=miệng âm đạo|n
同被=chung chăn|l
在后悔=đang hối hận|l
嘤咛=khẽ rên/anh ninh~|v
难受着=khó chịu|v
正难受着=đang khó chịu|l
为鱼肉=là thịt cá|l
为刀俎=là dao thớt|l
好久好久=thật lâu|m
理了理=sửa soạn/vuốt/chỉnh|v
碎发=tóc rối/tóc loà xoà|n
喘不过气=thở không ra hơi|l
造化=tạo hoá/tự nhiên/trẻ tạo/người tạo ra giới tự nhiên/sáng tạo/vận may/có phúc/may mắn/số đỏ|n
清晰可闻=có thể nghe rõ ràng|l
恶趣味=xấu xa thú vui/sở thích xấu|i
身子虚=thân thể yếu đuối|l
吐了一口气=thở ra một hơi|l
镶钻=khảm kim cương|l
翻了一个白眼=lườm một cái/lật liễu một cái bạch nhãn|l
每个月=mỗi tháng|m
在这=ở đây|l
决了堤=vỡ đê|x
没说一句话=không nói một câu|l
别说了=được không|x
操了多少心=hao tổn bao nhiêu tâm sức|l
就差明着说=chỉ thiếu điều nói thẳng|l
转过头=quay đầu|v
大小姐=đại tiểu thư|n
在地上=trên mặt đất|l
亲吻着=hôn hít|v
嗦嗦=xì xì|x
嗦嗦嗦=xì xì xì|x
好长=thật dài|x
好深=thật sâu|x
好紧=thật chặt|x
好粗=thật thô|x
好痒=thật ngứa|x
许久过去=qua hồi lâu|l
婚房=phòng cưới|n
哪有=nào có/đâu có|l倒在地=ngã xuống đất|l
她的背=lưng nàng|n
拍电视剧=quay phim truyền hình|l
不用你=không cần ngươi|l
走过去=đi tới|v
是吗=phải không|l
什么意思=có ý gì|l
是吗?=vậy sao?|l
不可置信=không thể tin|l
明知道=biết rõ|v
声谢谢=lời cảm ơn|n
接过去=tiếp lấy|v
谢谢你=cảm ơn ngươi|l
跑过去=chạy qua|v
回复信息=trả lời tin tức|l
不是吗?=không phải sao?|l
舒不舒服=dễ chịu hay không|l
自控力=khả năng tự chủ/năng lực kiềm chế bản thân|n
生理需要=nhu cầu sinh lý|n
长得=lớn lên/trưởng thành|v
女解说=nữ phát thanh viên/nữ bình luận|n
自认为=tự cho rằng|l
自认为自己=tự cho mình|l
个坏人=người xấu|x
个好人=người tốt|x
还你=trả lại ngươi|l
你们俩=hai người các ngươi|l
还的清=trả xong/trả hết|v
