应运而生=theo thời thế mà sinh/ứng vận nhi sinh/sinh ra theo thời thế




万贯家财=gia tài kếch xù/vạn quán gia tài/tài sản khổng lồ
万邦=vạn bang/Wanbon/tất cả các quốc gia
世家=thế gia/nhà làm quan
东=đông/nghĩa vụ chủ nhà
东主=đông chủ/chủ nhân
东走西顾=đông tẩu tây cố/đi đông đi tây
严加=chặt chẽ/nghiêm gia
严慈=nghiêm từ/nghiêm phụ và từ mẫu
五斗米道=Ngũ Đấu Mễ Đạo/Con đường của Thiên chủ
价格=giá cả/giới cách/giá/giá cả

催芽=thúc mầm/thúc nảy mầm




划过=xẹt qua/di động nhanh/tiến nhanh/quét/đảo

劳资=lão tử/mệt sức/chủ và thợ

千亿=trăm tỷ/trăm tỉ
千家万户=thiên gia vạn hộ/ngàn vạn gia đình
半老徐娘=người đẹp hết thời/bà sồn sồn/bán lão từ nương

卖主=người bán/chủ bán
卖艺=mãi nghệ/làm xiếc/múa võ/ca hát

印玺=ấn tỉ/ấn tỷ
厂家=xưởng/công xưởng/nhà máy/chủ nhà máy/chủ hãng
古灵精怪=cổ linh tinh quái/nhí nha nhí nhảnh/một cách tinh quái
史学家=nhà sử học/sử gia


复方=đơn thuốc kép/thuốc tổng hợp/thuốc phối hợp

天下一家=thiên hạ nhất gia/thiên hạ một nhà
天母=Thiên mẫu

妖主=Yêu Chủ/yêu chủ
媒染剂=thuốc ăn màu/chất phụ gia định màu nhuộm
嫂嫂=tẩu tẩu/chị dâu

字帖=tự thiếp/bảng chữ mẫu
字母表=bảng chữ cái/bảng mẫu tự
存心=có chủ tâm/ý định/mưu đồ/manh tâm/cố tình/rắp tâm/cố ý









底止=giới hạn/chấm dứt/kết thúc/chỗ dừng/điểm dừng
店家=chủ quán/cửa hàng/chủ tiệm/cửa hiệu/cửa tiệm
开交=dàn xếp/mở giao/giải quyết/kết thúc/chấm dứt/dứt
开动=thúc đẩy/chuyển động/chạy/khởi động/mở máy/động/hoạt động/tiến bước/tiến về phía trước
开山=khai sơn/phá núi/khai phá đồi núi/sư tổ khai sơn/khai sơn tổ sư/ông tổ
开拔=xuất phát/di chuyển/chuyển quân/chuyển động/xê dịch/bắt đầu lên đường/rút ra
开明=khai sáng/văn minh/tiến bộ/thông suốt/mang màu sắc dân chủ/giải thoát khỏi sự ngu dốt, mê tín/trao thêm kiến thức hoặc thông tin cho ai/sáng suốt









总理=thủ tướng/tổng lý/giám đốc/người phụ trách/quản lý chung/quản lý toàn bộ/Thủ tướng
总管=tổng quản/quản lý chung/quản lý toàn bộ/người quản lý/người quản lý chung
总统府=Phủ tổng thống/phủ Tổng thống
总裁=tổng giám đốc/tổng tài/quan tổng tài
总要=cũng nên/luôn luôn/tổng yếu/chung quy phải
总长=tổng trưởng/bộ trưởng/tham mưu trưởng/tổng tham mưu trưởng/chiều dài
总队长=trung đoàn trưởng/tổng đội trưởng
总面积=tổng diện tích/diện tích chung
您老=ngài/ngài lão/lão gia ngài
悲歌=bi ca/hát lời bi tráng/hát bi thương/bài điếu ca/khúc bi thương/bài ca bi thảm/khúc hát bi ai/khúc hát buồn đau/bài hát buồn/điệu buồn
想法=ý nghĩ/tìm cách/nghĩ cách/nghĩ cách/ý kiến/nhận xét/ý tưởng
愈盛=càng thịnh/càng mạnh mẽ
愚昧=ngu muội/dốt nát/mù quáng/ngu dốt
成功率=xác suất thành công/tỷ lệ thành công
成家立业=thành gia lập nghiệp/cưới vợ xây dựng cơ nghiệp
成心=cố tình/cố ý/có chủ tâm
成群结队=thành quần kết đội/cả đàn cả lũ/kết bè kết đội/cả đàn cả lũ/kết bè kết lũ
我儿=con ta/hài nhi của ta/con trai của ta
我姐=tỷ ta/tỷ của ta
我弟=em ta/ngã đệ/em của ta
战例=trận điển hình/trận mẫu/chiến tích
戚师弟=Thích sư đệ/Thích  sư đệ
户头=tài khoản/người gửi tiết kiệm/chủ sổ tiết kiệm/trương mục/công
所有=tất cả/sở hữu/hết thảy/vật sở hữu/toàn bộ/sở hữu tất cả
扁柏=cây trắc bá diệp/cây chamaecyparis obtusa/cây biển bách/cây bách lá tù
手机=điện thoại/điện thoại di động
打趸儿=mua sỉ/bán sỉ/tóm lại/tổng cộng/gộp
扦子=cái tiêm/cái giá/cái đế/cái xỉa/ống lấy mẫu
执行主席=chủ toạ/chủ tịch
扮猪吃虎=giả heo ăn thịt hổ/giả làm heo ăn thịt hổ
承接=tiếp nhận/hứng lấy/tiếp tục/tiếp nối/giữ/duy trì/tiếp diễn/xã giao/thù tạc/giao tiếp/tham gia hoạt động xã hội
抄斩=tịch thu tài sản giết kẻ phạm tội/chém giết tịch thu gia sản
报名=báo danh/đăng ký/ghi tên/đăng ký tham gia/ghi danh
抽到=rút đến/quất đến/rút được/rút thăm được/lấy mẫu ngẫu nhiên/đánh vào
拉家带口=vướng bận gia đình/gánh nặng gia đình/bìu ríu vợ con/ràng buộc họ hàng
拍卖行=phòng đấu giá/bán đấu giá
拍马=thúc ngựa/vỗ ngựa
拘束=câu thúc/hạn chế/hà khắc/khắc nghiệt/gò bó/ép buộc/thúc ép/cưỡng ép/nhút nhát/mất tự nhiên/không tự nhiên/câu nệ
拜认=bái nhận/làm lễ nhận người khác làm nghĩa phụ, nghĩa mẫu, sư phụ..
拜金主义=chủ trương tôn thờ đồng tiền/sự tôn thờ đồng tiền/bệnh ham làm giàu/quan niệm duy vật lý tài/chủ nghĩa sùng vàng
拨动=kích thích/quậy/quấy chọc/khơi/chọc/gạt/gợi/kích động/khêu gợi/thúc/khuấy/quấy/trộn/cời
择主=chọn chủ/trạch chủ
挣不脱=giãy dụa mà không thoát/không thoát được
换班=thay ca/đổi ca/thay kíp/đổi kíp
接班人=người nối nghiệp/thừa tự/người nhận ca/người nhận ban/người thay thế/người kế tục
推动=thôi động/đẩy mạnh/thúc đẩy
推着=đẩy/phụ giúp/thúc
推许=tôn sùng ca ngợi/ca ngợi
推进=đẩy tới/thúc đẩy/tiến lên/đẩy mạnh/tiến lên phía trước
揄扬=tán dương/tán thưởng/ca ngợi/tuyên dương/nêu gương
提交=đưa ra/đệ trình/đề giao
提亲=cầu hôn/đề nghị kết thông gia
插队=chen ngang/tham gia đội sản xuất ở nông thôn/nhập đội
摄影师=thợ quay phim/nhiếp ảnh gia/nhà nhiếp ảnh
摊丁入亩=gộp thuế đinh vào thuế ruộng/sạp đinh vào mẫu
摩托船=xuồng máy/ca-nô
撤佃=triệt điền/thu ruộng/địa chủ đòi lại ruộng đất
撤走=rút đi/chuyển đi/bỏ chạy/lui chạy/dời/di tản
播放器=máy chiếu phim/máy nghe nhạc/bá phóng khí/máy truyền tin
收住=dừng/dừng lại/kết thúc/đình chỉ
收班=hết ca/hết chuyến
改良主义=chủ nghĩa cải lương/chủ nghĩa cải cách
故国=cố quốc/quốc gia cổ/tổ quốc/đất nước/quê hương/cố hương
散席=tan tiệc/kết thúc bữa tiệc
敬老院=viện dưỡng lão/kính lão viện
数亿=mấy trăm triệu/mấy ức/mấy tỷ
文牍主义=chủ nghĩa giấy tờ/bệnh quan liêu giấy tờ
斗拳=đấu quyền/tỷ thí quyền thuật
斗转星移=đẩu chuyển tinh di/vật đổi sao dời/thời thế thay đổi/bãi biển hoá nương dâu/đấu chuyển tinh di
新姑爷=cô gia mới/chú rể mới
施加=thực hiện/gây/làm/gia tăng - thi hành/tạo nên
族主=tộc chủ/chủ họ
族谱=gia phả/tộc phổ
无功而返=không công mà lui/vô công nhi phản/tay trắng trở về
无所不至=bằng mọi cách/CHÍ/không trừ một nơi nào/bằng mọi cách/không từ bất cứ việc gì
无政府主义=chủ nghĩa vô chính phủ/vô chính phủ/chỉ hành vi, tư tưởng chống lại tổ chức trong đội ngũ cách mạng
无理数=số vô nghĩa/số vô tỷ
旮=ca/mọi ngóc ngách
旱烟袋=tẩu thuốc/tẩu hút thuốc/hạn yên đại
昂贵=đắt đỏ/sang quý/mắc/đắt tiền/mắc mỏ/đắt giá/đắt giá
昏聩=hoa mắt ù tai/mê muội/lẩm cẩm
昏蒙=ngu muội/mơ hồ
春化=xuân hoá/thúc/dục/kích thích
普查=tổng điều tra/điều tra rộng khắp/thăm dò rộng khắp
暧昧=mập mờ/ái muội/tối/mờ/khuất/thâm sâu/lèm nhèm/không minh bạch/không rõ ràng/không rõ rệt/đen tối/mờ ám/nhập nhằng/quanh co/không thẳng thắn/ám muội/khả nghi/không quang minh chính đại
暴死=nổ chết/chết bạo/Chết thình lình/bị bệnh chết đột ngột.. ◇Sơ khắc phách án kinh kì 初刻拍案驚奇: Kì gia đãn tri vi bạo tử/bất tri kì cố 其家但知為暴死/不知其故
曲子=từ khúc/khúc/ca khúc/bài hát/bài nhạc
更重=càng nặng/quá nặng/nặng hơn
更长=càng dài/dài hơn/lâu/càng dài
月下老人=nguyệt hạ lão nhân/ông tơ bà nguyệt
月嫂=điều dưỡng/bà mẫu/hộ lý/chị Nguyệt/người phụ nữ được thuê để chăm sóc một đứa trẻ mới sinh và mẹ của nó trong tháng sau khi sinh con
有口皆碑=tiếng lành đồn xa/ai cũng khen/ai cũng ca ngợi
有感而发=biểu lộ cảm xúc/hữu cảm nhi phát/hữu cảm nhi phát (*có cảm xúc nên phát ra)
未婚=chưa lập gia đình/vị hôn/chưa cưới/chưa kết hôn
未来主义=chủ nghĩa vị lai/chủ nghĩa tương lai/Chủ nghĩa vị lai
本主儿=đương sự/chính người đó/chủ nhân/nguyên chủ/cố chủ
本位主义=cá nhân chủ nghĩa/chủ nghĩa bản vị
本体论=bản thể luận/hình nhi thượng học
本少=bản thiếu/thiếu gia ta
本少主=bổn thiếu chủ/bản thiểu chủ

朵颐=cắn ăn/ăn ngốn/ăn/đóa di
机械论=chủ nghĩa duy vật máy móc/cơ giới luận
杀机=sát cơ/sát khí/ý định giết người/chủ tâm giết người
杂院儿=sân chung/sân chung của nhiều hộ gia đình

束住=thúc trụ/trói lại
束腰=đai lưng/thúc yêu
束身=giữ mình/tự rèn mình/tự trói buộc/thúc thân

果儿=Quả nhi/trứng gà
枯枝=cành khô/cành khô
某本=nào đó bản/mỗ vốn

标本=tiêu bản/gốc và ngọn/gốc đến ngọn/mẫu xét nghiệm/vật xét nghiệm/tiêu bổn
栋梁=lương đống/trụ cột của quốc gia/trụ cột/rường cột/đống lương
校样=so mẫu/bản in thử/mo-rát
样刊=tạp chí mẫu/mẫu tạp chí
样子=bộ dáng/hình dạng/kiểu mẫu/thần sắc/vẻ/mẫu/tình hình/xu thế/có vẻ/kiểu dáng/dáng vẻ
样板=bản mẫu/tấm mẫu/thước mẫu/gương học tập/mẫu
根本=căn bản/gốc rễ/cội nguồn/hoàn toàn/triệt để/chủ yếu/trọng yếu/từ trước đến giờ/trước giờ/vốn/xưa nay/trước sau/từ đầu đến cuối/tuyệt nhiên/không hề/tận gốc
格子=ô vuông/ngăn chứa/ca-rô/dấu đã kiểm/dấu ghi đã kiểm tra
格调=phong cách/cách điệu/phong cách/phẩm cách
桌椅板凳=bàn ghế/đồ mộc gia dụng
棒=bổng/tốt/gậy/ca tụng/tuyệt
棣棠=cây kerria/cây chùm vàng/cây đệ đường
楼主=lâu chủ/chủ topic
概括=khái quát/tổng quát/nhìn chung/tóm tắt/tóm lược
概要=điểm chính/yếu lược/đại cương/cốt yếu/chủ yếu
概观=nhìn chung/nhìn bao quát/nhìn tổng quát/tình hình chung
概貌=tình hình chung/tình hình khái quát/nét chung/nét chính/tổng quát
模型=mô hình/khuôn/hình mẫu/khuôn đổ/khuôn ép/khuôn mẫu
模子=khuôn mẫu/mô hình/mẫu/khuôn
模式=hình thức/kiểu mẫu/khuôn mẫu/mẫu/mô thức
模版=khuôn mẫu/mẫu
模特儿=người mẫu/mô-đen

款式=kiểu dáng/phong cách/tác phong/cách/lối/kiểu/mẫu/loại/dạng/khoản thức
歌=ca/bài hát
歌吟=ca hát/ngâm vịnh
歌唱家=ca sĩ/người hát
歌坛=giới ca hát/giới ca sĩ/ca đàn
歌女=ca nữ/ca sĩ nữ/nữ diễn viên
歌子=ca khúc/bài ca/bài hát
歌星=sao ca nhạc/ngôi sao ca nhạc/ca sĩ nổi tiếng/ca sĩ
歌神=ca thần/thần ca hát
歌舞=ca múa/ca vũ/múa hát
歌舞升平=ca múa mừng cảnh thái bình/ca vũ thăng bình
歌舞厅=phòng ca múa/ca vũ thính/phòng ca múa nhạc
正主=chính chủ/chính chủ
正气歌=chính khí ca/Chính Khí ca
正题=chính đề/chủ đề/đề chính/đề tài chính
此獠=kẻ này/ cái thằng chó này/lão này/cái thằng này
死产=thai chết lưu/Đẻ ra thai nhi bị chết
母=mẫu/mẹ/cái
母国=mẫu quốc/tổ quốc
母子=mẹ con/mẫu tử
母性=mẫu tính/mẫu tính (*bản năng của người mẹ)
母本=mẫu bản/gốc cái/cây cái
母机=máy cái/máy chủ/máy chính
母老虎=cọp cái/cọp mẹ/cái/cọp cái
母舰=mẫu hạm/tàu mẹ
母船=thuyền mẹ/mẫu hạm
比分=điểm số/tỷ số
比斗=giao đấu/thi đấu/tỷ đấu
民主集中制=chế độ tập trung dân chủ/nguyên tắc tập trung dân chủ
民怨=kêu ca/kêu than/dân oán
民粹主义=chủ nghĩa dân tuý/chủ nghĩa dân túy
求名=cầu danh/Truy cầu tiếng tốt. ◇Nhan thị gia huấn 顏氏家訓: Vong danh giả/thể đạo hợp đức/hưởng quỷ thần chi phúc hựu/phi sở dĩ cầu danh dã 忘名者/體道合德/享鬼神之福祐/非所以求名也
求战=khiêu chiến/gây chiến/yêu cầu tham gia chiến đấu
汇编=tổng hợp/biên soạn/sưu tập/sưu tầm/hối biên
汉主=Hán chủ/vua nhà Hán


汽船=thuyền máy/xuồng máy/ca-nô

油然而生=tự nhiên sinh ra/du nhiên nhi sinh/du nhiên nhi sinh/tự nhiên mà sinh ra
法治=pháp trị/cai trị quốc gia bằng pháp luật
法西斯=phát xít/chủ nghĩa phát xít/Phát xít
活动=hoạt động/chuyển động/vận động/theo mục đích/vì mục đích nào đó/hành động có mục đích/lay động/lung lay/không ổn định/đung đưa/lắc lư/linh hoạt/di động/không cố định/sinh hoạt/chạy chọt/đút lót/mua chuộc
活死人=người chết sống lại/xác chết di động/zombie/hoạt tử nhân/người đần độn/đồ vứt đi/người vô dụng
流动=lưu động/chảy/di động/không cố định
浇料=sốt gia vị để phết/nước sốt để rưới
浑括=tóm tắt/kết luận/tổng kết
浮动汇率=hối giá thả nổi/tỷ giá không ổn định/tỉ giá thả nổi
深化=gia tăng/sâu sắc hơn/đi đến chỗ sâu sắc hơn/thâm hóa
混茫=không rõ/lờ mờ/mông muội
混血儿=con lai/lai/hỗn huyết nhi
渔歌=ngư ca/bài hát của ngư dân
游走=du tẩu/chạy/bơi/đi khắp

潜移默化=thay đổi một cách vô tri vô giác/không nhận thức được/biến đổi ngầm/tiềm di mặc hóa/bất tri bất giác
灌输=quán thâu/dẫn nước/đưa nước/truyền bá/truyền/truyền thụ/truyền vào
灞桥=bá cầu/Cầu Thước/Baqiao District of Xi’an 西安市 [Xi1 an1 Shi4], Thiểm Tây
火轮=hỏa luân/ca-nô/tàu thủy/mặt trời/canô
煎迫=bức bách/bắt buộc/thúc ép
煞尾=kết thúc/thu dọn/khổ nhạc cuối cùng/đoạn kết
煤老板=đại gia dầu mỏ/ông chủ than
煮豆燃萁=củi đậu nấu đậu/nồi da xáo thịt/huynh đệ tương tàn
爱国如家=yêu nước như nhà/yêu đất nước như yêu gia đình của mình
父母=phụ mẫu/cha mẹ/ba má
父母亲=cha mẹ/phụ mẫu thân
爷儿=gia nhi/ông cháu/cha con
爷爷=gia gia/ông nội/ông
爷青回=thanh xuân trở lại/gia thanh hồi
片甲=mảnh giáp/mảnh giáp
牢骚=bực tức/tức/giận/oán trách/oán than/oán thán/kêu ca/than phiền/bất bình/lao tao
牲口=gia súc/sinh khẩu
狗仗人势=chó cậy gần nhà, gà cậy gần chuồng/chó cậy thế chủ
独霸一方=độc bá nhất phương/độc quyền một vùng
狱警=giám ngục/cảnh ngục/quản giáo/giám ngục
狼吞虎咽=ăn như hổ đói/lang thôn hổ yết/nuốt ngấu nghiến/ăn như hà bá đánh vựa/ăn như thần trùng mở mả/ngốn nga ngốn nghiến/ăn như hùm như sói
猪哥=Trư ca/Trư ca (bát giới)
猫儿=mèo con/Miêu nhi
率=suất/tỷ số/dẫn đầu/suất (*tỉ lệ)
王爷=Vương gia
王牌=vương bài/át chủ bài/con chủ bài/lá bài chủ chốt
玻璃丝=sợi thủy tinh/sợi ca-prôn/sợi thuỷ tinh
班组=tổ/tổ ca/nhóm lớp/Tổ ca
生而知之=sinh ra đã biết/sinh nhi tri chi
生育率=tỷ lệ sinh/khả năng sinh sản/tỉ lệ sinh
田埂=bờ ruộng/bờ mẫu/Ðiền canh/thửa ruộng
田家=Điền gia/nông dân
画谱=bản mẫu tập vẽ/bản mẫu/thiếp tập vẽ/sách đánh giá tranh/sách bình luận tranh
界主=Giới Chủ/giới chủ
留鸟=chim không di trú/loài chim không di trú
番茄=cà chua/phiên gia/cây cà chua/quả cà chua/trái cà chua
疆域=cương vực/lãnh thổ quốc gia/đất đai/địa hạt
病例=ca bệnh/ca/trường hợp/vụ bệnh
瘸=què/cà nhắc
白班=bạch ban/ca ngày
百家=bách gia/nhiều gia đình/nhiều dân tộc/đủ loại trào lưu học thuật/nhiều trường phái/trăm nhà
百家姓=bách gia tính/trăm họ Trung quốc
百灵=bách linh/chim sơn ca/Bách Linh
百货商店=cửa hàng bách hoá/cửa hàng tổng hợp
监督=giám sát/giám đốc/đốc thúc/giám sát viên/đốc công/người làm nhiệm vụ giám sát
相去=khác/cách nhau
看清楚=thấy rõ ràng/nhìn rõ ràng/nhìn rõ ràng
眩晕里=trong mê muội/trong hôn mê
着魔=mê muội/si mê/mê mẩn/ma
督战=đốc chiến/đôn đốc tác chiến/giám sát và đốc thúc tác chiến
石子儿=đá/stone nhi/thạch tử nhi/cobble
示例=thí dụ mẫu/ví dụ mẫu
礼拜=lễ bái/tuần lễ/cúng lễ/tuần/thứ/ngày thứ/chủ nhật/ngày chủ nhật
礼拜天=ngày chủ nhật/lễ bái thiên/chủ nhật
社会主义=chủ nghĩa xã hội/chủ nghĩa xã hội khoa học/chế độ xã hội chủ nghĩa
祖传=tổ truyền/gia truyền/ông cha truyền lại
禁不住=không chịu được/nhịn không được/không chịu nổi/không ức chế nỗi/không dừng được/không cầm được/không nín được/không nhịn được/không nhịn được
科班=chính quy/đào tạo chính quy/đào tạo chuyên nghiệp/tổ chức triệu tập nhi đồng để đào tạo thành diễn viên Hí khúc/khoa ban
称叹=ngợi khen/ngợi ca/tán thán/ca ngợi/tán dương
称王称霸=xưng vương xưng bá/xưng hùng xưng bá/làm vương làm tướng
称羡=ca ngợi/ca tụng/thán phục
称道=ca ngợi/khen/khen ngợi/tán dương/tuyên dương/ca tụng/xưng đạo
称颂=ca tụng/khen ngợi/tán dương
移山倒海=di sơn đảo hải/dời núi lấp biển/dời non lấp biển/đào non lấp biển
移植=cấy ghép/nhổ trồng/nhổ cấy/dời trồng/cấy/ghép/di thực
移樽就教=chủ động học hỏi/bưng rượu đến thỉnh giáo
移腿=di động/di chuyển - chân
移花接木=di hoa tiếp mộc/lập lờ đánh lận con đen
程千总=Trình Thiên tổng/Trình thiên tổng
窥破=nhìn ra/dòm ra
竞价=đấu giá/tranh giá
第一刀=đệ nhất đao/đao thứ nhất
第一国际=đệ nhất quốc tế/quốc tế thứ nhất
第一境=đệ nhất cảnh/cảnh giới thứ nhất
第一家=nhà thứ nhất/đệ nhất gia
第七道=đạo thứ bảy/đệ thất đạo
第三式=thức thứ ba/đệ tam thức
第三招=chiêu thứ ba/đệ tam chiêu
第三重=đệ tam trọng/tầng thứ ba
第九重=đệ cửu trọng/tầng thứ chín
第二=thứ hai/đệ nhị
第二十五=thứ hai mươi lăm/đệ nhị thập ngũ
第二根=cái thứ hai/đệ nhị cây
第五=thứ năm/đệ ngũ
第五根=cây thứ năm/đệ ngũ cây/cái thứ năm
第六篇=thiên thứ sáu/đệ lục thiên
第十一=thứ mười một/đệ thập nhất
策励=thúc đẩy/đốc thúc/khích lệ/thôi thúc/thúc giục/khuyến khích
策马=giục ngựa/thúc ngựa
管束=quản thúc/kềm chế/quản chế/nén lại/kềm lại/ràng buộc/ràng giữ
系主任=chủ nhiệm khoa/trưởng khoa/Chủ nhiệm khoa
系出名门=hệ xuất danh môn/khoa nổi tiếng/đến từ một gia đình danh giá
結束=kết thúc/Yuitsuka
絮絮叨叨=lải nhà lải nhải/cằn nhằn/già chuyện
红儿=Hồng nhi/hồng nhi
约制=ước chế/hạn chế/quản thúc/ràng buộc/bó buộc
纨绔=hoàn khố/quần áo lụa là/quần là áo lượt/công tử bột
纨绔子弟=ăn chơi thiếu gia/ăn chơi trác táng/playboy/con nhà giàu/công tử bột
练家子=người luyện võ/luyện gia tử
终结=kết thúc/chung kết/kết cuộc/nơi tận cùng
经院=kinh viện/triết học kinh viện/chủ nghĩa kinh viện
经院哲学=triết học kinh viện/chủ nghĩa kinh viện
结亲=kết thân/kết hôn/hôn nhân/kết tình thông gia
结束了=đã xong/kết thúc rồi
结语=lời kết thúc/phần kết/lời bạt
绝霸=tuyệt bá/Tuyệt Bá
统帅=thống soái/thống suất/chỉ huy/tổng chỉ huy/điều khiển/Thống soái
统管=quản lý/quản lý chung/tổng quản lý
绥靖主义=chính sách thoả hiệp cầu an/chủ nghĩa tuy tịnh/thuyết bình định
综=tổng/tông/tống
综上所述=từ trên tổng hợp lại/nói tóm lại
综合处=tổng hợp xử/phòng tổng hợp
综合排名=tổng xếp hạng/xếp hạng toàn diện
综括=tổng quát/bao gồm cả
综述=nói khái quát/tổng thuật
缸子=lọ/ca
罕譬而喻=hãn thí nhi dụ/kẻ khéo dạy thì nói ít mà vẫn dễ hiểu
美谈=ca tụng/câu chuyện mọi người ca tụng
翻修=sửa chữa lại/tu sửa/đổi mới mẫu mã
翻工=làm lại/gia công lại/phiên công
老=lão/già/rất
老七=lão Thất/Lão Thất
老丈人=lão trượng nhân/cha vợ
老不死们=đám lão bất tử/các lão bất tử
老东家=ông chủ cũ/lão đông gia
老书=sách cũ/lão thư
老侯爷=lão hầu gia/lão Hầu gia
老公公=lão  công công/ông/bố chồng/thái giám
老六=lão Lục/lão lục
老兵=lão binh/lính già/lão Binh/lính cũ
老农=lão nông/nông dân giàu kinh nghiệm
老友=lão hữu/bạn già/bạn lâu năm/bạn chí cốt/bạn cũ
老古董=lão cổ đổng/lão ngoan đồng/đồ cổ/cổ hủ/lão già
老大=lão đại/về già/lúc già/khi già/anh cả/người chèo đò/người đưa đò/rất/vô cùng
老大哥=lão đại ca/lão Đại ca
老天=lão thiên/lão Thiên/ông trời
老太公=lão thái công/bà già/quý ông lớn tuổi
老太婆=lão thái bà/bà già/lão bà
老太爷=lão thái gia/Lão thái gia/ông/quý ông/ông bên nhà/ông nhà
老头子=lão đầu tử/lão nhân/lão già/ông nó/ông ấy/thủ lĩnh/đại ca
老奶奶=lão nãi nãi/bà cố nội/bà cụ/bà lão
老妪=lão ẩu/bà lão
老姐=lão tỷ/chị gái
老子们=bọn lão tử/bọn ông mày đây
老字号=danh tiếng lâu năm/cửa hiệu lâu đời/cửa hiệu lâu năm/lão tự hào
老学究=lão học cứu/cổ giả/độc giả cao tuổi
老宅=lão trạch/khu nhà cũ/nhà cũ/(tổ tiên để lại)
老对头=lão đối đầu/đối thủ cũ
老将=lão tướng/người giàu kinh nghiệm
老年=lão niên/già nua/người già
老底=nội tình/gốc gác/nguồn cơn/của gia bảo/vốn liếng/lão để
老弟=lão đệ/cậu/chú em
老当益壮=càng già càng dẻo dai/gừng càng già càng cay/tuổi cao chí càng cao/lão đương ích tráng
老戏骨=lão hí cốt/cốt truyện cũ/diễn viên kỳ cựu
老手=lão thủ/tay già đời/lão luyện/tay sành điệu/người từng trải/người kỳ cựu
老掉牙=cũ rích/già cỗi/lỗi thời/cổ xưa/không hợp thời/lão điệu nha
老搭档=lão cộng tác/bạn nối khố/bạn gắn bó/hợp tác lâu
老景=lão Cảnh/cảnh già/tuổi già
老本=vốn ban đầu/vốn/lão bổn
老本行=nghề cũ/lão bổn hành
老板们=các lão bản/đám ông chủ
老母=lão mẫu/mẹ già
老气=cổ lỗ/vẻ người lớn/chững chạc/ra vẻ/ra vẻ người lớn/xám xịt/lão khí
老油子=tên giảo hoạt/tay lỏi đời/lão du tử
老油条=kẻ già đời/càng già càng lão luyện/lão du điều
老泪=lão lệ/lão Lệ
老烟=lão Thuốc/lão yên
老父亲=lão phụ thân/cha già
老爸=lão ba/phụ thân/cha
老生=lão sinh/vai nam trung niên/học sinh cũ/lão sinh (học sinh lâu năm)
老的人=lão nhân/người của lão
老眼昏花=mắt mờ/về già mắt bị lão hoá/lão nhãn hôn hoa/mắt mờ chân chậm
老祖母=lão tổ mẫu/bà già
老老实实=thành thành thật thật/lão lão thật thật/đàng hoàng
老藤=lão đằng/dây leo lâu năm/dây leo già
老衲=lão nạp/vị tăng già
老路=đường xưa/lối cũ/con đường cũ/kiểu cũ/lão Lộ
老身=lão thân/bà già này
老辈=lão bối/lớp người già/thế hệ trước/tiền bối/người lớn tuổi/bề trên
老道=lão đạo/đạo sĩ
老铁=lão Thiết/lão thiết
老鸨=tú bà/má mì/chủ chứa/trùm gái điếm/lão bảo
老鹰=diều hâu/lão ưng
老黄历=lão hoàng lịch/ngày nào
老鼠=chuột/lão thử/con chuột
老龙=lão long/lão Long
耆老=bô lão/người già

联播=tiếp âm/tiếp sóng/liên bá/phát thanh
肥育=vỗ béo/nuôi thúc


胶木=ván ghép/nhựa tổng hợp/ba-kê-lít
脱颖而出=trổ hết tài năng/bộc lộ tài năng/cái kim trong bọc có ngày lòi ra/thoát dĩnh nhi xuất
脸儿=khuôn mặt/kiểm nhi/mặt
臆测=phỏng đoán/suy đoán chủ quan/đoán chừng
臆见=nhận xét chủ quan/quan điểm chủ quan
臣僚=quan lại/bá quan văn võ
自然主义=tự nhiên chủ nghĩa/chủ nghĩa tự nhiên
舞者=vũ giả/người học võ/người tham gia múa
航空母舰=hàng không mẫu hạm/tàu sân bay/tàu chở máy bay/Hàng không mẫu hạm
船舱=khoang tàu/buồng nhỏ trên tàu/khoang thuyền/ca-bin
良家=nhà lành/đàng hoàng/gia đình thanh bạch/gia đình tử tế/nhà lương thiện
节育=hạn chế sinh đẻ/tránh thai/kế hoạch hoá gia đình/khống chế sinh đẻ
花儿=bông hoa/Hoa nhi
花儿样子=mẫu thêu hoa/bản mẫu thêu hoa
花哨=sức tưởng tượng/mê thích nhất thời/người hâm mộ/lôi cuốn/cuốn hút/ngon/vui mắt/khác thường/lạ lùng/ngông cuồng/quá đáng/màu sắc rực rỡ/sặc sỡ/đẹp đẽ/màu sắc đẹp đẽ/đa dạng/nhiều kiểu mẫu/biến hoá/nhiều thay đổi/hoa tiếu
花大姐=Hoa đại tỷ/bọ rùa/Hoa đại tỷ
花格子=ca rô/kẻ ca rô hoa
花棍舞=bá vương tiên/múa gậy hoa/điệu múa bá vương tiên
范儿=phong phạm/phạm nhi
茄子=quả cà/cà/cây cà/trái cà/gia tử
茶素=ca-phê-in/caphêin
草料=cỏ khô/thức ăn gia súc/rơm cỏ
营养师=bác sĩ dinh dưỡng/chuyên gia dinh dưỡng/Bác sĩ dinh dưỡng
落定=kết thúc/lạc định
落幕=kết thúc/bế mạc/hạ màn/tấm màn rơi xuống
蒙昧=mông muội/tối tăm/u mê/khờ dại
蒙王爷=được vương gia/Mông vương gia
蓄谋=chủ mưu/có âm mưu
藤儿=Đằng nhi/cây mây
蛋疼=nhức cả trứng/trứng đau/nhức hết cả bi/đau "bi"
蜀黍=thúc thúc/cây cao lương/hạt cao lương
蝉儿=Thuyền nhi/thiền nhi/con ve
血液=huyết dịch/máu/huyết/chủ yếu/thành phần chính/huyết dịch
行家=người trong nghề/hành gia/tay tổ/người lành nghề/người thạo nghề/giỏi nghề/thạo nghề/lành nghề/chuyên gia/Hành gia
行家里手=trong tay hành gia/chuyên gia
行尸走肉=cái xác không hồn/giá áo túi cơm/hành thi tẩu nhục/thịt chạy thây đi/cái xác biết đi/Walking Dead/xác chết di động
衣冠冢=mộ quần áo/Y Quan trủng/mộ chôn quần áo và di vật
表兄妹=biểu huynh muội/anh chị em họ
表演=biểu diễn/diễn/trình diễn/trình bày/phô bày/trưng bày/làm mẫu/làm động tác mẫu/thao diễn/thực hiện
表率=làm gương mẫu/gương tốt/tấm gương sáng/mẫu mực/mực thước/biểu suất/đại biểu
裘某=Cầu mỗ/Cừu mỗ
裘母=Cầu mẫu/Cừu mẫu
褒义=ca ngợi/nghĩa tốt/khen ngợi/tán dương/tuyên dương/bao nghĩa
褒义词=lời ca ngợi/lời khen ngợi/từ có nghĩa tốt
褒扬=biểu dương/tán dương/ca ngợi/tuyên dương
要旨=ý chính/ý chủ yếu
见称=được ca ngợi/được tán thưởng
规格=quy cách/kiểu mẫu/cách thức/khuôn mẫu/cỡ/quy định/yêu cầu hoặc điều kiện đã định
角色=nhân vật/kiểu người/vai/loại người/mẫu người/vai trò
训导主任=thầy tổng giám thị/thầy tổng giám sát
讴歌=ca ngợi/ca tụng/khen ngợi
许千总=Hứa Thiên tổng/Hứa thiên tổng
访古=kiếm di tích cổ/viếng di tích cổ
词干=thân từ/từ gốc/từ nguyên mẫu
诗文=thơ văn/thi văn/thư ca và văn chương
话茬=đề tài/nói chuyện/chủ đề đang thảo luận
诸子百家=bách gia chư tử/chư tử bách gia/Trăm trường phái tư tưởng, các trường phái tư tưởng khác nhau và các cơ sở của chúng trong thời Xuân Thu và Chiến Quốc
诸般=các loại/nhiều loại/các loại
调味品=gia vị/đồ gia vị
谋臣=mưu thần/chuyên gia về chiến lược
谎报=báo cáo sai/nói dối/báo cáo láo/khai man/báo cáo sai/báo cáo láo (sai)
谙练=lành nghề/thành thạo/thuần thục/lão luyện/rành/sành sỏi/giàu kinh nghiệm

谷哥=Cốc ca/Google
豪商=phú thương/thương gia giàu có/hào thương
貂儿=con chồn/Điêu nhi
财大气粗=tài đại khí thô/(*tiền nhiều như nước)/giàu nứt đố đổ vách
财神爷=thần tài/ông thần tài/tài thần gia
贤妹=hiền muội/em Hiền/Tiếng gọi em gái mình, với ý tôn xưng.
败子=phá gia chi tử/kẻ tiêu xài hoang phí/con hư
败家=bại gia/phá sản/lụn bại/phá của
败家子=bại gia tử/phá gia chi tử/người ăn tiêu hoang phí/người tiêu tiền như rác/người lười biếng vô tích sự/con phá của
败走=thua chạy/bại tẩu/thất bại bỏ chạy
货样=mẫu hàng/hàng mẫu
贾人=thương nhân/thương gia/nhà buôn/người buôn bán
赌东道=chủ sòng bạc/chủ sòng bài
赞誉=khen ngợi/thừa nhận/tán dương/ca ngợi/ca tụng/tán tụng/khen
赞颂=tán tụng/tôn sùng/ca tụng/ca ngợi/khen ngợi
走为上计=tẩu vi thượng kế/tẩu vi thượng sách
走亲访友=tẩu thân phóng hữu/thăm người thân và bạn bè/thăm bạn bè và các mối quan hệ của một người
走兽=tẩu thú/thú/thú vật
走马灯=đèn kéo quân/đèn cù/tẩu mã đăng
起家=lập nghiệp/làm nên/khởi gia
越狱=vượt ngục/trốn tù/đào tẩu/vượt ngục bỏ trốn
路千总=Lộ Thiên tổng/Lộ thiên tổng
身家=thân gia/bản thân và gia đình/xuất thân/tài sản/dòng dõi
车灯=đèn xe/một hình thức ca vũ dân gian ở vùng Tây Nam
转轴=trục xoay/trục chuyển động/trục quay/chủ ý/chủ định
软禁=giam lỏng/quản thúc
较大=khá lớn/lớn hơn/trọng đại/chủ yếu/nhiều hơn
辣妹子=cay muội tử/hot girl/một phụ nữ trẻ ngổ ngáo hoặc một cô gái xinh đẹp
辩证唯物主义=chủ nghĩa duy vật biện chứng/duy vật biện chứng
迁移=di chuyển/chuyển chỗ/chuyển/thiên di
过儿=Quá nhi/lần
过失杀人=ngộ sát/giết người không chủ định
过家家=chơi nhà chòi/nhà chòi/quá gia gia
返老还童=phản lão hoàn đồng/cải lão hoàn đồng/người già trẻ lại/hồi xuân
这城主=thành chủ này/người thành chủ này
追肥=bón thúc/phân bón thúc
逃走=đào tẩu/chạy trốn/chuồn
递交=đệ trình/trình/đưa tận tay/trao tay/đệ giao
递送=đưa/chuyển/đệ
通分=quy đồng mẫu số/đồng phân
通史=thông sử/lịch sử tổng quát
通婚=thông hôn/kết hôn/lấy nhau/thành hôn/kết thông gia
逼人=bức người/thúc bách/cấp bách/cấp thiết/toả hơi nóng/phả hơi nóng
逼命=đe doạ/hăm doạ/thúc bách/thúc ép
道道儿=biện pháp/phương pháp/phương cách/cách/chủ ý/lề lối/cách thức/con đường
遗业=sự nghiệp do người trước để lại/di sản
遗址=di chỉ/suy đồi
遗墨=bút tích để lại/di bút
遗恨=di hận/mối hận suốt đời
遗愿=nguyện vọng/ước nguyện/di nguyện
遗照=di ảnh/ảnh người chết
遗精=mộng tinh/bệnh di tinh
遗蜕=lột xác/xác lột/di thuế
遗风=di phong/thói cũ còn sót lại
遗骸=di hài/di thể/di cốt
邱千总=Khâu Thiên tổng/Khâu thiên tổng
邸=để/đệ
酒保=tửu bảo/người hầu rượu/người bán rượu/chủ quán rượu/người phục vụ ở quán rượu/kẻ làm thuê cho hàng rượu/battender
酣歌=say sưa ca hát/hát say sưa
酣歌恒舞=ngập trong yến tiệc ca hát/ăn chơi thả cửa
酵母菌=diếu mẫu khuẩn/nấm men/khuôn
采制=thu thập chế biến/thu thập gia công/thu thập/lấy tin rồi ghi âm hoặc ghi hình
重心=trọng tâm/chủ yếu/cốt nặng
金工=gia công kim loại/xử lý kim loại
钱母=Tiền mẫu/mẹ Tiền
链枷=cây vụt/liệm gia (côn)
错动=thác động/để di chuyển tương đối với nhau
长年=nhiều năm/quanh năm/suốt năm/người ở đợ/đầy tớ/trường thọ/chủ thuyền/người chủ thuyền
长歌当哭=dùng thơ văn để giải toả nỗi buồn/trường ca thay nước mắt
长者=trưởng giả/trưởng lão/bậc trưởng thượng
长鲸吸水=cá voi hút nước/trường kình hấp thủy/trường kình hấp thủy (*)
门户=môn hộ/cửa/cửa ngõ/cửa ra vào/gia đình/môn phái/địa vị xã hội
门生=môn sinh/môn đệ
门第=dòng dõi/huyết thống/môn đệ
门里出身=nghề gia truyền/có nghề gia truyền
闭幕=bế mạc/hạ màn/kết thúc
防老=dưỡng già/dưỡng lão
阿哥=đại ca/anh/huynh/con trai/a ka/a ca
附庸国=nước phụ thuộc/các quốc gia chư hầu
随乡入乡=nhập gia tuỳ tục/vào làng thì phải theo lệ làng/đất lề quê thói
雀儿=tước nhi/chim tước
雄主=hùng chủ/vị vua có tài trí mưu lược kiệt xuất
雅正=xin ý kiến chỉ giáo/quy phạm/mẫu mực/chính trực
雕儿=điêu nhi/đại bàng con
零售商=nhà bán lẻ/thương gia bán lẻ
雷千总=Lôi Thiên tổng/Lôi thiên tổng
霸业=bá nghiệp/sự thống trị/nghiệp bá/bá nghiệp
霸占=chiếm lấy/bá chiếm/chiếm đoạt/chiếm đóng
霸才=phách tài/bá tài
霸榜=bá bảng/Bá Bảng
霸霸=bá bá/Bá Bá
靓妹=tịnh muội/đẹp gái
面额=mệnh giá/mặt trán/mệnh gía/mệnh giá/loại
鞭策=thúc giục/quất roi/nghiêm khắc thúc giục/tiên sách

顺时而动=thuận thời mà động/di chuyển theo thời gian
顾家=lo việc nhà/Cố gia/lo cho gia đình/lo chuyện nhà/

颂扬=khen ngợi/ca ngợi/ca tụng
领主=lãnh chúa/lĩnh chủ
领空=không phận/vùng trời quốc gia/lĩnh không
飞檐走壁=vượt nóc băng tường/võ nghệ cao cường/phi thiềm tẩu bích/phi diêm tẩu bích
馅儿=nhân bánh/nhân thịt nhồi/hãm nhi
驱使=thúc đẩy/đem ra sử dụng/khu sử/ép buộc/thúc giục/lái/điều động
驱策=ra roi/di chuyển
驱马=ruổi ngựa/thúc ngựa/xua ngựa
高中=cao trung/cao trúng/trường trung học bậc cao đẳng/trung học đệ nhị cấp/trường cấp 3
高歌猛进=hát vang tiến mạnh/cao ca mãnh tiến
高祖母=cao tổ mẫu/bà sơ
魂儿=hồn nhi/linh hồn nhỏ bé
魄力=quyết đoán/ phách lực/kiên quyết/quả quyết/dứt khoát/bá lực/phách lực (*)
魔幻现实主义=chủ nghĩa hiện thực huyền ảo/chủ nghĩa hiện thực huyền diệu
鸣唱=minh xướng/ca hát
鹊巢鸠占=tu hú chiếm tổ/tu hú sẵn tổ (khách chiếm nhà chủ)/tu hú sẵn tổ/chim cưu chiếm tổ chim khách/chiếm nhà đất của người khác

黑道=hắc đạo/đường tối/bất chính/phạm pháp/ám muội/tổ chức tội ác/xã hội đen/ma-phi-a
齐唱=đồng ca/hợp ca
龙头=long đầu/đầu rồng/vòi nước/vòi/ghi-đông xe đạp/dẫn đầu/chủ đạo/thủ lĩnh giang hồ/đại ca giới giang hồ/trùm xã hội đen/đầu rồng (vòi nước)/đầu rồng
专门家=chuyên gia/chuyên viên/người có chuyên môn
世族=thế gia vọng tộc/thế tộc
丧主=tang chủ/người chủ trì tang lễ
主张=chủ trương/cho là/cho rằng
乐舞=vũ nhạc/ca múa/ca vũ
价格为=giá cả là/giá tiền là
会众=hội chúng/người dự hội nghị/người dự họp/người tham gia
促使=thúc đẩy/thúc/giục/giục giã
共计=tổng cộng/tính gộp/tất cả/cả thảy/cùng bàn tính/cùng bàn chuyện/cùng trao đổi/tổng cộng là
南儿=Nam nhi
原主=nguyên chủ/chủ cũ
参加=tham gia/gia nhập/tham dự/dự/đề xuất/đưa ra/cho/góp
史迹=sử tích/di tích lịch sử
名模=người mẫu/danh mô
基本上=trên cơ bản/chủ yếu/cốt yếu/đại thể/về cơ bản/trên căn bản
姐妹们=bọn tỷ muội/các tỷ muội
姨父=di phụ/dượng
婚娶=đón dâu/lấy vợ/lập gia đình
家乡=quê quán/gia hương/quê nhà/quê hương
家声=danh dự gia đình/thanh danh gia đình/danh tiếng gia đình
家规=gia quy/nề nếp/phép tắc
小家伙=tiểu gia hỏa/tiểu tử kia/tiểu tử
层层加码=lên từng cấp/lớp cộng mã/gia số lặp lại
府主=Phủ chủ/phủ chủ
总队=tổng đội/trung đoàn
悲剧片=phim bi kịch/Bi kịch, phim kết thúc không có hậu
托儿带口=gánh nặng gia đình/拉家带口
收尾=kết thúc/kết thúc công việc/đoạn kết/kết luận/phần kết
敬而远之=kính nhi viễn chi/đứng xa mà trông/tôn kính mà không thể gần gũi/kính trọng nhưng không gần gũi/kính sợ tránh xa
族规=tộc quy/gia quy/gia pháp
暗=ám/ngầm/tối/ngu muội/thầm
枝头=đầu cành/đầu cành cây
某甲=mỗ giáp/một con giáp/một số cá nhân
正儿八经=đường đường chính chính/chính nhi bát kinh/đường hoàng ra dáng
母爱=tình thương của mẹ/lòng mẹ thương con/mẫu ái/tình mẹ
母系=mẫu hệ/phía bên mẹ/dòng họ bên mẹ
波霸=sóng bá/Boba/Ba Bá/quả bóng khoai mì, trong 波霸 奶茶 [bo1 ba4 nai3 cha2]
烟袋=tẩu thuốc/tẩu hút thuốc
父老=phụ lão/bô lão/cụ già
称誉=ca ngợi/tán dương/ca tụng
第七=thứ bảy/đệ thất
第七根=đệ thất cây/cây thứ bảy
第六根=cây thứ sáu/đệ lục cây
综合=tổng hợp/tổng hợp lại/hệ thống lại
综计=tổng cộng/cộng lại
老家=quê quán/lão gia/quê nhà/nguyên quán/quê
老猫=mèo già/lão Miêu
老翁=lão ông/lão Ông
联姻=thông gia/quan hệ thông gia/đám hỏi
范文=bài văn mẫu/bài làm mẫu/bài mẫu
草芥=cỏ rác/cọng rơm cái rác/chuyện vặt/chuyện nhỏ/cái rơm cái rác/rơm rác/cái cỏ cái rơm/đồ nhỏ nhặt, vặt vãnh, vô giá trị
萌妹=manh muội/gái loly
蒙昧主义=chủ nghĩa mông muội/chính sách ngu dân
行走于=hành tẩu ở/đi lại ở
规范=quy phạm/quy tắc/kiểu mẫu/nề nếp/tiêu chuẩn/chuẩn mực/khuôn phép/hợp quy tắc/hợp với quy tắc/hợp quy phạm
誉为=ca tụng là/vinh dự
调味=gia vị/điều vị
逃之夭夭=bỏ trốn mất dạng/trốn chạy/bỏ trốn/tẩu thoát/mất dạng/đào chi yêu yêu/chạy mất dép
遗体=di thể/di hài/xác
那管家=Quản gia kia/quản gia kia
霸道=bá đạo/độc tài/chuyên chế/quân phiệt/dùng sức mạnh để trị/ngang ngược/hỗn xược/Bá Đạo
高师弟=Cao sư đệ/Cao  sư đệ
黄口小儿=hoàng khẩu tiểu nhi/trẻ em/trẻ con/con nít/mồm còn hôi sữa/nhóc con miệng còn hôi sữa
主持者=người chủ trì/kẻ chủ trì
大男子主义者=người đại nam tử chủ nghĩa/người theo chủ nghĩa sô vanh nam
套儿=sáo nhi/vòng dây
家居=ở không/ở nhà chơi rông/gia cư
尊尚=ủng hộ/tán thành/chủ trương
总服务台=quầy tổng phục vụ/bàn dịch vụ tổng thể
拇=mẫu/ngón cái
拘管=quản thúc/quản chế/câu thúc
拥军优属=ủng hộ bộ đội/ưu đãi gia đình quân nhân cách mạng
民谣=dân dao/ca dao dân gian/ca dao
筑堤=đắp bờ/đắp đê/gia cố đê
续约=gia hạn hợp đồng/Gia hạn khế ước
走背字=xui xẻo/tẩu bối tự
迷走神经=thần kinh phế vị/thần kinh mê tẩu
遗留下=lưu lại/để lại/di lưu lại
丁冬=leng keng/leng ca leng keng/lẻng kẻng
东道主=chủ nhà/chủ tiệc/chủ
中继线=đường dây điện thoại trung chuyển/tổng đài
主战派=phe chủ chiến/phái chiến tranh chính/diều hâu
乳娘=nhũ mẫu/vú nuôi
叔公=thúc công/ông chú
同根而生=đồng căn nhi sinh/đồng căn nhi sinh
吕千总=Lữ Thiên tổng/Lữ thiên tổng
大男子主义=đại nam tử chủ nghĩa/chủ nghĩa đàn ông lớn/chủ nghĩa sô vanh nam
字母=chữ cái/chữ/chữ chỉ thanh mẫu/phụ âm
弟兄=huynh đệ/anh em/em trai và anh trai
战歌=hành khúc/khúc quân hành/nhạc chiến đấu/chiến ca
拔高=cất cao/nâng cao/giương cao/ngẩng/ngước lên/kéo lên/tâng bốc/đề cao/cố ý đề cao/ca tụng quá đáng/xuất chúng/xuất sắc hơn người/đỉnh điểm/người vượt trội
数亩=vài mẫu/sổ mẫu
星期=tuần lễ/ngày thứ/chủ nhật
法帖=bản dập/bản in chữ mẫu
烟管=tẩu thuốc/ống khói
班长=ban trưởng/lớp trưởng/trưởng lớp/tiểu đội trưởng/chủ kỹ viện/tú bà
累计=tính gộp lại/luy kế/tính tổng cộng/tính gộp/gộp lại để tính toán
老头儿=lão đầu nhi/ông già/ông lão
老妈子=lão mụ tử/mụ già
老朋友=lão bằng hữu/bằng hữu cũ/bạn cũ

话事人=người nói chuyện/người làm chủ
轰然而散=ầm vang mà tán/oanh nhiên nhi tán
迁徙=di chuyển/đổi dời/thiên tỷ
遁入空门=xuất gia/đi tu
龙头老大=long đầu lão đại/ông trùm
万亿=vạn ức/ngàn tỷ/ngàn tỉ
三爷=Tam gia/tam gia
个案=hồ sơ/vụ án đặc biệt/án đặc biệt/ca/vụ kiện/trường hợp cá biệt
中军=trung quân/chủ soái
主业=nghề chính/chủ nghiệp
主力=chủ lực/lực lượng chính
主办=chủ sự/người chịu trách nhiệm chính/người đứng ra tổ chức/làm chủ
主持公道=chủ trì công đạo/giữ gìn lẽ phải
主脑=chủ não/đầu não/chủ chốt/bộ phận quan trọng nhất/thủ lĩnh/đầu sỏ
义姐=nghĩa tỷ/chị nuôi/chị kết nghĩa
争霸=tranh bá/tranh phách
五子棋=cờ ca rô/cờ năm quân/cờ Liên Châu ( cờ Renju)
五花八门=đủ loại/đa dạng/loè loẹt/đủ mẫu mã/xốc xếch
亲家=thân gia/thông gia/sui gia/ông bà thông gia/ông bà sui gia
亲家母=bà thông gia/bà sui gia
亲戚=thân thích/thông gia
传诵=truyền tụng/ca tụng
作家=tác gia/tác giả/nhà văn
俚歌=dân ca/lý ca/câu hát quê kệch của người nhà quê hát
儿歌=nhạc thiếu nhi/nhạc trẻ em/bài hát cho thiếu nhi/bài hát nhi đồng
儿童=nhi đồng/thiếu nhi/trẻ em
儿童片=phim thiếu nhi/Phim dành cho thiếu nhi
兆里=tỷ dặm/ngàn tỉ dặm
光束=chùm sáng/chùm tia sáng/chùm ánh sáng/quang thúc
公畜=con đực/con giống/gia súc giống
冤大头=oan đại đầu/coi tiền như rác/công tử Bạc Liêu/người tiêu tiền như nước
冲动=xúc động/xung động/kích thích/thúc đẩy/phát động/thôi thúc/bị kích thích/bị kích động/khởi động/xung lực/sôi nổi/quá xúc động/kích động
凡百=tổng quát/dù sao cũng/dù sao đi nữa
凤姐=Phượng tỷ/Phượng tả
剧作家=kịch gia/nhà soạn kịch/người viết kịch
加大=tăng lớn/gia tăng
可贵=đáng ngưỡng mộ/đáng quý/đáng phục/đáng ca tụng/đáng hâm mộ
善主=thiện chủ/thằng lương thiện
因地制宜=nhập gia tuỳ tục/vận dụng sao cho phù hợp từng nơi
国家队=đội tuyển quốc gia/quốc gia đội
填表=điền đơn/điền vào mẫu đơn/điền vào một biểu mẫu
声母=thanh mẫu/phụ âm
大主教=đại chủ giáo/tổng giám mục/đại giáo chủ
夫家=nhà chồng/phu gia/phu gia (nhà chồng)
女娃儿=nữ oa nhi/bé gái/bé con
好人好事=người tốt việc tốt/những người tốt và những điều tốt đẹp/những con người đáng khâm phục và những việc làm gương mẫu
如弟=như đệ/em kết nghĩa
姐夫=tỷ phu/anh rể
子儿=hạt bụi/tử nhi
安土重迁=ấm chỗ ngại dời/đã quen ở một nơi, không thích hay ngại di chuyển đến chỗ khác/không muốn rời quê cha đất tổ
家徒四壁=nhà chỉ có bốn bức tường/gia cảnh quá nghèo/nghèo rớt mồng tơi
家禽=gia cầm/gà vịt ngang ngỗng/giống chim nuôi trong nhà
宿儒=bậc túc nho/túc nho/học trò lão luyện
寄母=mẹ nuôi/mẹ đỡ đầu/nghĩa mẫu
工作母机=máy cái/máy chính/máy chủ/máy phục vụ
市电=điện sinh hoạt/điện gia dụng
带徒弟=dạy đồ đệ/truyền nghề/dạy học trò
幼儿=trẻ nhỏ/trẻ em/trẻ sơ sinh/ấu nhi
弟妹=đệ muội/em trai em gái/em dâu
弟子=đệ tử/đồ đệ/học sinh
怡人=thoải mái/di nhân
总价=tổng giá trị/giá tổng cộng
总兵=tổng binh/thống lĩnh quân đội/thống soái/nguyên soái/Tổng binh
总纲=tổng cương/quy tắc chung/nguyên tắc chung/cương lĩnh chung
恋家=nhớ nhà/lưu luyến gia đình/không muốn rời xa gia đình
我国=nước ta/quốc gia của ta/nước tôi
抄家=xét nhà/tịch biên/tịch thu tài sản/tịch biên gia sản
抽取=rút ra/lấy mẫu/lấy ra
拢共=tổng cộng/cộng lại/cộng tất cả
插手=nhúng tay/chen tay vào/tham gia
施事=người thực hiện/chủ thể phát ra động tác
朝奉=nhà giàu/quan triều phụng/kẻ có của/quản gia/quan triều phụng
某家=mỗ gia/nhà ta/nhà nào đó
某某=mỗ mỗ/một cái gì đó/so-và-như vậy
标兵=tiêu binh/đội quân danh dự/gương mẫu/mẫu/gương/cá nhân tiên tiến/đơn vị kiểu mẫu
榆木脑袋=đầu gỗ/đầu du mộc/Cây du chuyên dùng để bó củi/chế tạo gia cụ/cực kỳ dẻo dai cứng cỏi/để nói người ngoan cố/không chịu thông suốt.
母龙=mẫu long/rồng cái
比武=luận võ/đấu võ/tỷ võ
江总=chủ tịch Giang/Giang tổng
汽艇=ca-nô/canô
泰水=nhạc mẫu/mẹ vợ
混蒙=lừa gạt/lừa dối/hỗn độn/mông muội
王法=vương pháp/phép vua/chủ trương chính sách của nhà nước/chính sách pháp lệnh
由小而大=tích tiểu thành đại/do tiểu nhi đại
白千总=Bạch Thiên tổng/Bạch thiên tổng
白头偕老=bạch đầu giai lão/đầu bạc răng long/chung sống hoà hợp/bên nhau hạnh phúc đến già/bạc đầu giai lão
省长=tỉnh trưởng/chủ tịch tỉnh/Tỉnh trưởng
眩晕=mê muội/chóng mặt/bị choáng/hôn mê
督抚=đốc phủ/tổng đốc và tuần phủ
第一回=lần thứ nhất/đệ nhất hồi/hồi thứ nhất
第一桶金=món tiền đầu tiên/đệ nhất dũng kim
第一级=bậc thứ nhất/đệ nhất cấp
第一部=bộ thứ nhất/đệ nhất bộ
第七名=hạng bảy/đệ thất danh/người thứ bảy
第三篇=thiên thứ ba/đệ tam thiên/trang thứ ba
第二件=kiện thứ hai/đệ nhị kiện/cái thứ hai
管事=quản sự/quản lý sự vụ/quản lý công việc nội bộ/hiệu nghiệm/có công dụng/có kết quả/có tác dụng/người quản lý/quản gia
约束=ước thúc/ràng buộc/trói buộc
纨绔们=đám công tử bột/các hoàn khố
纵观=nhìn chung/nhìn tổng quát
终点=điểm cuối/điểm cuối cùng/tới hạn/điểm kết thúc/điểm cuối
老三=lão tam/lão Tam
老三样=ba cái thứ kinh điển/lão tam
老兄=lão huynh/anh bạn/ông anh
老娘=lão nương/mẹ già/mẹ già này/gái già này/già này/bà đỡ đẻ ngày xưa/bà ngoại
老曾=Lão Tăng/lão Tằng
老板娘=lão bản nương/bà chủ/bà chủ
老林=rừng già/lão lâm/rừng hoang/rừng nguyên thuỷ/rừng nguyên sinh
老汤=lão Thang/nước luộc/nước dưa cũ
老泪纵横=nước mắt tuôn đầy mặt/lão lệ tung hoành
老狐狸=lão hồ ly/cáo già
老顽固=lão ngoan cố/người bảo thủ
而立之年=tuổi xây dựng sự nghiệp/nhi lập chi niên
花呢=hoa đây/vải len sọc/dạ hoa/vải len ca-rô
蒙千总=Mông Thiên tổng/Mông thiên tổng
话题=chủ đề/trọng tâm câu chuyện/đề tài/đầu đề câu chuyện
赢家=bên thắng/người thắng/Doanh gia
赶跑=cưỡng chế di dời/ép di chuyển/đuổi đi/sa thải/thải hồi/tống cổ/đuổi cổ
跨国公司=công ty đa quốc gia/công ty xuyên quốc gia
达卡=Đa-ca/Dacca/Đaca
近代=cận đại/thời đại tư bản chủ nghĩa
通俗歌曲=bài hát phổ biến/bài hát phổ thông/ca nhạc phổ thông
遗书=di thư/tác phẩm của người trước để lại/thư/thư từ của người chết để lại/sách bị thất lạc
遗志=di chí/chí nguyện của người đã chết
遗腹子=di phúc tử/con mồ côi từ trong bụng mẹ/mồ côi từ trong bụng mẹ
遗言=di ngôn/lời trăng trối
酵母=men/con men/diếu mẫu
阔少=cậu ấm/con nhà giàu/công tử bột
阿姨们=đám a di/các a di
附加=kèm theo/phụ gia/phụ thêm/thêm/phụ
高飞远走=cao phi viễn tẩu/cao bay xa chạy
鼓盆而歌=vỗ bồn mà ca/chậu trống và hát
一主=một chủ/nhất chủ
一国=một nước/một quốc/một quốc gia
一国之主=một nước chi chủ/nhất quốc chi chủ
一塌刮子=tất cả/tổng cộng/gộp chung lại
一家之主=nhất gia chi chủ/đứng đầu một nhà/chủ nhân một gia đình
一家之长=nhất gia chi trưởng/nhất gia chi trường
一揽子=tổng quát/hàng loạt/cả gói
一搓=nhất chà xát/chà một cái/xoa một cái

三代=đời thứ ba/ba đời/tam đại/đệ tam
三姓家奴=gia nô ba họ

上座率=tỉ lệ ngồi/tỷ lệ chỗ ngồi trên
上架=lên khung/lên giá/vào VIP/chưng bày/lên khung (vào VIP)
上移=đi lên/di chuyển lên
下奶=xuống sữa/thúc sữa/cho sữa vào
下操=ra thao trường/tập luyện/kết thúc buổi luyện tập/hết giờ tập/tập luyện xong
不娶=không cưới/không lập gia đình
不拘一格=không bám vào một khuôn mẫu/không hạn chế một kiểu
不易之论=không đổi lời/lời chính xác/lời bất hủ/lời bất di bất dịch
不甘寂寞=không chịu cô đơn/muốn tham gia vào/người không chịu nhàn rỗi/không muốn làm người ngoài cuộc
不胫而走=lan truyền nhanh chóng/bất hĩnh nhi tẩu/lan nhanh/không chân mà chạy
不谋而合=không mưu mà hợp/không hẹn mà nên/tình cờ trùng hợp/không bàn mà trùng ý/bất mưu nhi hợp
不足为训=không phải một ví dụ để theo/không đáng làm gương/không mẫu mực
不辨菽麦=không phân biệt lúa đậu/chẳng biết ngô khoai gì cả/thiếu thực tế/ngu/ngu muội/không phân biệt được đậu với lúa mạch/thiếu kiến thức thực tế
世家子弟=con em thế gia/con cháu thế gia/con cháu thế gia
世父=thế phụ/bá phụ/bác cả/bác ruột
东家=đông gia/ông chủ/chủ nhân/chủ/Đông gia
东家长西家短=đông gia dài tây gia ngắn/nói chuyện phiếm
东道=chủ nhà/chủ/nghĩa vụ/nhiệm vụ
东道国=nước chủ nhà/nước đăng cai
丧权辱国=nhục nước mất chủ quyền/nhục mất nước
个人主义=cá nhân chủ nghĩa/chủ nghĩa cá nhân
中央空调=trung ương điều hòa/điều hòa không khí trung tâm/Nghĩa gốc là điều hòa tổng
中立国=nước trung lập/trung lập/quốc gia trung lập
串讲=phân tích câu/giải thích ý bài theo câu theo chữ/giảng xuyên suốt bài/tổng kết/giảng khái quát
临阵=lâm trận/tham gia chiến đấu
为主=làm chủ/là việc chính/là chủ yếu/là chúa/là chủ/vì chủ
主事=chủ sự/việc chính/việc chủ quản
主事人=người chủ sự/chủ nhân
主人=chủ nhân/chủ/người chủ/ông chủ/chủ sở hữu
主公=chúa công/chủ công
主刀=mổ chính/bác sĩ mổ chính/chủ đạo
主力军=quân chủ lực/lực lượng chính/đội quân chủ lực
主君=chủ quân/Quận chúa
主坐=chủ toạ/Chủ mưu/chủ phạm. § Cũng nói là chủ nhi 主兒. ◇Thủy hử truyện 水滸傳: Từ Ninh thính bãi/tâm trung tưởng đạo: Kí hữu chủ tọa/tất bất ngại sự 徐寧聽罷/心中想道: 既有 主坐/必不礙事
主妇=bà chủ/bà chủ nhà/chủ phụ
主掌=chủ chưởng/nắm giữ
主攻=chủ công/mũi tiến công chính
主机=máy chủ/trưởng máy/máy bay dẫn đầu/máy chính/chủ cơ
主楼=lầu chính/chủ lâu
主治大夫=chủ trị đại phu/bác sĩ phụ trách
主笔=chủ bút/tổng biên tập
主编=chủ biên/tổng biên tập/chủ bút
主要=chủ yếu/chính
主讲=chủ giảng/giảng chính
主调=chủ điều/giai điệu chính/một quan điểm chính
主谋=chủ mưu/kẻ chủ mưu
主题歌=ca khúc chủ đề/ca khúc chính
举家=cả nhà/cả gia đình
久别=cửu biệt/xa cách từ lâu/xa cách từ lâu/xa cách
久而久之=dần dà/cửu nhi cửu chi/lâu ngày/lâu dần
之主=chi chủ/đứng đầu/Chi Chủ
之国=chi quốc/quốc gia
九爷=cửu gia/Cửu gia
乡巴佬=nhà quê/Hai lúa/hương ba lão
书法家=nhà thư pháp/thư pháp gia
买卖人=thương gia/người buôn bán/dân buôn bán
了断=kết thúc/chấm dứt/đoạn
争雄=tranh hùng/giành thế chủ động
二世=hai thế/đệ nhị/hai đời/đời thứ hai

交换机=tổng đài/Switch/tổng đài điện thoại
亲哥=anh ruột/thân ca
亲如一家=thân như một nhà/thân thiết như một gia đình/mối quan hệ thân thiết như gia đình
亲姐姐=thân tỷ tỷ/chị gái ruột
亲母=thân mẫu/mẹ đẻ
亲生女儿=con gái ruột/nữ nhi ruột thịt
亲眷=thân quyến/thân thiết/thân thích/họ hàng/thân thuộc/gia quyến
人参=nhân sâm/sâm/người tham gia
仇家=cừu gia/kẻ thù/địch thủ/Cừu gia
介入=tham gia/can dự/can dự vào/dính vào/can thiệp vào/nhúng tay vào
从长计议=bàn bạc kỹ hơn/tính việc lâu dài/bàn bạc thong thả/suy nghĩ kỹ hơn rồi bàn sau/bàn bạc kỹ càng
仙家=Tiên gia
任城主=đảm nhiệm thành chủ/Nhâm thành chủ

仿办=làm theo/làm theo mẫu
会亲=sẽ tự thân/thông gia gặp nhau
会动=sẽ động/biết di động
传播=truyền bá/truyền/phổ biến/toả/chiếu/phát/công bố/ban hành
伤亡率=tỷ số thương vong/tỉ lệ thương vong
伯仲=sàn sàn nhau/sàn sàn như nhau/cùng lứa/cùng cỡ/sàn sàn/cỡ nhau/như nhau/bá trọng
伯伯=bá bá/bác trai/bác
伯母=bá mẫu/bác gái
伯爵夫人=bá tước phu nhân/nữ bá tước
伯爵府=phủ Bá tước/phủ bá tước
伯祖=bá tổ/ông bác
伺机而动=tuỳ thời mà động/di chuyển theo thời gian
低能儿=trẻ đần độn/trẻ kém phát triển/đê năng nhi
何德何能=có tài đức gì/hà đức hà năng/có tài cán gì
佛主=Phật chủ/phật tổ
佛号=phật hiệu/a-di-đà phật
作东=làm chủ/chủ bữa tiệc/làm chủ tiệc
作主=làm chủ/tác chủ/quyết định/phân xử/giải quyết
你姐=tỷ ngươi/chị của ngươi/chị ngươi
佳儿佳妇=con thảo dâu hiền/giai phụ giai nhi
侄儿=chất nhi/cháu
例如=tỷ như/ví dụ/thí dụ/ví như
便餐=món thường/món đơn giản/bữa ăn gia đình/bữa cơm gia đình
促迫=thúc bách/cấp bách
俏头=gia vị/chỗ lí thú
保姆=bảo mẫu/vú em/nữ giúp việc/cô người làm/cô bảo mẫu/cô nuôi dạy trẻ/bảo mỗ
倒班=thay ca/đổi ca

债主=chủ nợ/người cho vay
值夜班=trực ca đêm/trực đêm
偕老=giai lão/vợ chồng cùng nhau chung sống đến già
傢伙=gia hoả/cái thứ/con/lão này/Gia hỏa/các đồ dùng trong nhà/anh chàng
催=thúc/thôi/thúc dục/thúc giục
催促=thúc giục/giục/thúc/đẩy nhanh
催熟=thúc/dú/làm cho chín muồi/làm cho chín chắn/dú
催青=thúc động dục/kích dục/thúc trứng tằm nở sớm/xuân hoá
儒家=nho gia/nhà nho
儿上=bên trên/nhi thượng
儿女=nhi nữ/nữ nhân/con cái/con cháu/con/những người con/nam nữ/trai gái/con gái
儿童医院=bệnh viện nhi/bệnh viện nhi đồng/Bệnh viện Nhi đồng/Bệnh viện nhi đồng
允儿=Doãn nhi/Yoona
元老会=nguyên lão hội/Nguyên Lão Hội
元老院=nguyên lão viện/để các bực già cả tôn trọng dự vào bàn việc nước
兄弟=huynh đệ/anh và em/em trai/chú em/cậu em/người anh em/anh em
兄弟阋墙=huynh đệ bất hòa/nội bộ bất hoà/anh em trong nhà cãi cọ nhau
先入为主=vào trước là chủ/ấn tượng ban đầu giữ vai trò chủ đạo
先生=tiên sinh/thầy/thầy giáo/ngài/chồng/thầy thuốc/ông lang/thầy ký/tài phú/thầy bói
光景=quang cảnh/khoảng chừng/hoàn cảnh/tình cảnh/tình trạng/gia cảnh/có thể/có lẽ/có nhẽ/khoảng/ước chừng
克己奉公=đặt quyền lợi chung lên quyền lợi riêng/khắc phục chủ nghĩa cá nhân, phụng sự công ích/đặt lợi ích tập thể lên trên lợi ích cá nhân
全国运动会=đại hội thể dục thể thao toàn quốc/Đại hội Thể thao Quốc gia/Đại hội thể dục thể thao toàn quốc
全家=cả nhà/toàn gia/cả gia đình
八只=tám con/tám cái
八哥=chim sáo/Bát ca

公主=công chúa/công chủ
公子哥儿=công tử ca nhi/cậu ấm/công tử bột/con ông cháu cha/công tử
六畜=lục súc/gia súc
共=chung/tổng
关键=mấu chốt/then chốt/điều quan trọng/nhân tố quyết định/chủ yếu/chính yếu/quan trọng
典试=chấm thi/chủ trì việc thi cử
养家活口=nuôi dưỡng gia đình/nuôi sống gia đình/để hỗ trợ gia đình của một người
养老金=hưu bổng/lương hưu/tiền trợ cấp dưỡng lão/tiền dưỡng lão
养虎遗患=dưỡng hổ di hoạn/nuôi ong tay áo, nuôi cáo trong nhà/chơi với chó, chó liếm mặt
内弟=em vợ/nội đệ
内海=nội hải/biển trong đất liền/biển lục địa/hải phận/vùng biển chủ quyền
冒险主义=chủ nghĩa mạo hiểm/chủ nghĩa phiêu lưu
军国主义=chủ nghĩa quân phiệt/chủ nghĩa phát-xít
冰玉=băng ngọc/Băng Ngọc/Tỉ dụ nhân phẩm cao khiết hoặc sự vật trong sạch.Nói tắt của băng thanh ngọc nhuận 冰清玉潤: gọi thay cha vợ và chàng rể.Tỉ dụ cha và con.Hình dung trơn sạch bóng láng. ◇Nguyên sử 元史: Nhan diện như băng ngọc/nhi thần như ác đan nhiên 顏面如冰玉/而脣如渥丹然
凑热闹=tham gia náo nhiệt/vô giúp vui/tham gia trò vui
凝视=nhìn chăm chú/ngưng thị/ngưng mắt nhìn/nhìn chằm chằm/đưa mắt nhìn/nhìn chăm chú
凡夫俗子=phàm phu tục tử/người thường/tín đồ Thiên chúa giáo La Mã không chịu tham gia các buổi lễ của giáo hội Anh như luật pháp quy định trước kia
出家=xuất gia/đi tu
分争=phân tranh/tranh luận/bàn cãi/tranh bá
分家=phân gia/tách ra/ở riêng/ra ở riêng/một mình/phân chia/rời ra

利己主义者=người theo chủ nghĩa lợi kỷ/những người ích kỷ
刺儿头=thứ nhi đầu/đồ ba gai/đồ hay sinh sự/đồ sinh sự
副主编=phó chủ biên/Phó Tổng biên tập
副总经理=phó tổng quản lý/Phó tổng kinh lý
副总裁=phó tổng giám đốc/Phó tổng tài
劝农=khuyến nông/thúc đẩy nông nghiệp
功高盖主=công cao lấn chúa/công cao cái chủ/công cao chấn chủ
加人一等=gia nhân nhất đẳng/hơn người một bực
加以=tiến hành/gia dĩ/hơn nữa/thêm nữa/lại thêm/tăng thêm/thêm vào đó/hơn nữa
加值=gia trị/point
加元=gia nguyên/đô la Canada
加入=gia nhập/thêm vào/thêm/tham gia/gia nhập vào
加农炮=pháo/đại bác/súng ca-nông/gia nông pháo
加加=gia gia/Gaga
加压=tăng áp lực/tăng sức ép/gây áp lực/gia áp
加官=gia quan/thăng chức/lên chức/thăng quan tiến chức/kiêm nhiệm/kiêm thêm/gia/thăng quan
加官晋爵=thăng quan tiến chức/gia quan tấn tước/phong cho một chức danh một vị trí chính thức
加密=mã hóa/mã hoá/làm chặt hơn/gia mật
加封=gia phong/dán niêm phong
加班=tăng ca/thêm ca/làm thêm giờ
加紧=gấp rút/gia tăng/khẩn trương/tăng cường/cố gắng
加老=Gia lão
加薪=tăng lương/lên lương/gia tân
加速=gia tốc/tăng tốc/tăng tốc độ/tăng nhanh
加速器=máy gia tốc/máy tăng tốc/gia tốc khí
加速度=tăng tốc độ/gia tốc
加长=dài hơn/lâu hơn/dài thêm/gia trưởng
动如脱兔=nhanh nhẹn như thỏ/di chuyển như thoát thỏ
动脉弓=động mạch chủ vòng cung/cung động mạch chủ
劳模=nhân viên gương mẫu/chiến sĩ thi đua/công nhân gương mẫu
勇气可嘉=can đảm lắm/dũng khí khả gia
包工=làm khoán/thầu/chủ thầu/bao công
包菜=cải bắp/bắp cải/gói thức ăn/bắp cải
医家=y gia/thầy thuốc
医闹=y nháo/y học náo loạn/có tổ chức gây rối các cơ sở chăm sóc sức khỏe hoặc lạm dụng bằng lời nói và thể chất đối với nhân viên y tế, bởi một bệnh nhân bị hại hoặc những người ủy thác như thành viên gia đình hoặc côn đồ được thuê, thường nhằm mục đích đòi bồi thường


升值=tăng gia trị/tăng tỉ giá đồng bạc
半死=gần chết/bị giày vò/chết khiếp/nửa chết
半路出家=giữa đường xuất gia/thay đổi giữa chừng/đổi nghề giữa chừng/nửa chừng xuất gia

卖呆=đứng đờ người ra/ngây ra/dự vui/tham gia cuộc vui
卢卡申科=Lukashenko/Aleksandr Grigoryevich Lukachenko, tổng thống Belarus từ năm 1994

原型=nguyên hình/nguyên mẫu/mẫu đầu tiên/mô hình vốn có
参军=tham quân/tòng quân/tham gia quân đội/đi bộ đội/đi lính/vô lính/đầu quân
参合=tham gia/đúc kết/tham khảo tổng hợp
参演=tham diễn/tham gia
参知政事=tham gia chính sự/tham gia chính sự
参预=tham dự/dự cuộc/tham gia
及第=cập đệ/thi đậu/thi đỗ/đỗ đạt
反客为主=đảo khách thành chủ/bị động trở thành chủ động/đổi khách làm chủ
反比=phát triển trái ngược/trái ngược/tỷ lệ nghịch
反比例=tỷ lệ nghịch/phản tỷ lệ
反特=phản gián/chống đặc biệt/tham gia vào hoạt động phản gián
反霸=chống lại chủ nghĩa bá quyền/chống bá quyền/thanh toán tội ác của địa chủ ác bá
发展中国家=quốc gia đang phát triển/nước đang phát triển
叔伯=thúc bá/chú bác
叔叔=thúc thúc/chú
叔祖=thúc tổ/ông chú
叠加=điệp gia/chồng/chồng lên/chồng chất
古国=cổ quốc/quốc gia cổ/nước có lịch sử lâu đời
叫绝=tán dương/ca ngợi/khiếu tuyệt
可可=nhưng có thể/ca-cao/cây ca-cao/bột ca-cao/nước ca-cao
叹羡=hâm mộ/ca ngợi và hâm mộ
各帮=các bang/các bang
合共=tổng cộng/gộp chung
合唱=hợp xướng/đồng ca/hợp ca
合成纤维=sợi nhân tạo/sợi tổng hợp
合计=tổng cộng/bàn bạc/hợp kế/cộng lại/tính gộp lại/[hé·ji]/tính toán/lo toan/dự kiến/trù tính/lo/thương lượng/thảo luận
吉光片羽=mảnh da Cát Quang/di sản văn hoá quý giá/quý giá
同宗=đồng tông/cùng gia tộc/cùng dòng họ
同室操戈=gà nhà bôi mặt đá nhau/huynh đệ tương tàn/nồi da nấu thịt
同工异曲=cách làm khác nhau, kết quả như nhau/ca khúc khác nhau, diễn xuất giống nhau
名家=danh gia/học giả tiếng tăm
后娘=mẹ kế/kế mẫu/mẹ ghẻ/dì ghẻ
君主=quân chủ/vua
君主政体=chế độ quân chủ/chuyên quyền

命意=xác định chủ đề/hàm ý/ngụ ý
和会=hoà hội/hội nghị hoà bình kết thúc chiến tranh
和平主义=chủ nghĩa hoà bình/chủ nghĩa hòa bình
咦=a/ồ/di
哥们=ca môn/anh em/bạn thân/anh chàng
哪个=cái nào/cái kia/người nào/nào/ai/cái nào/cái này/này
哲学家=triết học gia/nhà triết học
唯名论=duy danh luận/thuyết duy danh/chủ nghĩa duy danh
唯心论=chủ nghĩa duy tâm/thuyết duy tâm
唰=bá/vù
唱反调=làm trái lại/hát ngược giọng/làm ngược lại/chủ trương ngược lại
商场=cửa hàng/thương trường/thị trường/cửa hàng tổng hợp
啥=cái gì/gì/cái đó
善门=thiện môn/gia đình nhân đức
喊价=kêu giá/gọi giá
嘉尚=tán dương/ca ngợi/ca tụng
器件=linh kiện chủ chốt/linh kiện chính
噶伦=ca-luân/caluân
噶厦=ca-xi-a/caxia
嚣张=phách lối/hung hăng càn quấy/kiêu ngạo/hung hăng càn quấy/hung hăng
四世=bốn đời/đệ tứ


四海之内皆兄弟=tứ hải giai huynh đệ/trong bốn biển đều là huynh đệ/Anh em bốn biển một nhà
四海之内皆兄弟也=tứ hải giai huynh đệ/anh em bốn bể một nhà
回游=bơi về/hồi du/cá biển di chuyển trở về/di cư
回目=chủ đề/tiêu đề/nội dung chính
困束=trói buộc/khốn thúc
国产手机=điện thoại hàng nội địa/điện thoại di động trong nước/Điện thoại di động trong nước sx
国仇=quốc thù/thù nước/mối thù của quốc gia
国力=quốc lực/thực lực của một nước/thực lực quốc gia/sức mạnh quốc gia
国境=quốc cảnh/lãnh thổ một nước/địa hạt/địa phận một nước/phạm vi lãnh thổ thuộc chủ quyền một nước/biên giới/biên giới quốc gia
国宝=quốc bảo/bảo vật quốc gia/vật báu/báu vật
国家主义=chủ nghĩa quốc gia/chủ nghĩa dân tộc
国家机关=cơ quan nhà nước/cơ quan nhà nước cao nhất/cơ quan quốc gia
国家级=quốc gia cấp/cấp quốc gia
国是=việc lớn quốc gia/kế lớn của đất nước/quốc là
国运=quốc vận/vận mệnh quốc gia/tương lai đất nước/vận nước
图纸=bản vẽ/giấy đã vẽ bản mẫu
圆熟=thuần thục/thành thục/thành thạo/lão luyện/linh hoạt/viên thục
土家=Thổ gia
土老冒=thổ lão mạo/vẻ quê mùa
圣歌=Thánh ca
圣母=Thánh mẫu/đức mẹ Ma-ri-a/đức mẹ
在业=làm việc/tham gia công tác
地主之谊=chủ nhà tình nghĩa/người chủ địa phương
地主家=nhà địa chủ/địa chủ gia/nhà chủ nhà
地老天荒=địa lão thiên hoang/dài đằng đẵng/dài dằng dặc
坎儿=khảm nhi/mấu chốt, điểm quyết định/thời điểm quan trọng/điểm chính/phần cốt yếu/cương trực/tiếng lóng/biệt ngữ/khẩu hiệu/khẩu lệnh/mật mã
坏主意=chủ ý xấu/ý đồ xấu
坐班=ca trực/làm việc đúng giờ/trực ban/tọa ban
坛坛罐罐=xoong chảo chum vại/nồi niêu chum vại/dụng cụ gia đình
坤道=khôn đạo/Cách ăn ở của người đàn bà. Khôn đạo: Đạo quẻ Khôn, Phụ nữ theo về Khôn đạo, do câu Khôn vi mẫu, cũng như đàn ông theo về Kiền đạo, do câu Kiền vi phu. » Này con gái thuộc về Khôn đạo. Khôn đức nhu nết gái dịu dàng «
基址=nền/di tích/tàn tích
基干=cốt cán/cơ sở/nền tảng/cán bộ chủ chốt/cán bộ cốt cán
基干民兵=dân quân chủ lực/dân quân Kigan
基本=cơ bản/căn bản/nền tảng/chính/chủ yếu/cốt lõi/đại thể
基调=nhạc dạo/tư tưởng chính/quan điểm cơ bản/quan điểm chủ yếu/cơ điều
堂兄弟=đường huynh đệ/anh em họ
堤坝=đê đập/đê điều/đê bá
增产=tăng gia sản xuất/tăng sản lượng/tăng sản
增加=gia tăng/tăng/tăng thêm/tăng lên/tăng cường
夏威夷果=quả mắc-ca/trái cây Hawaii/Macadamia
外姑=ngoại cô/Mẹ vợ. Như Nhạc mẫu.
多亿=nhiều ức/nhiều tỷ/hơn trăm triệu
夜总会=hộp đêm/dạ tổng hội/câu lạc bộ đêm/hộp đêm
夜班=ca đêm/ca làm đêm
大人物=đại nhân vật/nhân vật nổi tiếng/người có danh vọng/người tai to mặt lớn
大人的事=đại nhân sự việc/chuyện của người lớn
大动脉=động mạch chủ/huyết mạch/đại động mạch/động mạch lớn
大叔=đại thúc/chú
大合唱=đại hợp xướng/hợp xướng/đồng ca
大哥=đại ca/anh cả/anh trưởng/anh hai/anh/ông anh
大堂哥=đại đường ca/anh Đại Sảng
大头鱼=cá vồ/cá đầu to
大姐=đại tỷ/chị cả/chị hai/chị lớn/chị/đại tả/cô ả
大姑=đại cô/dì lớn
大姓=danh gia/thế gia vọng tộc/họ quyền thế/họ lớn
大姨=đại di/dì cả/Đại di
大姨妈=đại di mụ/kinh nguyệt
大官=đại quan/ngài/tiên sinh
大家伙=đại gia hỏa/tất cả mọi người/tên to xác
大家庭=đại gia đình/gia đình lớn/cộng đồng
大尾巴狼=lão sói vẫy đuôi/sói đuôi to
大快朵颐=ăn như gió cuốn/đại khoái đóa di
大方=hào phóng/chuyên gia/học giả/chuyên môn/thành thạo/lành nghề/trong nghề/chè Đại Phương/trà Đại Phương/rộng rãi/phóng khoáng/độ lượng/nghĩa hiệp/tự nhiên/thanh thản/đứng đắn/trang nhã/nhã/nền nã/hào phóng
大族=đại tộc/họ lớn/đại gia đình
大海=biển cả/biển rộng/đại hải
大爷=đại gia/ông lớn/cụ lớn/bác
大管家=đại quản gia/tổng quản/Đại quản gia
大老婆=đại lão bà/vợ cả/vợ lớn
大院=đại viện/khu vực có nhiều hộ gia đình ở/cơ quan lớn/trụ sở lớn
天下第一=thiên hạ đệ nhất/đệ nhất thiên hạ
天主=Thiên chủ/Chúa Trời
天伦之乐=niềm vui gia đình/niềm hạnh phúc gia đình
天经地义=thiên kinh địa nghĩa/lẽ bất di bất dịch/lý lẽ chính đáng/đạo lý hiển nhiên, hai năm rõ mười
天老儿=người bị bệnh bạch tạng/người bạch tạng/Thiên lão nhi
头儿=đầu nhi/Lão đại/thủ lĩnh
头家=người thu tiền xâu/người thu xâu/nhà cái/nhà trưởng/nhà trên/cửa trên/ông chủ/người chủ
夸奖=khích lệ/khen/khen ngợi/ca ngợi/hoan nghênh
夸赞=tán dương/khen/khen ngợi/ca ngợi
女主=nữ chính/nữ chủ/nữ nhân vật chính
女主人=nữ chủ nhân/bà chủ
女儿=nữ nhi/con gái
女儿身=thân nữ nhi/thân con gái
女家=gia đình nhà gái/nhà gái
女模特=nữ người mẫu/hầu gái
奴家=nô gia/ta/em/thiếp
奴才=nô tài/gia nô/kẻ cam tâm làm tôi tớ cho người
奶妈=vú em/bà vú/nhũ mẫu
奶娘=nhũ mẫu/vú em/bà vú
奶子=cái vú/sữa/vú/vú em/bà vú/nhũ mẫu
好手=hảo thủ/người giỏi/người lành nghề/người có năng lực/người lão luyện/người có nghề/tay giỏi
好来好去=mở đầu tốt đẹp, kết thúc tốt đẹp/đầu xuôi đuôi lọt
妹夫=muội phu/em rể
妹子们=các muội tử/các em gái
姐=tỷ/tả
姐姐=tỷ tỷ/chị gái/chị họ
姑母=cô mẫu/cô/bác
姥爷家=nhà ông ngoại/mỗ gia gia
姨太太=di thái thái/vợ bé/vợ lẽ/Di thái thái
姨夫=dượng/di phu
姨奶奶=di nãi nãi/bà cô/vợ bé/vợ lẽ
姨妈=di mụ/dì
姬老=Cơ lão/Cừu lão
姻娅=quan hệ thông gia/quan hệ đồng hao
娃儿=oa nhi/Oa Nhi
婆家=nhà chồng/gia đình chồng/bên chồng/nhà bà
婶母=thẩm mẫu/thím
嫁人=lấy chồng/lập gia đình/xuất giá
嫂子=tẩu tử/chị dâu
子弟=tử đệ/con cháu/con em/lớp con em/thế hệ sau
孕畜=gia súc có chửa/gia súc mang thai
存在主义=chủ nghĩa hiện sinh/thuyết hiện sinh
孙儿=tôn nhi/Tôn nhi
孙千总=Tôn Thiên tổng/Tôn thiên tổng
学员门=các đệ tử/các học viên
学妹=học muội/niên muội
孩子=hài tử/đứa bé/trẻ con/nhi đồng/trẻ em/con nít/em bé/con cái/con
孩子头=người thích trẻ con/người thích con nít/lão ngoan đồng/trùm trẻ con/đứa trẻ cầm đầu
孩提=nhi đồng/trẻ em/tuổi thơ/thời nhỏ/thời thơ ấu
孩童=hài đồng/nhi đồng/trẻ em/trẻ con/em bé
宁爷=Trữ gia/Ninh gia
宅门=cổng lớn/cổng chính/gia đình giàu có/nhà cao cửa rộng/trạch môn
宇宙国=quốc gia vũ trụ/vũ trụ quốc
安家立业=an cư lập nghiệp/an gia lập nghiệp/An cư lập nghiệp
宋氏家族=Tống thị gia tộc/gia tộc họ Tống
完工=hoàn thành/xây xong/xong việc/hoàn công/xong/kết thúc/xong công việc/làm xong
宗主国=mẫu quốc/chính quốc
宗旨=tôn chỉ/mục đích/tông chỉ/chủ ý quy về cái gì
宗社=quốc gia/xã tắc/đất nước
宗谱=gia phả/phả hệ
官家=quan gia/quan phủ/nhà quan/triều đình/quan lại
定盘星=điểm thăng bằng/chủ kiến/chủ trương
宝贝儿子=nhi tử bảo bối/con trai bảo bối
实干家=nhà hành động/thật kiền gia
宠儿=sủng nhi/vật cưng/được mến chuộng/được ưa thích/người được yêu thích/con cưng/người được sủng ái/điều thích nhất/sủng thần/ái thiếp
宫主=cung chủ/Cung Chủ
家丑=việc xấu trong nhà/chuyện xấu trong gia đình/chuyện xấu trong nhà
家丑外扬=việc xấu trong nhà truyền ra ngoài/gia đình xấu xí
家严=gia nghiêm/bố tôi/ông cụ nhà tôi/thân sinh
家乘=chuyện nhà/nhật ký gia đình/gia phả
家人=người nhà/thành viên trong gia đình/người trong nhà/gia đình/thường dân/người bình thường/gia nhân
家什=dụng cụ/đồ dùng/gia cụ/đồ vật trong gia đình
家住=gia trụ/nhà ở
家兄=gia huynh/anh tôi
家具=đồ dùng trong nhà/gia cụ/vật dụng trong nhà
家和万事兴=gia hoà vạn sự hưng/gia hòa vạn sự hưng/gia đình và tất cả mọi thứ/nếu gia đình sống hòa thuận mọi công việc sẽ phát đạt
家园=gia viên/quê hương/gia đình/vườn nhà/cây nhà lá vườn/nhà làm
家境=gia cảnh/hoàn cảnh gia đình
家姊=gia tỷ/chị tôi
家属=gia thuộc/người nhà/người trong gia đình/thân nhân
家常便饭=chuyện thường ngày/cơm thường/cơm gia đình/chuyện thường/bình thường như cơm bữa/chuyện thường như cơm bữa
家底=vốn liếng/của cải/gia sản/gia cơ/vốn tích luỹ
家庭主妇=bà chủ gia đình/bà nội trợ/Nội trợ
家庭煮夫=ông chồng nội trợ/gia đình nấu ăn/vợ chồng
家庭环境=hoàn cảnh gia đình/môi trường gia đình
家当=gia sản/gia tài/của cải/đồ đạc trong nhà
家暴=bạo lực gia đình/gia bạo
家母=gia mẫu/mẹ tôi
家生=cuộc sống gia đình/người ở/người hầu/đầy tớ/đồ dùng trong nhà
家用=gia dụng/dùng ở nhà/đồ dùng gia đình/chi phí trong nhà
家私=gia sản/tài sản gia đình/tài sản
家系=gia hệ/thế hệ/các thế hệ trong gia đình/nhánh/chi
家计=gia kế/sinh kế của gia đình
家训=gia huấn/lời giáo huấn trong gia đình
家访=đi thăm hỏi các gia đình/viếng nhà/thăm viếng
家贼=gia tặc/ăn trộm/trộm trong nhà/gián điệp/nội gián/tặc trong nhà
家道中落=gia cảnh sa sút/gia đạo rơi xuống/đi xuống thế giới
宾主=chủ khách/khách và chủ
宿老=già lão/lão già
寄主=ký chủ/kí chủ/cây chủ/vật chủ
密斯=tiểu thư/cô
富人=người giàu có/người có tiền/địa chủ/nhà tư bản/người giàu
富得流油=giàu đến chảy mỡ/giàu có đến mức nứt đố đổ vách
寸步难移=một bước cũng không nhúc nhích được/một nửa bước khó di chuyển
对亲=kết thân/xây dựng hôn nhân/đính ước/hai gia đình gặp nhau
对决=quyết đấu/tỷ thí
将军们=các tướng quân/các tướng quân
小儿科=trò trẻ con/đồ chơi cho con nít/tiểu nhi khoa
小叔子=tiểu thúc tử/chú em (*em trai của chồng)/chú em
小哥儿=tiểu ca nhi/tiểu ca
小女儿=tiểu nữ nhi/con gái nhỏ
小姨子=cô em vợ/tiểu di tử
小孩儿=tiểu hài nhi/trẻ em/nhi đồng
小家庭=tiểu gia đình/gia đình nhỏ
小帅哥=tiểu soái ca/tiểu suất ca/anh chàng đẹp trai
小弟=tiểu đệ/em trai nhỏ/em
小弟们=các tiểu đệ/bọn tiểu đệ
小爷=ta/tiểu gia
小老儿=tiểu lão nhân/tiểu lão nhi
小说家=tiểu thuyết gia
少东家=thiếu đông gia/ông chủ nhỏ
少主=Thiếu chủ
尘埃落定=hết thảy đều kết thúc/bụi bậm lắng xuống
尽到=kết thúc/tận cùng
尾声=hồi cuối/khâu cuối cùng/vĩ thanh/kết thục/khúc hát cuối cùng/điệu kèn kết thúc vở kịch hát/khúc nhạc dạo cuối cùng trong một bài nhạc cỡ lớn/phần kết thúc/giai đoạn chót/phần cuối/kết thúc
居家=nhà ở/cư gia/ở nhà

展期=kéo dài thời hạn/gia hạn/thời hạn triển lãm/thời gian triển lãm/triển kì/khoan cho thêm hẹn nữa
展限=kéo dài kỳ hạn/gia hạn
岳家=Nhạc gia/nhạc gia/nhà bố mẹ vợ/nhạc gia
岳母=nhạc mẫu/mẹ vợ
崇尚=tôn trọng/tôn kính/chiều ý/chiều theo/biện hộ/bào chữa/chủ trương/tán thành/ủng hộ/phong thánh/giữ gìn/duy trì/tôn sùng/sùng thượng
川贝=xuyên bối/bối mẫu Tứ Xuyên
工作面=nơi làm việc/chỗ làm việc/xưởng sản xuất linh kiện/bộ phận gia công các linh kiện
巨头=cự đầu/đầu sỏ/trùm/Cự Đầu/Đầu Sỏ/bá chủ
已婚=đã kết hôn/có chồng/có gia đình
市委秘书长=thị ủy bí thư trưởng/tổng bí thư thị ủy
帅哥=soái ca/suất ca/anh chàng đẹp trai/dễ nhìn/ca đẹp trai/đẹp trai
师妹们=các sư muội/các sư muội
师弟=sư đệ/thầy và trò
师母=sư mẫu/cô
帝国主义=chủ nghĩa đế quốc/đế quốc
常任理事国=nước ủy viên thường trực/quốc gia thành viên thường trực
干练=già dặn/giỏi giang/giàu kinh nghiệm/lão luyện/kiền luyện
干预=can thiệp/can dự/tham gia/tham dự
幻人=ảo nhân/ảo thuật gia/nhà ảo thuật
广播=phát thanh/truyền phát/quảng bá
庄家=nhà cái/nhà chủ/cái/Trang gia : nhà cái/Trang gia
应考=dự thi/tham gia sát hạch
底牌=át chủ bài/con bài chưa lật/nội tình/bên trong/tình hình bên trong/lực lượng sau cùng/lực lượng cuối cùng/lá bài tẩy
店东=chủ hiệu/ông chủ
店主=chủ cửa hàng/chủ tiệm/điếm chủ/chủ quán
店老板=chủ tiệm/điếm lão bản
府邸中=trong phủ đệ/trong phủ/bên trong tòa phủ đệ
府邸里=trong phủ đệ/bên trong tòa phủ đệ
庭长=đình trưởng/chủ tọa phiên tòa/chủ toạ
建国=kiến quốc/thành lập đất nước/lập quốc/thành lập quốc gia/dựng nước/xây dựng đất nước
弃儿=khí nhi/bỏ rơi con trai
张千总=Trương Thiên tổng/Trương thiên tổng
弥天大谎=di thiên đại hoang/lời nói dối trắng trợn/nói dối thấu trời/nói dối như cuội/dóc tổ
弥留=di lưu/hấp hối/sắp chết
强求=cưỡng cầu/gò ép/khuôn mẫu/yêu cầu quá đáng
归结=quy kết/kết luận/quy/tóm lại/tổng quát/kết cục/kết thúc
归赵=quy Triệu/vật trở về chủ cũ/châu về hợp phố
当家=đương gia/quản lý việc nhà/làm nhà/quản gia
御姐=ngự tỷ/chân dài
德哥=Đức ca/Đức Ca
心儿=trái tim/Tâm nhi
怡然=vui mừng/sung sướng/di nhiên
总则=sơ lược tiểu sử/quy tắc chung/điều lệ chung/nguyên tắc chung/tổng quát quy tắc
总务=tổng vụ/hành chính tổng hợp/quản lý/người quản lý/cán bộ hành chính tổng hợp/người phụ trách hành chính tổng hợp
总参谋长=tổng tham mưu trưởng/Tổng tham mưu trưởng
总司令=Tổng tư lệnh/tổng tư lệnh
总和=tổng cộng/tổng/tổng số/tổng hoà/tính gộp lại
总图=tổng đồ/sơ đồ
总得=dù sao cũng phải/thế nào cũng phải/tổng đắc
总括=tổng quát/nhìn chung mọi vấn đề
总旗=tổng kỳ/Tổng Kỳ
总监=tổng thanh tra/tổng giám/Tổng giám
总督=Tổng đốc/quan tổng đốc/toàn quyền/thống đốc
总督府=phủ tổng đốc/Tổng đốc phủ
总经理=giám đốc/tổng giám đốc/Tổng kinh lý
总统=tổng thống/Tổng thống
总统制=chế độ tổng thống/hệ thống tổng thống
总计=tổng cộng/tổng số/tính tổng cộng/tổng kết
总论=tổng luận/lời tổng luận/bảng tóm tắt/bảng tổng hợp/phần mở đầu/khái luận
总部=tổng bộ/cơ quan đầu não/bộ tổng tư lệnh/quân uỷ trung ương/văn phòng chính/trụ sở chính
总量=tổng lượng/tổng sản lượng/tổng số lượng/tổng số
恋歌=tình ca/bản tình ca
悲歌慷慨=khí khái oai hùng/bi ca hào phóng
悲观主义=chủ nghĩa bi quan/bi quan
情歌=tình ca/bài ca tình yêu
惜老怜贫=kính lão thương nghèo/kính trọng người già, thương yêu người nghèo khó
惯家=tay sừng sỏ/tay lão luyện
愚妄=ngu muội lại ngông cuồng/ngu dốt xằng bậy
愚蒙=ngu muội/ngu tối/ngu dốt
愚陋=ngu muội quê mùa/ngu dốt quê mùa
愚顽=ngu muội ngoan cố/ngu dốt ngoan cố
成型=thành hình/đúng mẫu/giống như đúc/cùng một giuộc
成某=thành nào đó/Thành mỗ
战列舰=chiến hạm/tàu chiến đấu/chiến đấu hạm/tàu chủ lực/Thiết giáp hạm
户主=chủ hộ/chủ gia đình/chủ nhà
户口本=sổ hộ khẩu/đăng ký hộ gia đình
房产主=người cho thuê nhà/chủ cho thuê nhà
手机壳=vỏ di động/vỏ điện thoại di động/Ốp điện thoại/ốp lưng
手泽=vật gia truyền/bút tích tổ tiên
打主意=nghĩ cách/tìm cách/vì/chủ ý/có ý đồ
打定主意=hạ quyết tâm/kiên quyết/quyết định/quyết định chủ ý
打样=vẽ mẫu thiết kế/bản vẽ thiết kế/vẽ ma-két/in bản mẫu/in nháp
打桩=đóng cọc/đóng cừ/gia cố móng
扣题=trọng tâm/tập trung vào chủ đề chính
折腾=giày vò/lăn qua lăn lại/đi qua đi lại/làm đi làm lại/dằn vặt/dày vò/làm khổ/làm lại nhiều lần/giày vò/chơi đùa/hành hạ
抽样=lấy mẫu/đưa mẫu/thử/cho ví dụ tiêu biểu
担架=cáng cứu thương/cáng cứu thương/băng-ca/cáng/băng ca
拘牵=ràng buộc/bó buộc/buộc/cột/trói/trói buộc/kiềm chế/câu thúc
拢总=tính tổng/tính tổng cộng
拥有者=người sở hữu/kẻ có được/người chủ
持家=công việc quản gia/lo việc nhà/lo chuyện gia đình/chăm lo việc nhà/trị gia
持论=lập luận/chủ trương/trình bày luận cứ/đưa lý lẽ
按问=thẩm vấn/Xét hỏi/khảo tra. ◇Khang Biền 康駢: Nhân tỉ di ngục phủ trung án vấn 因俾移獄府中按問
挤牙膏=nói lấp lửng/nói không chủ định/nói không chủ đích/bóp kem đánh răng
挪不动=nhấc không nổi/di chuyển không nổi
挪了挪=xê dịch/dời một chút/hơi di chuyển
挪动=xê dịch/hoạt động/thay đổi vị trí/dịch chuyển vị trí/di chuyển/na động
挪移=na di/mượn tiền/vay tiền/di chuyển
挽歌=vãn ca/bài ca phúng điếu/bài ca đưa đám
换岗=đổi ca/thay đổi công việc/thay đổi người bảo vệ
授徒=nhận đồ đệ/dạy đồ đệ
掌握=nắm giữ/nắm chắc/nắm vững/hiểu rõ/chủ toạ/chủ trì
掌柜=chưởng quỹ/chưởng quầy/chủ hiệu buôn/ông chủ/địa chủ/chồng
掌管=chưởng quản/quản lý/chủ trì/phụ trách quản lý/trông coi
排班=sắp xếp lớp học/sắp xếp ca làm
探亲=thăm người thân/thăm gia đình/thăm nhà
提请=đệ trình/đưa ra/nêu ra
插播=sáp bá/phát sóng/để làm gián đoạn
插脚=chen chân/tham gia
搬迁=di chuyển/dời/chuyển/xê dịch/đổi chỗ/dời chỗ/bàn thiên
摄入=thu hút/hấp thu - vào/tham gia
摇尾乞怜=chó vẩy đuôi mừng chủ/nịnh hót lấy lòng/vẫy đuôi cầu xin
摇滚歌手=ca sĩ rock/ca sĩ nhạc rock
摹印=chữ khắc dấu/ấn phẩm in lại mẫu
撺掇=khuyến khích/xui/kích/xúi giục/kích động/xúi bẩy/thúc đẩy/giục giã
收场=kết thúc/kết cục/xong việc/thu tràng/kết cuộc
收徒=thu đồ/thu đồ đệ
收束=kiềm chế/ngăn chặn/kết thúc/thu xếp/sắp xếp
放工=tan ca/tan tầm/tan sở
政儿=chính nhi/chính nhi
政见=chính kiến/chủ trương chính trị/ý kiến chính trị/chính kiến
故典=hoa văn/mẫu mực
救世主=chúa cứu thế/cứu thế chủ/Chúa cứu thế
救应=tiếp ứng/ứng cứu/tăng cường/gia cố
教主=giáo chủ/tổng giám mục
教书先生=tiên sinh dạy học/giáo viên dạy học
教条=giáo điều/tín điều/giáo lý/chủ nghĩa giáo điều
教母=giáo mẫu/mẹ đỡ đầu
散播=tản/lan ra/rắc/rải/tung ra/gieo rắc/tán bá
敦促=nhắc nhở/thúc giục/đề nghị/khẩn cấp/cấp bách/giục
数学家=nhà số học/số học gia
斗方=giấy ca-rô/giấy kẻ ô/giấy carô
斗烟丝=thuốc rê/thuốc sợi hút tẩu/thuốc lá rời
断定=kết luận/kết thúc/nhận định
断机=dừng máy/ngừng máy/dừng động cơ/ngừng dệt dạy con/hiền mẫu giáo tử
新老=mới cũ/mới lão
方千总=Phương Thiên tổng/Phương thiên tổng
方家=Phương gia/bậc thầy/chuyên gia có cỡ/người chuyên sâu/người thành thạo
族产=gia sản dòng họ/của cải gia tộc/gia sản ông bà
族弟=tộc đệ/Em họ.
无意识=vô ý thức/không chủ định/không có ý thức
无神论=vô thần luận/thuyết vô thần/chủ nghĩa vô thần
早班=đi làm sớm/ca sáng/Ca sớm
旱烟=thuốc lá sợi/thuốc lá rời/thuốc lá hút tẩu/cái gạt tàn thuốc
时装模特=model thời trang/người mẫu thời trang
昏乱=mê muội/mê loạn/thần trí mê muội/xã hội đen tối/hỗn loạn/nền chính trị đen tối
昏了头=váng đầu/đầu óc mê muội/bị váng đầu
昏头昏脑=đầu óc mê muội/bù đầu bù cổ/đầu óc mê mẩn/đầu óc choáng váng
易老=Dịch lão/dễ già
普通人家=người bình thường/phổ thông nhân gia

暗昧=ám muội/mờ ám/ngu muội/đần độn/ngốc nghếch
暴走=bạo tẩu/nổi khùng/nổ tung
有加=có thừa/có gia/rất nhiều
朗姆酒=rượu Rum/lãng mỗ tửu
期满=mãn hạn/hết hạn/kết thúc, hết hạn
未婚先育=ăn cơm trước kẻng/chưa lập gia đình để sinh con trước
本事=bản sự/bản lĩnh/cốt truyện/câu chuyện thật/truyện nguyên mẫu/bản lãnh/bổn sự
本令主=bổn lệnh chủ/bản lệnh chủ/Bổn lệnh chủ
本体=bản thể/phần quan trọng/bộ phận chính, chủ chốt
本土=bản thổ/quê hương/nơi sinh trưởng/mẫu quốc/bản quốc/chính quốc/bổn thổ
本意=bản ý/bổn ý/chủ ý/ý định ban đầu
本生=bản sinh/Cha mẹ sinh ra mình.Chỉ đích thân 嫡親/tức là dòng chính trong gia tộc. ◇Trần Khang Kì 陳康祺: Diễn Thánh Công chi bổn sanh bào tỉ khả phối công chi tử/ngô vi môi 衍聖公之本生胞姊可配公之子/吾為媒
本门主=Bổn môn chủ/bản môn chủ
机关=cơ quan/bộ phận then chốt/bộ phận chủ chốt của máy/máy móc/máy/trụ sở/cơ mưu/mưu kế
机子=máy móc/máy dệt/cò súng/cái lẫy/lẫy cò/di động
杂家=tạp gia/học phái Tạp Gia/người có kiến thức rộng
杂耍=gánh xiếc/xiếc ảo thuật/ca hát tạp kỹ
李千总=Lý Thiên tổng/Lý thiên tổng
杜千总=Đỗ Thiên tổng/Đỗ thiên tổng
束修=thúc tu/sửa chữa/xem 束 脩 [shu4 xiu1]
束手无策=thúc thủ vô sách/bó tay toàn tập
林千总=Lâm Thiên tổng/Lâm thiên tổng
枢机=đầu mối/chức vụ trọng yếu/cơ quan chủ quản/then chốt/mấu chốt
某=nào đó/mỗ//một
柬帖=thiếp chữ mẫu/dẫn thiếp/cái danh thiếp
柳子=cây khởi liễu/làn điệu chủ yếu trong Liễu kịch
标准=tiêu chuẩn/mẫu mực/đúng chuẩn/chuẩn mực/chuẩn/mực thước
标杆=cọc tiêu/cọc ngắm/kiểu mẫu/gương mẫu/tiêu can
标题音乐=nhạc có tiêu đề/âm nhạc có chủ đề
校董=trường học chủ tịch/giáo đổng
样儿=hình dáng/hình thức/dáng vẻ/loại/kiểu/dạng nhi
样本=hàng mẫu/bản trích/dạng bổn
核心=hạch tâm/trung tâm/hạt nhân/chính/chủ yếu/nòng cốt/nồng cốt/core
案子=bản án/án tử/bàn con/mâm/bàn dài/bàn/vụ án/án kiện/ca/trường hợp
梅老=Mai lão/lão Mai
椰=dừa/gia
椰果=gia quả/dừa/nata de coco
椿萱=xuân huyên/phụ mẫu/cha mẹ
楷体=chữ Khải/mẫu chữ in
楷模=mẫu mực/mẫu/gương/tấm gương/bản/giai mô
楼橹=lâu lỗ/tháp pháo chiến trường có thể di chuyển
概况=tình hình chung/tình hình tổng quát/tình hình đại khái
概范=kiểu/mẫu/mô hình
概述=tường thuật tóm lược/tường thuật tóm tắt/tóm tắt/tổng kết/khái quát
横行霸道=hoành hành bá đạo/hoành hành ngang ngược/ăn ngang nói ngược/ăn ở ngang ngược
欢歌=hoan ca/vui vẻ hát/hào hứng hát/giọng ca vui vẻ/giọng hát hào hứng/giọng hát vui sướng
歌剧院=ca kịch viện/sấn khấu kịch
歌功颂德=ca công tụng đức/ca tụng công đức
歌唱=ca hát/ca xướng/hát/ca/ngợi ca/hát mừng
歌喉=giọng hát/giọng ca
歌声=tiếng ca/giọng ca/giọng hát/tiếng hát
歌手=ca sĩ/danh ca
歌曲=ca khúc/bài hát/bài ca/bản nhạc
歌本=tập nhạc/tập bài ca/tập bài hát
歌王=ca vương/vua ca hát
歌者=ca giả/người ca hát/người ca
歌诀=ca quyết/bài văn vần/bài vè miệng/bài vè
歌词=ca từ/lời bài hát/lời ca
歌颂=ca tụng/ca ngợi
正人=chính nhân/người chính trực/nhân vật chính/trụ cột/người chủ quản
正职=chức vị chính/nghề nghiệp chính/nghề nghiệp chủ yếu/chính chức
武老=Võ lão/Vũ lão
武警总部=Vũ Cảnh tổng bộ/tổng bộ cảnh sát vũ trang
死亡率=tỉ lệ tử vong/tỷ số tử vong
死伤率=tỷ số chết/tỉ lệ tử thương

毁誉=chê khen/nói tốt và nói xấu/phỉ báng và ca ngợi
母亲=mẫu thân/mẹ/má/me/u
母体=mẫu thể/cơ thể mẹ
母女=mẫu nữ/mẹ con
母校=trường học cũ/trường cũ/trường xưa/mẫu giáo
母音=mẫu âm/nguyên âm
比喻=ví von/tỉ dụ/ví dụ/thí dụ/ví/tỷ dụ
比如=tỉ như/tỷ như/ví dụ như/thí dụ/như/chẳng hạn như
比试=so tài/tỷ thí/thi/làm động tác/tư thế
比重计=thể tích kế/tỷ trọng kế
民族主义=dân tộc chủ nghĩa/chủ nghĩa dân tộc/một bộ phận của chủ nghĩa Tam dân
汇总=tập hợp/tổng hợp/thu thập/sưu tầm/góp nhặt/hối tổng

沉迷=trầm mê/mê muội/mụ mị/mê hoặc/làm mê mệt
没出息=không có tiền đồ/Không tiến lên/chẳng nên thân/vô hi vọng/không ra gì. ◇Hồng Lâu Mộng 紅樓夢: Giá khả hựu thị hồ thuyết/tựu toán nhĩ thị cá một xuất tức đích/chung lão tại giá lí/nan đạo tha tỉ muội môn đô bất xuất môn đích 這可又是胡說/就算你是個沒出息的/終老在這裡/難道他姊妹們都不出門的
没谱儿=chưa nghĩ tới/không có chủ định/không có kế hoạch
河神=thần sông/hà bá
沾上=dính vào/dính lên
法儿=biện pháp/pháp nhi
洄游=hồi du/di chuyển trở lại/di trú
洋夷=người tây dương/dương di
洒家=ta/ta đây/tớ/sái gia
洛千总=Lạc Thiên tổng/Lạc thiên tổng
活儿=việc/sự việc/nghề đơn giản/hoạt nhi
流荡=lưu động/di động/phiêu bạt/lưu lạc/lông bông
流行歌曲=ca khúc được yêu thích/bài hát quen thuộc/ca khúc lưu hành
浮=phù/lơ lửng/di động
海阔凭鱼跃=biển rộng mặc cá bơi/biển rộng mặc cá nhảy
添加剂=chất phụ gia/chất thêm
渡轮=tàu thuỷ/ca-nô/phà/độ luân
港口=bến cảng/cảng/bến tàu/bến cảng/cảng khẩu
港商=thương nhân Hồng Kông/cảng thương/thương gia Hồng Kông
游标=thước ngắm di động/véc-nhê
满门=cả nhà/toàn gia
漂移=trôi đi/trôi nổi/di chuyển/dời
激光束=chùm laser/kích quang thúc
火候=hỏa hầu/hỏa hậu/độ lửa/độ cháy/sức lửa/sức nóng/hoả hầu/độ/trình độ khá/tài giỏi/điêu luyện/trình độ điêu luyện/lão luyện/lúc gay go/giờ phút mấu chốt/thời khắc quan trọng/đúng lúc/thế lửa/hỏa hầu
火家=đồng sự/cộng sự/hỏa gia
火居道士=tu tại gia/đạo sĩ tu tại gia
点子=điểm/ý tưởng/điểm quan trọng/điểm quan trọng(giọt)/giọt/hạt/vết/vệt/nhịp/ít/chút/chỗ mấu chốt/điểm mấu chốt/chủ ý/biện pháp/phương pháp/cách/điểm quan trọng (giọt)
热议=nhiệt nghị/chủ đề nóng/bàn tán sôi nổi
热贴=chủ đề nóng/miếng dán nóng
熊千总=Hùng Thiên tổng/Hùng thiên tổng
爱儿=ái nhi/yêu con/đứa con yêu quý/con trai yêu quý
爱国主义=chủ nghĩa yêu nước/lòng yêu nước
爷爷奶奶=gia gia nãi nãi/ông nội bà nội
片尾=cuối phim/đuôi phim/tín dụng kết thúc
片尾曲=bài hát kết phim/khúc đuôi phim/Bài hát kết thúc của phim
片甲不留=không chừa mảnh giáp/không còn manh giáp
版主=moderator/admin/bản chủ
牛耳=người cầm đầu/người cầm đầu (tai trâu)/người chủ minh ước/đầu đảng
牡丹=mẫu đơn/cây mẫu đơn/hoa mẫu đơn/Mẫu Đơn
物主=vật chủ/chủ đồ
状纸=đơn kiện/mẫu đơn kiện/cáo trạng
独家=độc nhất vô nhị/duy nhất/độc nhất/độc gia
独门=độc môn/cửa riêng/bí truyền/gia truyền
独霸=độc bá/độc quyền/độc chiếm
王千总=Vương Thiên tổng/Vương thiên tổng
王国=vương quốc/quốc gia
玩儿=chơi/ngoạn nhi/chơi đùa/đùa rỡn
玩意儿=đồ chơi/trò vui/xiếc/đồ vật/ngoạn ý nhi/trò chơi
玩物丧志=mê muội mất cả ý chí/chơi bời lêu lổng/ham thú chơi bời
现代=hiện đại/thời đại hiện nay/thời đại ngày nay/thời đại xã hội chủ nghĩa
玻璃纸=giấy kiếng/giấy bóng kính/giấy mi-ca
班主=chủ gánh/chủ xị/bầu gánh/chủ gánh hát/trưởng kíp/trưởng ca/trưởng ban
班子=ban tử/gánh hát/đoàn hát/ban/nhóm/kíp/ê-kíp/ca/tổ/ê kíp/ban ngành
生而知之者=người sinh ra đã biết/sinh nhi tri chi giả/sinh nhi tri chi giả
田主=điền chủ/chủ ruộng
由不得=không thể theo/không phải do/không thể tuỳ theo/không thể thuận theo/không thể tự chủ được/không kiềm được/buột/cũng không do/không thể kìm được
由分而合=do phân nhi hợp/từ phân thành hợp
电器=đồ điện/thiết bị điện/đồ điện gia dụng
电船=thuyền máy/xuồng máy/ca-nô
男主=nam chính/nam chủ/nhân vật nam chính
男儿们=đám nam nhi/những đàn ông
男儿有泪不轻弹=nước mắt nam nhi không dễ chảy/nam nhi có nước mắt không nhẹ/Đàn ông đích thực không dễ khóc
男孩儿=nam hài nhi/bé trai
画帖=bản vẽ mẫu/thiếp tập vẽ
畜疫=bệnh dịch gia súc/dịch bệnh
畜禽=súc cầm/gia súc và gia cầm
疗养院=trại an dưỡng/viện điều dưỡng/dưỡng đường/viện dưỡng bệnh/viện dưỡng lão
症候群=hội chứng/biến chứng/di căn/di chứng
登第=đăng đệ/đăng khoa/đỗ tiến sĩ/thi đỗ
白文=chính văn/chủ văn/nội dung chính/bản chính văn/nét chìm/chữ chìm/hoa văn chìm
白种人=người da trắng/người Cáp-ca/mặt tái
百亿=chục tỷ/10 tỷ/mười tỉ
百年偕老=bách niên giai lão/Chúc tụng vợ chồng hòa mục trăm năm cùng già. ◇Nho lâm ngoại sử 儒林外史: Chỉ nguyện nhĩ môn phu thê bách niên giai lão/đa tử đa tôn 只願你們夫妻百年偕老/多子多孫
百户=Bách hộ/bách hộ/bách gia
百货公司=công ty tổng hợp/công ty bách hóa
皇族=Hoàng tộc/hoàng tộc/hoàng thất/hoàng gia
皮大衣=áo khoác bằng da/áo khoác gia
相加=tương gia/tăng theo cấp số cộng/gia tăng/cộng lại/lẫn nhau
看客=quần chúng/khán giả/cử toạ/khách xem/khán giả
真叔=Chân thúc/chân thúc
真意=chân ý/ý thật/chân thành/chân thật/chủ ý
眩晕中=trong mê muội/trong hôn mê
眷属=thân thuộc/gia quyến/thân thích/người nhà/quyến thuộc
着迷=mê muội/say mê/say sưa
督促=đốc xúc/thúc giục/đốc thúc/đôn đốc
督察=đôn đốc/giám sát/đốc thúc/người đôn đốc/người giám sát/đốc sát
督标=tổng đốc/toàn quyền
督阵=đôn đốc/đốc thúc/đốc trận
砝码=quả cân/pháp mã/kiếp mã/pháp mã (*đòn bí mật gia thêm cận nặng cho đàm phán)
碟仙=điệp tiên/Điệp Tiên/hình thức bói toán tương tự như bảng Ouija, trong đó những người tham gia sử dụng ngón tay trước của họ để đẩy một chiếc đĩa nhỏ trên một tờ giấy có ghi nhiều ký tự Trung Quốc
磨坊主=chủ nhà xay/chủ nhà máy/cối xay
社会党=đảng xã hội/Đảng Xã hội/Đảng xã hội chủ nghĩa
祖业=tổ nghiệp/gia sản tổ tiên/tài sản tổ tiên
祭司=tư tế/tế ti/tế tự/thầy tế/chủ tế
祸首=đầu sỏ/trùm/kẻ chủ mưu/chủ mưu/thủ phạm
离题=lạc đề/không bám vào chủ đề
种禽=gia cầm giống/gia cầm trống/gia cầm mái
科学家=nhà khoa học/khoa học gia/người nghiên cứu khoa học
秘方=bí phương/bài thuốc gia truyền/bài thuốc bí truyền/bí truyền
积分榜=bảng điểm số/bảng tổng sắp
称兄道弟=xưng huynh gọi đệ/xưng anh xưng em/bạn bè thân thiết/thân mật/mật thiết/thân tình
称赏=khen ngợi/tán dương/ca tụng
称霸=xưng bá/thống trị/làm lãnh chúa/làm chúa tể
移不开=dời không ra/di bất khai
移居=di cư/chuyển chỗ ở
移形换位=di hình hoán vị/thay hình đổi vị
移民=di dân/dân di cư
穷学生=học sinh nghèo/đệ tử nghèo
立意=lập ý/dàn ý/quyết định/xác định chủ đề
立户=lập hộ/lập gia đình/lập tài khoản
竟达=tổng cộng/cánh đạt/càng đạt

童叟无欺=già trẻ không gạt/đồng tẩu vô khi/không dối trên lừa dưới
童工=lao động trẻ em/công nhân nhi đồng/công nhân
笔走龙蛇=bút tẩu long xà/thoăn thoắt/rồng bay phượng múa/viết chữ như rồng bay phượng múa
第一=thứ nhất/đệ nhất/đầu tiên/hạng nhất/bậc nhất/quan trọng nhất
第一任=đời thứ nhất/đệ nhất nhiệm/đệ nhất đảm nhận/người đầu tiên nhận chức
第一名=thứ nhất/hạng nhất/tên thứ nhất/đệ nhất danh
第一枚=cái thứ nhất/đệ nhất mai/quả thứ nhất
第一根=cái thứ nhất/đệ nhất cây
第一次世界大战=đại chiến thế giới thứ nhất/chiến tranh thế giới lần thứ nhất/đệ nhất thế chiến
第一重=đệ nhất trọng/tầng thứ nhất
第一门=đệ nhất môn/môn thứ nhất
第七品=đệ thất phẩm/cấp thứ bảy
第三=thứ ba/đệ tam
第三国际=đệ tam quốc tế/quốc tế thứ ba
第三根=cái thứ ba/đệ tam cây/cây thứ ba
第三纪=kỷ đệ tam/kỷ thứ ba
第九=thứ chín/đệ cửu
第九位=vị thứ chín/đệ cửu vị/người thứ chín
第二境=đệ nhị cảnh/cảnh giới thứ hai
第二重=đệ nhị trọng/tầng thứ hai
第五重=đệ ngũ trọng/tầng thứ năm
第八道=đạo thứ tám/đệ bát đạo
第六道=đạo thứ sáu/đệ lục đạo
第几=thứ mấy/đệ mấy
第十二=thứ mười hai/đệ thập nhị
第十四=thứ mười bốn/đệ thập tứ
第四=thứ tư/đệ tứ/thứ tư
第四境=đệ tứ cảnh/cảnh giới thứ tư
管制=quản chế/kiểm soát/quản lý chặt/quản lý cưỡng chế/quản thúc cưỡng chế
管家=quản gia/người quản lý
精神=tinh thần/nghị lực/sinh lực/tôn chỉ/ý nghĩa chủ yếu/sức sống/hoạt bát/sôi nổi/nhanh nhẹn/linh lợi
糟老头子=lão già họm hẹm/lão già nát rượu
紧箍咒=kim cô chú/lời chú cẩn cô/cẩn cô nhi/chú cẩn cô nhi/xiềng xích/gông xiềng/khẩn cô chú
红夷炮=hồng di pháo/Hồng Di Pháo
红衣主教=hồng y giáo chủ/giáo chủ hồng y
练歌房=phòng luyện ca/phòng hát
练达=lão luyện/thạo đời/hiểu đời/lõi đời/từng trải/lão thành
终了=kết thúc/xong/cuối cùng
结尾=phần cuối/giai đoạn kết thúc/giai đoạn cuối/lời nói cuối/hành động cuối cùng/kết vĩ
结束语=lời kết/kết thúc/Kết luận
结论=kết luận/phán quyết/tuyên án/kết thúc/phần cuối/sự chấm dứt
统率=chỉ huy/tổng chỉ huy/điều khiển/thống suất
继母=mẹ kế/kế mẫu/mẹ ghẻ
续签=ký tiếp/gia hạn/gia hạn hợp đồng
绿树成荫=cây xanh râm mát/lục thụ thành ấm - sống già thành đại ca/cây xanh tạo bóng mát/cây xanh tỏa bóng

罗非鱼=cá rô phi/cá rô phi/Cá rô phi
美人儿=mỹ nhân nhi/tiểu mỹ nhân/mỹ nhân
美容师=chuyên gia làm đẹp/mỹ dung sư
美称=tiếng khen/lời khen/lời ca ngợi
群雄=quần hùng/xưng hùng xưng bá
老丈=lão trượng/cụ già
老东西=lão già/lão già kia
老二=lão nhị/lão Nhị
老人=lão nhân/người già/cụ già/cha mẹ già/ông bà cụ/người cũ
老人的手=tay của lão nhân/tay của ông lão
老伙计=lão hỏa kế/ông bạn già/lão đầu
老公=lão công/chồng/lang quân/thái giám/công công
老几=hàng/vai vế/thứ/là cái gì/ra gì/lão kỷ/cái gì
老化=biến chất/hỏng/lão hoá/già/lạc hậu/lão hóa
老千=gian lận bài bạc/lão thiên/chơi ăn gian
老坑=lão Khanh/hố cũ
老天爷=lão thiên gia/ông trời/lão trời già/thượng đế/chúa/trời/ông trời già
老夫子=lão phu tử/thầy đồ/thầy giáo làng/bạch diện thư sinh/trí thức thụ động
老奸巨猾=cáo già/xảo quyệt/lão gian cự hoạt
老妈=lão mụ/mẹ
老妖=lão yêu/lão Yêu
老姑娘=lão cô nương/gái lỡ thì/bà cô/con gái út
老婆=lão bà/vợ
老婆婆=lão bà bà/bà/mẹ chồng
老婆子=lão bà tử/mụ già/bà nó/bà ấy
老子的人=lão tử người/người của lão tử
老小=lão tiểu/già trẻ/lớn bé/vợ
老师傅=lão sư phó/sư phụ già/thợ cả
老幺=lão út/lão yêu
老店=lão điếm/tiệm cũ
老怀大慰=tuổi già an lòng/lão hoài đại úy
老态=vẻ già nua/lão thái
老态龙钟=tuổi già sức yếu/mắt mờ chân chậm/già yếu lụm cụm/già lụm khụm/lão thái long chung
老总=tổng giám đốc/thầy cai/thầy đội/ông tổng/lão tổng
老成=lão thành/từng trải/lão luyện/dày dạn kinh nghiệm/già dặn
老是=luôn/lão thị
老板=lão bản/ông chủ/chủ rạp/chủ gánh
老树=cây già/gốc cây già/lão thụ
老根=rễ già/lão căn
老槐树=cây hòe già/lão hòe thụ
老气横秋=ông cụ non/làm ra vẻ/THU/lên mặt cụ non/già cỗi/không sôi nổi/lão khí hoành thu/lão khí hoành thu (như ông cụ non)
老汉=lão hán/ông cụ già/ông cụ già/già này/lão đây
老江湖=lão giang hồ/người từng trải/người biết đối nhân xử thế
老爷=lão gia/quan lớn/quan to/nhân vật quan trọng/ông chủ/ông ngoại/cũ kỹ
老爷子=lão gia tử/cụ/cụ ông/ông cụ bên nhà
老爷爷=lão gia gia/ông cố nội/ông cụ/ông
老牛=lão ngưu/bò già/trâu già/lão Ngưu
老糊涂=lão hồ đồ/già mà hồ đồ
老练=lão luyện/từng trải/nhiều kinh nghiệm/điêu luyện/có kinh nghiệm
老者=lão giả/lão già/ông già/ông lão
老者的手=tay của lão giả/tay của ông lão
老而=già/lão nhi
老而不死=già mà không chết/lão nhi bất tử
老肖=lão Tiêu/lão Tiếu
老腰=eo/eo già/lão yêu
老臣=lão thần/cựu thần
老花眼=lão thị/mắt lão/viễn thị/mắt viễn thị
老花眼镜=kính lão/kính viễn thị
老茧=vết chai/cục chai/lão kiển
老街=phố cũ/lão nhai/Lào Cai/tỉnh Lào Cai
老调=luận điệu cũ rích/lời lẽ nhàm chán/lão điệu
老谋深算=đa mưu túc trí/nhìn xa trông rộng/lão mưu thâm toán
老酒=lão tửu/rượu lâu năm/rượu cũ
老面=lão mặt/bột nở
老高=lão cao/rất cao
老鬼=lão quỷ/lão Quỷ/lão Ma/lão Quỷ
老黄牛=lão Hoàng Ngưu/con bò già
老黑=lão Hắc/lão hắc
老龄化=già hóa/lão hóa/Già hóa dân số
老龟=lão quy/lão Quy
考核者=người tham gia khảo hạch/người bị khảo hạch
而动=mà động/nhi động
而终=mà kết thúc/mà chết/mà chấm dứt
耕畜=gia súc kéo cày/trâu bò cày
耙子=cái cào/cái bừa/bá tử
肉翅=cánh thịt/cánh bằng thịt/cánh
肋眼=nạc lưng/Rib eye là phần nạc lưng của bò/hay còn gọi là scotch fillet/là phần thịt nạc lưng được xẻ từ xương sườn của con bò nhưng không bao gồm xương. Sở dĩ gọi là rib eye vì nó bao gồm phía trên của phần sườn. Cái tên này bắt nguồn từ việc sau khi cắt ngang một miếng nạc lưng bò sẽ thấy một dải mỡ chạy giữa miếng thịt/nhìn khá giống hình con mắt. Phần mỡ này sẽ giúp miếng thịt bò mềm thơm/béo ngậy khi áp chảo hoặc bỏ lò ở nhiệt độ cao.
育婴堂=dục anh đường/cô nhi viện/nhà nuôi trẻ em mồ côi
育幼院=dục ấu viện/bần nhi viện/cô nhi viện
胎具=mẫu khuôn gốm sứ/hàng mẫu
胜率=tỷ số thắng/tỷ lệ thắng
能歌善舞=năng ca thiện vũ/giỏi ca múa
脱班=chậm giờ/vào ca muộn/trễ
腌制=ướp gia vị/ướp/ướp muối
臆度=suy đoán chủ quan/đoán chừng
臆想=phán đoán/suy tưởng/suy nghĩ chủ quan
臆断=ước đoán/kết luận chủ quan
自制力=tự chủ/kỷ luật/lực tự chế
自家人=người trong nhà/tự gia nhân
自民党=đảng Tự Dân/LDP/Đảng Dân chủ Tự do
航母=hàng không mẫu hạm/hàng mẫu
船主=chủ thuyền/chủ tàu/thuyền trưởng
船老大=chủ thuyền/bác lái đò/người lái chính
艺术家=nghệ thuật gia/văn nghệ sĩ/nghệ sĩ/nhà nghệ thuật
艺术总监=tổng thanh tra nghệ thuật/Giám đốc Nghệ thuật/CAO Art
花户=hộ khẩu/hộ gia đình/cửa hàng hoa
花样=hoa văn/bịp bợm/đa dạng/các kiểu hoa văn/nhiều kiểu/chủng loại/khuôn/mẫu/thủ đoạn bịp bợm/trò bịp bợm/trò gian trá/hoa dạng/trò gian
花肥=phân bón hoa/bón thúc/phân trồng hoa/phân thúc ra hoa/hoa phì
花花太岁=thái tuế/công tử bột/công tử nhà giàu
苍生=thương sinh/thương sinh linh/muôn dân/trăm họ/dân đen/bá tính/thương sinh/muôn dân trăm họ
若儿=Nhược nhi/nhược nhi
苦行僧=khổ hạnh tăng/tu khổ hạnh/chủ nghĩa khổ hạnh
范例=kiểu mẫu/gương mẫu/gương/tấm gương
范本=bản mẫu/mẫu
草昧=mông muội/nụ/nguyên thuỷ/chưa khai hoá
莺歌燕舞=oanh ca yến hót/oanh ca yến vũ
落槽=mực nước xuống/nếp nhà sa sút/gia đạo suy tàn/an nhàn/nhẹ nhõm/thanh thản
蒋先生=Tương tiên sinh/Tưởng tiên sinh
蕉麻=chuối a-ba-ca/chuối abaca
藏家=Tàng gia/tàng gia
虔婆=chủ chứa/tú bà
蜚声=truyền bá tiếng tăm/nêu cao tên tuổi
行东=chủ phường/nghiệp chủ/chủ hãng
行行出状元=ngành nghề nào cũng có chuyên gia/nghề nào cũng có trạng nguyên/chuyên gia/người xuất sắc
行长=hành trưởng/chủ tịch ngân hàng
补遗=phần bổ sung/phần bổ di/phần bổ sung những thiếu sót/phụ lục/phần thêm vào/người đời sau bổ sung các tài liệu sưu tầm được vào những phần bị thiếu trong các danh tác của tiền nhân
表兄弟=biểu huynh đệ/anh em bà con/anh em họ
表哥=biểu ca/anh họ
表姐=biểu tỷ/chị bà con
表彰=khen ngợi/tuyên dương/ca ngợi/khen/biểu dương
表扬=khen ngợi/biểu dương/khen/tuyên dương/tán dương/ca ngợi/tôn vinh/ca tụng
袁某=Viên mỗ/viên mỗ
袋子=cái túi/túi/cái túi
被迫=bị ép/bị bắt buộc/bị thúc ép/bị buộc
装上=lắp đặt/cài đặt/xếp lên/mặc lên
装老=giả lão/áo liệm/áo mặc cho người chết
褒奖=khen thưởng/ca ngợi/khen ngợi
褥草=phụ gia thức ăn chăn nuôi/Phụ Gia Thức Ăn Chăn Nuôi
西域三十六国=ba mươi sáu nước Tây Vực/Tây Vực ba mươi sáu quốc gia
西移=tây di/di chuyển về tây/chuyển về tay/chuyển về tây
要端=nội dung chính/nội dung chủ yếu
角儿=giác nhi/giác nhi (nhân vật phụ)
解放鞋=giày giải phóng/giày cởi ra
解甲归田=giải ngũ về quê/giải giáp quy điền/cởi giáp về quê
言传身教=tự thân dạy dỗ/lời nói và việc làm đều mẫu mực/dạy người thế nào, mình làm như vậy/đích thân dạy dỗ
议长=nghị trưởng/chủ tịch quốc hội/Chủ tịch quốc hội
评委=ban giám khảo/bình ủy/bình phẩm/giám khảo
诗伯=thi bá/thi hào
诗史=lịch sử thơ ca/sử thi
话务员=người trực tổng đài/nhân viên tổng đài/người coi tổng đài
语锋=ngữ phong/Ngữ Phong/chủ đề thảo luận
读经=đọc kinh/đọc kinh điển Nho gia
调料=gia vị/đồ gia vị
谢我=cám ơn ta/cám tạ ta/cảm ơn ta
谥号=thuỵ hiệu/số hiệu/tên và chức danh di cảo
谭千总=Đàm Thiên tổng/Đàm thiên tổng
豪哥=Hào ca/hào ca
豪族=gia tộc quyền thế/gia tộc giàu sang quyền thế/thế gia vọng tộc/hào tộc
负极=cực âm/ca-tốt
财东=chủ hãng/người đầu tư/người bỏ vốn/tài chủ/người có phần hùn chiếm đa số
财主=tài chủ/nhà giàu/người có của/ông chủ/ông chủ lớn
资本主义=chủ nghĩa tư bản/tư bản chủ nghĩa/tư bản
赞叹=tán thưởng/tán thán/than thở/ca ngợi/khen ngợi/ca tụng/tán tụng
赞歌=tán ca/bài hát ca tụng/bài hát ca ngợi/bài thơ ca tụng
赞美=ca ngợi/ca tụng/khen ngợi
赞赏=tán thưởng/khen ngợi/ca ngợi/ca tụng
走=đi/chạy/tẩu
走光=đi hết/lộ hàng/tẩu quang
走调=sai điệu/tẩu điều
赵千总=Triệu Thiên tổng/Triệu thiên tổng
跃跃欲试=kích động/dược dược dục thí/nóng lòng muốn thử/muốn thử xem sao/nóng lòng muốn tỷ thí/nhao nhao muốn thử
身教=thân giáo/giáo dục con người bằng hành động gương mẫu
车驾=xa giá/xe ngựa của vua/xe ngựa của hoàng gia/xe ngựa
轨范=quy phạm/nề nếp/mẫu mực/tiêu chuẩn
轻粉=khinh phấn/ca-lô-men/calômen
轻重倒置=chưa nặn bụt đã nặn bệ/đảo lộn chủ yếu và thứ yếu/đặt ngược nặng nhẹ/lẫn lộn đầu đuôi, chính phụ
边儿=bên cạnh/Biên nhi
过誉=quá khen/quá tán dương/quá ca ngợi/quá đáng
迈动=di chuyển/mại động
返销=bán lại/hàng tái nhập/tái nhập hàng gia công
这娃=oa nhi này/oa nhi này/đứa bé này
退庭=kết thúc phiên toà/kết thúc phiên xử/bãi đường
送审=đệ trình/tống thẩm
适可而止=có chừng có mực/một vừa hai phải/dừng lại đúng lúc/vừa phải thì thôi/thích khả nhi chỉ
递来=đưa tới/truyền đạt/chuyển/đưa/đệ trình - tới
通共=tổng cộng/tất cả
造型=tạo hình/tạo dáng/tạo khuôn/khuôn mẫu/hình thù
造物主=tạo vật chủ/tạo hóa/Tạo hóa/Chúa sáng thế/chúa sáng thế
逼迫=bức bách/thúc ép/ép
道家=Đạo gia/đạo gia
道门=đạo môn/đạo giáo/đạo gia/môn đạo/Đạo môn
遗下=di hạ/để lại
遗像=di ảnh/bức ảnh của người đã chết
遗失=di thất/đánh rơi/rơi mất/bỏ mất/lưu lạc/mất
遗孤=trẻ mồ côi/di cô/con mồ côi
遗容=di dung/dung nhan người chết/di ảnh/chân dung người đã chết
遗弃=vứt bỏ/bỏ rơi/ruồng rẫy/ruồng bỏ/di khí/bỏ hoang
遗患=di hoạn/để lại tai hoạ/di họa
遗憾=tiếc nuối/di hận/mối hận suốt đời/đáng tiếc/lấy làm tiếc
遗民=di dân/người trung thành với triều đại trước/người sống sót
遗泽=di trạch/Di Trạch
遗篇=di thiên/thơ văn của người trước để lại
遗老=di lão/lão thần triều đại trước/bô lão
遗韵=di vận/di chuyển
那儿=chỗ ấy/chỗ/nơi nào/lúc ấy/chỗ ấy/nơi ấy/bấy giờ/Na nhi
那师叔=cái kia sư thúc/người sư thúc kia
那师祖=cái kia sư tổ/người sư tổ kia
那老僧=lão tăng kia/người lão tăng kia
那长老=trưởng lão kia/người trưởng lão kia
邮政总局=tổng cục bưu chính/bưu điện/tổng cục bưu điện/Tổng cục bưu chính
释老=thích lão/Phật giáo và đạo giáo
重音=trọng âm/nốt nhạc chính/chủ âm
金枪鱼=kim thương ngư/cá ngừ ca-li
金沙=cát vàng/kim sa
金钹=kim bạt/kim bạt (*cái nón úp)
鉴戒=rút kinh nghiệm/làm gương/điều răn/làm mẫu/rút bài học
钉子户=hộ không chịu di dời/hộ bị cưỡng chế
钱千总=Tiền Thiên tổng/Tiền thiên tổng
钹=chũm chọe/cái nón úp
铁哥们=bạn thân/bạn bè thân thiết/thiết ca môn
锅铲=cái nồi/cái xẻng/oa sạn
镇督=tổng trấn/trấn đốc
长姊=trưởng tỷ/chị
长生不老=trường sinh bất lão/trường sinh bất lão/trẻ mãi không già
长老=trưởng lão/người già/người lớn tuổi
门风=môn phong/nề nếp gia đình/gia phong
闭会=bế mạc/kết thúc hội nghị
阀阅=công huân/công lao to lớn/công trạng/kỳ công/gia đình có công
防务=phòng ngự/công việc bảo vệ an ninh quốc gia
阿姐=a tỷ/chị Ơi
阿姨=a di/dì/cô/mợ/thím/bác gái/vú
阿难=A Nan/Thái tử Ananda, em họ của Đức Phật và là đệ tử thân cận nhất của Ngài
陈迹=việc đã qua/di tích/di vật/chuyện quá khứ/việc quá khứ
除灵=trừ linh/để kết thúc thời kỳ để tang
陪读=gia sư/đọc cùng/đi cùng con hoặc vợ/chồng của một người đang học tập ở nước ngoài
随遇而安=gặp sao yên vậy/thích ứng trong mọi tình cảnh/thoả mãn trong mọi tình cảnh/tùy ngộ nhi an
隔壁=sát vách/bên cạnh/bên cạnh/láng giềng/hàng xóm sát vách/nhà bên cạnh/cách vách
难兄难弟=cá mè một lứa/anh không ra anh, em không ra em/một giuộc/người cùng cảnh ngộ/người cùng hội cùng thuyền/bạn khố rách áo ôm/nan huynh nan đệ
集成=tổng thể/tập hợp
雇主=cố chủ/người đi thuê/người đi mướn/chủ thuê/chủ mướn/người sử dụng lao động
雏形=hình thức ban đầu/thời kỳ đầu của sự phát triển/nguyên lý cơ bản/nguyên lý sơ đẳng/khái niệm bước đầu/kiến thức cơ sở/mô hình thu nhỏ/hệ mẫu/mẫu đầu tiên/nguyên mẫu/người đầu tiên/sồ hình/mô hình
雪上加霜=đã rét vì tuyết lại lạnh vì sương/họa vô đơn chí/liên tiếp gặp nạn/đã rét vì tuyết lại giá vì sương/hoạ vô đơn chí/liên tiếp gặp tai nạn/tuyết thượng gia sương/chó cắn áo rách
霸主=bá chủ/chúa tể
霸气=bá khí/khí phách/thô bạo/ngang ngược/haki
霸王=bá vương/Bá Vương/kẻ cực kỳ thô bạo/kẻ ngang ngược
音乐片=phim ca nhạc/Phim ca nhạc
音儿=ý/âm thanh/tiếng/Âm nhi
领导们=các lãnh đạo/những người lãnh đạo
领水=thuỷ phận/lãnh hải/hải phận/vùng biển quốc gia/hoa tiêu
领海=lãnh hải/vùng biển quốc gia
颈=cổ/cái cổ/cảnh/gáy
风儿=cơn gió/Phong nhi
飘移=nhẹ nhàng di chuyển/phiêu di
饲料=đồ ăn/thức ăn gia súc/tự liêu
馊主意=chủ  ý ngu ngốc/chủ ý cùi bắp/ý đồ xấu
首家=thủ gia/đầu tiên
香主=hương chủ/Hương chủ

驱遣=ép buộc/thúc giục/sai khiến/đuổi đi/xua tan/loại bỏ/gạt bỏ
驴儿=con lừa/lư nhi
骨干=cốt cán/thân xương/nòng cốt/nồng cốt/chủ chốt/trụ cột/rường cột
骨殖=di cốt/hài cốt/xương cốt/xương người chết
高千总=Cao Thiên tổng/Cao thiên tổng
高档=cấp cao/cao đương/giá cao/sa hoa/hàng tốt/giá cao/hạng sang/xa hoa
高看=xem trọng/coi trọng/đánh giá cao/đánh giá cao
鲤鱼旗=cờ cá chép/koinobori, một chiếc tất gió hình cá chép của Nhật Bản tung bay để chúc mừng Ngày thiếu nhi
鲩鱼=cá trắm cỏ/cá tin ca/cá chép
鸨母=chủ chứa/tú bà/chủ kỹ viện
麦霸=mic bá/Mai Bá/mạch phách/mic hog
麾下=dưới trướng/bộ hạ/tướng soái/tướng quân/chủ soái/dưới quyền
黄烟=khói vàng/thuốc hút tẩu
黎民=lê dân/bá tính/dân chúng
黔首=bá tính/dân chúng/bá tính
K 歌=hát Karaoke/K ca**
UP主=uploader/UP Master/UP chủ
一催=thúc giục/thúc một chút
一包在内=bao gồm tất cả/tổng cộng tất cả
一总=tổng cộng/tất cả/cả thảy/tất
一起=cùng một chỗ/vừa lên/đồng thời/cùng nhau/cùng nơi/cùng/tổng cộng/cả thảy/một vụ
一跃=nhảy lên/nhảy/nhảy một cái/nhảy một cái
一马当先=một ngựa đi đầu/đầu tàu gương mẫu/xung trận ngựa lên trước/xông lên trước
七弟=Thất đệ/thất đệ
下工=tan tầm/tan ca/cho thôi việc
不觉=chưa phát giác/không ngờ/chưa phát giác ra/chưa phát hiện/bất giác/bất giác
业主=chủ xí nghiệp/nghiệp chủ
两百亿=200 ức/20 tỷ
丧家=tang gia/nhà có tang
主人翁=nhân vật chính/người chủ/chủ nhân/ông chủ
主厨=chủ bếp/đầu bếp chính
主台=chủ đài/sàn chính
主因=nguyên nhân chính/chủ nhân
主导权=quyền chủ đạo/quyền chủ đạo
主将=chủ tướng/người chỉ huy tối cao/chim đầu đàn/người dẫn đầu
主帅=chủ soái/người cầm đầu/tướng soái
主干=trụ cột/thân cây/thân chính/lực lượng chính/lực lượng chủ yếu/cốt cán/nồng cốt/chủ kiền
主战=chủ chiến/phái chủ chiến/chủ trương phát động chiến tranh
主星=chủ tinh/ngôi sao chính
主板=mainboard/bo mạch chủ/chủ bản (motherboard)
主程序=chương trình xử lý chính/chủ trình tự
主线=chủ tuyến/đầu mối chính/manh mối chính
主考=chủ khảo/người chủ khảo
主药=chủ dược/thuốc chủ yếu/vị thuốc chính
主营=chủ doanh/kinh doanh chủ yếu
主裁=trọng tài/chủ đề
主角=nhân vật chính/diễn viên/vai chính/nhân vật chủ yếu
主门=chủ môn/cửa chính
主队=đội chủ nhà/chủ đội
乃第=nãi đệ/em mày
之家=nhà/gia đình
九家=chín nhà/Cửu gia/cửu gia
二代=đời thứ hai/nhị đại/hai đời/đệ nhị
二十亿=hai tỷ/hai mươi tỷ/2 tỉ
二哥=nhị ca/Nhị ca
二姐=Nhị tỷ/nhị tỷ
五家=năm nhà/Ngũ gia
亮儿=Lượng nhi/lửa đèn/đèn đuốc/ánh sáng
亲兄妹=thân huynh muội/anh em ruột
亲族=thân tộc/gia tộc/họ hàng thân thuộc
亲贵=hoàng thân quốc thích/hoàng gia/hoàng thất/cận thần
人家=người ta/nhân gia/nhà/hộ/gia đình/nhà chồng tương lai/gia đình chồng tương lai/người khác
从戎=tòng quân/đi lính/gia nhập quân đội
任大人=mặc cho đại nhân/Nhậm đại nhân
会计师=kế toán viên cao cấp/chuyên gia kế toán/nhân viên kế toán/người trông coi sổ sách thời xưa/hội kế sư/kế toán
传媒=truyền thông/người phổ biến/người truyền bá
传家=gia truyền/truyền gia
传扬=lan truyền/loan truyền/truyền bá/phổ biến
伯祖母=bá tổ mẫu/bà bác (bác gái của cha)/bà bác
佃东=địa chủ/chủ đất
位移=chuyển vị/di chuyển vị trí/chuyển chỗ
佛爷=Phật gia/ông Phật/Phật Thích Ca Mâu Ni
作料=gia vị/đồ gia vị
例题=ví dụ mẫu/vấn đề làm ví dụ/câu hỏi ví dụ
侯千总=Hầu Thiên tổng/Hầu thiên tổng
便览=sự chỉ dẫn ngắn/sách tóm tắt/sách hướng dẫn ngắn gọn/thuyết minh tổng quát/bảng giới thiệu sơ lược
促成=thúc đẩy/xúc tiến/thúc đẩy để đi đến thành công
促进=xúc tiến/đẩy mạnh/thúc mau/giục gấp/thúc đẩy phát triển
保守主义=chủ nghĩa bảo thủ/tư tưởng bảo thủ
保母=bảo mẫu/người vú
债权=trái quyền/quyền của chủ nợ
倾家荡产=táng gia bại sản/khuynh gia bại sản/tán gia bại sản/mất hết của cải
做东=làm chủ/làm ông chủ
催奶=thúc sữa/kích thích tiết sữa
催生=thúc đẩy sinh trưởng/đề cao/trợ sản/thúc sinh/giục sinh/thôi sinh
催运=thôi vận/thôi thúc
儿=nhi/con
儿子=nhi tử/con trai/người con
儿孙=con cháu/cháu trai/nhi tôn
儿科=khoa Nhi/nhi khoa/khoa nhi
儿茶=nhi trà/cây nhi trà
先烈们=các bậc tiên liệt/tiên liệt môn
光头哥=Quang đầu ca/đầu trọc đại ca
兔儿爷=thỏ nhi gia/ông già thỏ
兔爷=thỏ gia/ngài thỏ
入魔=nhập ma/mê muội/si mê/mê mẩn
全国性=mang tính toàn quốc/thuộc quốc gia
全盘=toàn bộ/toàn diện/tổng thể/toàn bàn
公子王孙=vương tôn công tử/con vua cháu chúa
六神无主=hoang mang lo sợ/mất bình tĩnh/không làm chủ được tinh thần/mất hết hồn vía
典范=điển hình/điển phạm/mẫu mực/kiểu mẫu/gương mẫu
农户=nông hộ/nhà nông/gia đình nông dân
冠名商=nhà tài trợ/tên thương gia
凤儿=Phượng Nhi/Phượng nhi
出动=xuất động/lên đường/bắt đầu lên đường/điều động/phái đi/điều đi/bắt tay hành động/cùng làm/tham gia
出奔=ra đi/bỏ trốn/đào tẩu/trốn đi/cuỗm đi
刀儿=dao nhỏ/dao nhíp/Đao nhi
初中=sơ trung/trung học/trung học sơ cấp/trung học cơ sở/trung học đệ nhất cấp/trường cấp hai
利他主义=chủ nghĩa vị tha/chủ nghĩa thực chứng
利欲熏心=hám lợi đen lòng/vàng đỏ nhọ lòng son/tiền bạc, lợi ích làm mê muội tâm can/bị lợi ích làm mê muội
制海权=quyền làm chủ trên biển/quyền khống chế mặt biển
剑霸=kiếm bá/Kiếm Bá
剧增=gia tăng mãnh liệt/kịch tăng
副门主=phó môn chủ/Phó môn chủ
加害=gia hại/làm hại
加工=gia công/chế biến/công việc hoàn chỉnh sản phẩm
加强版=gia cường phiên bản/phiên bản vip
动=động/di chuyển
劲儿=kình/sức lực/nhiệt tình/kình nhi
势家=thế gia/gia đình có thế lực
化合=hoá hợp/tổng hợp/kết hợp/phối hợp
化险为夷=biến nguy thành an/hóa hiểm vi di/chuyển nguy thành an
千金=thiên kim/ngàn vàng/nghìn vàng/nhiều tiền nhiều bạc/thiên kim tiểu thư
单少主=Đan thiếu chủ/Thiện thiếu chủ
卢某=Lô mỗ/Lư mỗ
厅上=chủ tịch/trên sảnh
参=tham gia/vạch tội/sâm/tố/tham
友尽=hữu tận/kết thúc tình bạn
反例=phản lệ/trường hợp ngược lại/phản mẫu
叔侄=thúc cháu/chú cháu
口琴=kèn ác-mô-ni-ca/kèn ácmônica
古老=cổ lão/cổ xưa/Cổ lão/từ xưa/cổ kính/cũ xưa
史诗=sử thi/anh hùng ca
合家=cả nhà/toàn gia/cả gia đình
合成氨=tổng hợp amoniac/amoniac tổng hợp
吊古=thăm danh lam thắng cảnh/viếng di tích
同堂兄弟=đồng đường huynh đệ/gọi tắt là
后台老板=chủ gánh/ông bầu/kẻ đứng sau/kẻ giật dây/ông chủ đứng sau
后母=mẹ kế/kế mẫu/mẹ ghẻ/dì ghẻ
后浪推前浪=sóng sau đè sóng trước/thúc đẩy tiến lên/lớp sóng sao đẩy lớp sóng trước/tre già măng mọc
后遗症=di chứng/dị tật/để lại hậu quả/ảnh hưởng còn lưu lại/hậu di chứng/di chứng về sau
吴师弟=Ngô sư đệ/Ngô  sư đệ
呈递=đệ trình/trình/đưa ra để xem xét
告老还乡=cáo lão hồi hương/cáo lão về quê
哀辞=lời điếu văn/lời điếu/khúc bi thương/lời than van/lời rên rỉ/bài ca ai oán/bài ca trong lễ truy điệu/bài hát buồn
哥儿们=anh em/các anh em/các anh/các ca sĩ
哪国=nước nào/quốc gia nào

唱歌=ca hát/hát
善终=kết thúc yên lành/chết già/cái chết yên lành/làm tốt bước cuối cùng/chết già : kết thúc an lành/chết tử tế
喇叭=loa/kèn đồng/còi/Lạt bá/cái loa
四妹=Tứ muội/tứ muội
国仇家恨=thù nước hận nhà/quốc cừu gia hận
国势=thực lực quốc gia/sức mạnh quốc gia/tình hình một nước/tình hình quốc gia
国家=quốc gia/nhà nước/đất nước/lãnh thổ
国度=quốc gia/quốc độ/đất nước
国恨家仇=hận nước thù nhà/quốc hận gia thù
国界=biên giới/biên giới quốc gia/ranh giới giữa hai nước/quốc giới
國家=quốc gia/nhà
在家=ở nhà/tại gia/có nhà
圭臬=khuôn mẫu/khuê biểu/mẫu mực/chuẩn mực/phép tắc/mực thước
地主=địa chủ/người bản địa/người bản xứ/chủ
地方主义=chủ nghĩa địa phương/đầu óc địa phương/đầu óc cục bộ
堂上=công đường/trên đường/quan tòa/bố mẹ/cha mẹ/phụ mẫu/quan toà/quan xử án
堂主=đường chủ/Đường chủ
堂妹=đường muội/em họ
增压=tăng áp/để thúc đẩy
外延=giãn ra/sự giãn ra/ngoại diên/sự kéo dài/sự gia hạn
外门弟子服=dồng phục ngoại môn đệ tử/dồng phục đệ tử ngoại môn
大伯=Đại bá/đại bá/bác cả
大宗=đại tông/hàng loạt/số lượng lớn/khối lượng lớn/nhiều/hàng chủ lực/sản phẩm chính
大家=mọi người/đại gia/chuyên gia/người nổi tiếng/bậc thầy/họ lớn/thế gia vọng tộc
大家风范=đại gia phong phạm/phong cách quý phái
大少爷=đại thiếu gia/cậu ấm/công tử bột/Đại thiếu gia
大班=chủ/giám đốc/phu kiệu/lớp lá/lớp lớn
大老爷=đại lão gia/ông lớn/quan lớn/Đại lão gia
大老粗=đại lão thô/già nua/Người kém văn hoá/không có văn hoá
大节=đại thể/quốc gia đại sự/khí tiết/tiết tháo/đại cương
大觉=đại giác/Đại Giác/Giác ngộ triệt để. ◇Trang Tử 莊子: Thả hữu đại giác/nhi hậu tri thử kì đại mộng dã 且有大覺/而後知此其大夢也
大选=đại tuyển/tổng tuyển cử/vận động bầu cử
天老爷=ông trời/trời/Thiên lão gia
夯歌=bài ca đầm đất/hò đầm đất
夷人=di nhân/người Di
奔忙=hối hả/vội vàng/ngược xuôi bôn tẩu/trôi nổi vất vả/vất vả bôn ba
女优=ca sĩ/con hát/đào hát/nữ diễn viên
女孩儿=nữ hài nhi/con gái
好好先生=hảo hảo tiên sinh/ông ba phải/người cầu an
妇孺皆知=người người đều biết/phụ nữ và trẻ em đều biết/một tên hộ gia đình
妹子=muội tử/em gái/con gái/cô em
姆=mẫu/mu
姊妹=tỷ muội/chị em
姐们=tỷ môn/đám tỷ tỷ
姑爷=cô gia/anh/cậu
姥姥=mỗ mỗ/bà ngoại/bà đỡ/bà mụ
姥爷=ông ngoại/mỗ gia
姨娘=di nương/dì
姬某=Cơ mỗ/Cừu mỗ
娘姨=bảo mẫu/vú em/người trông giữ trẻ/bà vú
婚配=hôn phối/kết hôn/lập gia đình/thành gia thất
婴儿=hài nhi/trẻ con/trẻ sơ sinh/anh nhi
嫂夫人=tẩu phu nhân/bà chị
嬷嬷=ma ma/mẹ/má/bà lão/cụ bà/nhũ mẫu/vú em
子畜=gia súc con/súc vật nhỏ
孝悌=hiếu đễ/hiếu thuận với cha mẹ, hoà thuận với anh chị/hiếu/hiếu hiếu/lòng hiếu thảo và bổn phận huynh đệ
孤孀=cô nhi quả phụ/quả phụ/đàn bà goá
孩儿=hài nhi/con
宁伯=Trữ bá/Ninh bá
它的主人是=chủ nhân của nó/chủ nhân của nó là
完璧归赵=của về chủ cũ/Châu về hợp Phố/Châu về hợp Phố (*của về chủ cũ)
完美主义=chủ nghĩa hoàn mỹ/chủ nghĩa hoàn hảo
宗法=tông pháp/gia tộc/học thầy/theo thầy
官僚主义=thói quan liêu/chế độ quan liêu/chủ nghĩa quan liêu
定弦=giai điệu/lên dây/so dây/có ý định/có chủ định
客家=người Hẹ/khách gia
客户=hộ khách/người thuê nhà/chủ hộ ở nơi khác chuyển tới/mối hàng/khách hàng chính/bạn hàng/khách hàng
家业=gia nghiệp/gia sản
家伙=gia hỏa/vũ khí/tên/thằng cha/lão/cái con/người
家务=việc nhà/nội trợ/gia vụ/việc vặt trong nhà
家塾=dạy học tại nhà/dạy tại gia
家妓=gia kỹ/gái mại dâm
家学=nhà học/gia đình có tiếng là học giỏi/gia đình có truyền thống học giỏi/gia học
家慈=từ thân tôi/bà cụ tôi/thân mẫu tôi
家法=gia pháp/phép nhà/dụng cụ để trừng phạt gia nhân
家馆=học tại nhà/học tại gia
宽限=thư thả/gia hạn/nới/nới rộng hạn định
宿主=túc chủ/kí chủ/chủ kí sinh
对歌=hát đối/đối ca
对比=so sánh/đối lập/tỷ lệ
封千总=Phong Thiên tổng/Phong thiên tổng
封镜=xong cảnh/kết thúc việc quay phim
尊老=tôn lão/Tôn lão
小人儿=tiểu nhân nhi/bé gái/bé
小儿=tiểu nhi/trẻ em/nhi đồng/thằng cháu nhà tôi
小儿子=tiểu nhi tử/con trai
小家庭=gia đình nhỏ/tiểu gia đình
小老婆=tiểu lão bà/vợ bé/thiếp
小鸟儿=chú chim non/tiểu điểu nhi/chú chim nhỏ/con chim bé nhỏ
少年老成=thiếu niên lão thành/ông cụ non
居士=cư sĩ/người tu tại gia
山国=sơn quốc/quốc gia/khu vực
岩心=mẫu khoan/lõi khoan
巨头们=đám cự đầu/các bá chủ
师爷=sư gia/trợ lý/trọ tá/trợ tá mời làm riêng không có trong biên chế
师范=sư phạm/trường sư phạm/gương sáng/gương tốt/gương mẫu
常住=thường trú/chủ nghĩa vĩnh cửu
平均主义=bình quân chủ nghĩa/chủ nghĩa bình quân/bình quân

广度=chiều rộng/độ rộng/quảng bá

开夜车=làm đêm/làm ca ba/làm việc khuya/làm thêm ban đêm/làm thâu đêm/thức suốt đêm
开恩=khai ân/ban ơn/gia ơn
弟子里=trong hàng đệ tử/trong các đệ tử
弥天大祸=di thiên đại họa/hoạ lớn ngập trời
弥散=tỏ khắp/di tán
弥足=đầy đủ/di túc
归家=trở về nhà/Quy gia
归档=đệ đơn/sắp xếp/sắp đặt/quy đương
当家的=chủ nhà/ông xã
形式主义=bệnh hình thức/chủ nghĩa hình thức
影儿=bóng hình/Ảnh nhi
徐娘半老=từ nương bán lão/già mà dê
御主=ngự chủ/Master
忍得下=nhịn được/nhịn được xuống
快马加鞭=ra roi thúc ngựa/ngựa khoẻ dồn roi/ngựa chạy nhanh quất thêm roi/cố gắng vượt bực/cố gắng càng nhanh càng tốt
总=tổng/dù sao vẫn/chung quy/cuối cùng
总会=kiểu gì cũng sẽ/tổng hội/đã hiểu
总体=tổng thể/toàn bộ/toàn diện
总体而言=tổng thể mà nói/nhìn chung
总参=tổng tham/tổng sam
总攻=tổng tiến công/tổng công kích/tổng công
总机=tổng đài/tổng đài điện thoại
总账=tổng nợ/sổ cái
总额=tổng ngạch/tổng số
恶霸=ác bá/cường hào/ác bá cường hào
愈浓=càng đậm/càng đậm
成婚=thành hôn/lập gia đình/kết hợp/cưới
成家=thành gia/lập gia đình/thành gia thất/cưới vợ/thành trùm/trở thành chuyên gia/thành người lão luyện/thành danh/Thành gia
户型=kiểu nhà/loại hộ gia đình/cấu hình của các phòng trong một nơi cư trú
房东=chủ thuê nhà/chủ cho thuê nhà/chủ nhà/phòng đông/chủ nhà trọ
扩散=khuếch tán/lan rộng/lan truyền/loan truyền/truyền bá/phổ biến/phủ khắp
把儿=tay cầm/đặt con trai/đưa nhi/một tay cầm
投进=quăng vào/ném vào/bỏ vào/lao vào/tìm đến/tham gia vào
折衷主义=chủ nghĩa điều hoà/chủ nghĩa chiết trung
报表=bảng báo cáo/báo biểu/biểu bảng báo cáo/bảng báo cáo (*cho sếp)
拜服=bái phục/kính phục/khâm phục/thán phục/cảm phục/ngưỡng mộ/ca tụng
挂拍=gác vợt/giải nghệ/gác kiếm/kết thúc giải
按部就班=làm từng bước/dần từng bước/tuần tự nhi tiến/tuần tự mà tiến/hoàn thành từng bước/thực thi từng bước một/dần dần từng bước
掌印=chưởng ấn/giữ ấn/giữ ấn tín/giữ con dấu/chủ trì/chủ toạ/nắm chính quyền/dấu tay
接班=tiếp ban/nhận ca/nhận ban/đổi kíp/thay ca
推介=quảng bá/giới thiệu/Giới thiệu
推行=phổ biến/thúc đẩy/phát triển rộng
插足=chen chân/tham gia/nhúng tay vào
搬动=di chuyển/đổi chỗ/dời chỗ/đem dùng/áp dụng
搬移=di chuyển/di động
摊主=chủ quán/chủ sạp/than chủ
摹本=bản gốc/bản mẫu/mô bổn
撑天柱地=đỡ trời chống đất/đội đá vá trời/gánh trách nhiệm trọng đại quốc gia đại sự
撤侨=di tản/rút kiều bào/để sơ tán
放样=hàng mẫu/khuôn mẫu/làm theo mẫu
政事=chính sự/việc nhà nước/việc quốc gia/chính sự
政治家=chính trị gia/nhà chính trị/người hoạt động chính trị
教条主义=chủ nghĩa giáo điều/bệnh giáo điều
敢于=có can đảm/dám/có quyết tâm/mạo muội/đánh bạo/có dũng khí
整体=chỉnh thể/toàn thể/tổng thể/toàn thân
文物=văn vật/di vật văn hoá/hiện vật văn hoá khảo cổ
新主=tân chủ/chủ mới
施主=thí chủ/người cho
无以复加=tột đỉnh/không hơn được nữa/vô dĩ phục gia
无拘无束=vô câu vô thúc/không bị ràng buộc
日班=ca ngày/ca học ban ngày
明主=minh chủ/minh quân/anh quân
明儿=đến mai/Minh Nhi/ngày mai/mai đây/mai sau/tương lai/Minh nhi
易手=thay chủ/đổi chủ/đổi tay
昧=giấu/muội
晚班=ca đêm/ca trực muộn
更猛=mạnh hơn/càng mạnh
曾母暗沙=bãi cạn James/Tằng mẫu ám sa
有产者=người có tài sản/chủ sở hữu tài sản
有的放矢=bắn tên có đích/làm việc có chủ đích/làm việc có mục tiêu rõ ràng
服部家=nhà Hattori/phục vụ gia đình
本家=bản gia/bổn gia/người trong tộc/người họ nội/Bổn gia
本少爷=bản thiếu gia/bổn thiếu gia
本心=bản tâm/chủ tâm/chủ định/ý muốn lúc đầu

机率=tỷ lệ/cơ suất/xác suất
权千总=Quyền Thiên tổng/Quyền thiên tổng
束手=bó tay/thúc thủ/khoanh tay
束手就擒=thúc thủ chịu trói/bó tay chịu trói
杯=chén/ly/gia/bôi
林海=lâm hải/cánh rừng bao la bạt ngàn/biển rừng/cánh rừng bao la/rừng ngút ngàn
柔术=nhu thuật/tỷ lệ
查重率=tỉ lệ trùng lặp/tỷ lệ kiểm tra trọng lượng
校霸=hiệu bá/trường bá
根=cây/rễ/căn/rễ : cái
棚户=gia đình sống bằng lều/hộ ở lều
楚千总=Sở Thiên tổng/Sở thiên tổng
榜样=tấm gương/gương tốt/kiểu mẫu/gương mẫu/mô hình
模本=bản gốc/bản mẫu
模范=điển hình/mô phạm/mẫu mực/gương mẫu/kiểu mẫu
歌伎=ca kỹ/ca hát
歌咏=ca hát/ca/hát
歌舞团=đoàn ca múa/ca vũ đoàn/đoàn ca múa nhạc
歌迷=mê ca nhạc/mê ca hát/fan ca nhạc
正儿=Chính nhi/chính nhi
毁家纾难=hiến toàn bộ gia sản/hiến toàn bộ gia tài ra giúp nước
母巢=mẫu sào/ong chúa
母球=mẫu cầu/bi cái
母线=mẫu tuyến/dây cáp điện/đường sinh
比例=tỉ lệ/tỉ số/gấp bao nhiêu lần/tỷ lệ
比較=tương đối/tỷ lệ
水母=sứa/thủy mẫu
汉家=Hán gia/nhà Hán

法则=pháp tắc/cách/quy luật/pháp quy/mẫu mực/kiểu mẫu/gương/phép tắc
洪千总=Hồng Thiên tổng/Hồng thiên tổng
活跃=sinh động/phát triển/sôi nổi/hoạt động mạnh/sục sôi/làm sôi nổi/thúc đẩy/đẩy mạnh/sống động/phát triển mạnh
流布=truyền bá/truyền khắp nơi/rải rác khắp nơi
浪漫主义=chủ nghĩa lãng mạn/sự lãng mạn
浮动=lưu động/di động/lững lờ/trôi lơ lửng trên mặt nước/không ổn định/phấp phỏng/thấp thỏm/hoang mang/phù động
浮船坞=âu thuyền di động/ụ nổi
海关总署=tổng cục hải quan/Tổng cục Hải quan/Tổng cục hải quan
海鳝=lươn biển/cá lịch biển/lưp biển
渔翁=ngư ông/ông lão đánh cá
游移=dao động/do dự/lưỡng lự/du di
演播=diễn bá/phát sóng/hiệu suất phát sóng
灭族=diệt tộc/tru di tam tộc/giết cả họ
烟斗=cái tẩu/tẩu hút thuốc phiện/ống điếu
烟枪=tẩu hút thuốc/tẩu hút thuốc phiện
爷们=gia môn/đàn ông/chồng
爷青结=ta đi đời rồi/gia thanh kết
牢笼=lồng giam/lao lung/lồng chim/chuồng thú/lồng/chuồng/cũi/sự ràng buộc/bẫy/lưới/cạm bẫy/tròng/lung lạc/ràng buộc/trói buộc/câu thúc/kiềm chế/nhà tù/lao tù
牧歌=mục ca/bài ca chăn cừu
牧牛=chăn bò/chăn thả gia súc
牧畜=chăn nuôi gia súc/chăn nuôi
牧群=đàn gia súc/đàn cừu
物理学家=nhà vật lý học/vật lý học gia
玄而又玄=huyễn hoặc khó hiểu/huyền nhi hựu huyền/vừa sâu xa vừa khó hiểu
玩家=người chơi/ngoạn gia/nhà chơi/player
班主任=chủ nhiệm lớp/thầy chủ nhiệm/giáo viên chủ nhiệm/giáo viên phụ trách
生母=mẹ đẻ/mẹ ruột/thân mẫu
生老病死=sinh lão bệnh tử/sinh lão bệnh tử
男儿=nam nhi/đàn ông/nam tử hán/con trai
白婆=cụ bà tóc bạc/lão bà tóc trắng
白手兴家=tay trắng làm nên/hai bàn tay trắng hưng gia
白手成家=tay trắng làm nên/Tay trắng tự lực làm nên gia nghiệp. ☆Tương tự: bạch thủ khởi gia 白手起家.
白种=người da trắng/người Cáp-ca/mặt tái
百灵鸟=chim sơn ca/chim chiền chiện/bách linh điểu
皇室=hoàng thất/hoàng gia/triều đình
监察室=buồng giám sát/giám sát thất
看家狗=quản gia/chó giữ nhà
督办=đốc thúc/đôn đốc/người giám sát/người đôn đốc

石斑鱼=cá mú/cá mú/Cá mú, cá song
祖师=tổ sư/ông tổ/sư tổ
祖母=tổ mẫu/bà nội

神主=Thần Chủ/linh vị/bài vị/thần chủ


移动=di động/chuyển dời/di chuyển
移山填海=di sơn đảo hải/dời núi lấp biển
移情=di tình/đồng cảm/để thay đổi tình cảm
穷人的孩子早当家=trẻ nhà nghèo sớm biết chuyện/trẻ em nghèo sớm là một gia đình
穷家富路=cùng gia phú lộ/con đường nghèo và giàu có/Ở nhà thế nào cũng được/đi đường phải rủng rỉnh.
窑姐=Diêu tỷ/Diêu tỷ (kỹ viện)
窠臼=cách cũ/khuôn mẫu cũ/mẫu sẵn/mẫu rập khuôn/rập khuôn
童话=truyện cổ tích/đồng thoại/cổ tích/truyện nhi đồng
竹材=trúc đã chế biến/trúc đã qua gia công
第一件=kiện thứ nhất/đệ nhất kiện/cái thứ nhất
第一团=đoàn thứ nhất/đệ nhất đám
第一批=nhóm đầu tiên/đệ nhất phê/món thứ nhất
第五道=đạo thứ năm/đệ ngũ đạo
第六境=đệ lục cảnh/cảnh giới thứ sáu
第六天=ngày thứ sáu/đệ lục thiên
第十=thứ mười/đệ thập
第四个=cái thứ tư/người thứ tư/thứ tư/đệ tứ
第四步=bước thứ tư/đệ tứ bộ
第四纪=kỷ đệ tứ/kỷ thứ tư
第四重=đệ tứ trọng/tầng thứ bốn
签筒=ống thẻ/ống thăm/ống lấy mẫu
管家婆=bà chủ/bà quản gia/nữ quản gia
级任=cấp nhiệm/giáo viên chủ nhiệm
终场=kết thúc/diễn xong/kỳ thi cuối cùng
终止=kết thúc/ngưng hẳn/đình chỉ
经验主义=kinh nghiệm chủ nghĩa/chủ nghĩa kinh nghiệm
结业=kết nghiệp/tốt nghiệp/kết thúc khoá học/hết khoá/cuối khoá
结拜兄弟=kết bái huynh đệ/anh em kết nghĩa/huynh đệ kết nghĩa
结束=kết thúc/chấm dứt/hết/kết liễu/thắt/tết/trang điểm
结案=kết án/kết thúc vụ án
统共=tổng cộng/tất cả
综观=tổng quan/nhìn chung/nhìn bao quát/nhìn tổng hợp
翘家=trốn nhà/bỏ nhà/kiều gia
老久=lão Cửu/hồi lâu
老交情=lão giao tình/bạn bè cũ
老人家=lão nhân gia/cụ/cụ ấy/ông bà cụ
老伯=lão bá/bác
老儿=lão nhi/lão nhân
老八板儿=lão bảo thủ/ông thủ cựu
老兵们=các lão binh/đám ma cũ
老冤家=lão oan gia/kẻ thù cũ
老前辈=lão tiền bối/bậc tiền bối
老古董们=đám lão cổ đổng/những lão già
老司姬=tài xế già-chan/lão Tư Cơ
老四=lão tứ/lão Tứ
老土=lão thổ/quê mùa
老大爷=lão đại gia/cụ ông/bác
老太太=lão thái thái/bà/quý bà/cụ nhà
老头=lão đầu/ông lão
老姜=củ gừng/lão Khương
老娘们儿=mụ già/lão nương môn nhi/gái có chồng/gái lớn/con gái lớn/vợ
老媪=bà lão/bà cụ/bà già

老家伙=lão gia hỏa/lão gia này/lão gia/lão già/lão gia hoả
老寿星=lão thọ tinh/ông cụ/cụ/người được chúc thọ
老巫婆=lão vu bà/mụ phù thủy
老师=lão sư/thầy cô giáo/bậc thầy
老师们=các lão sư/các thầy giáo
老干部=cán bộ kỳ cựu/lão cán bộ
老幼=lão ấu/già trẻ
老底子=nội tình vốn liếng/lão để tử/gốc gác
老旦=lão đán/vai bà già
老朽=lão hủ/cổ hủ/già yếu/hom hem/lụ khụ/lão già cổ hủ này
老牌=uy tín lâu năm/nhãn hiệu lâu đời/được tín nhiệm/danh tiếng/nổi tiếng từ xưa/người được tín nhiệm/người có uy tín/lão bài/lâu năm
老百姓=lão bách tính/dân chúng/nhân dân/dân cư/thường dân/dân thường
老皮=vỏ khô/lão Bì
老矣=già rồi/lão hĩ
老虎=lão hổ/con cọp/hổ/hùm/cọp/ông ba mươi/hao phí/lãng phí/kẻ tham ô/chằn tinh gấu ngựa/chằn
老财=lão tài/ông chủ
老资格=lão tư cách/già dặn
老辣=cay độc/đanh đá chua ngoa/cay nghiệt/lão lạt
老饕=lão thao/ông già/háu ăn
老骨头=lão cốt đầu/xương già/lão già khọm
老鸟=lão điểu/dân chuyên nghiệp/dân Pro
老龄=tuổi già/lớn tuổi/người già/lão
胎儿=thai nhi/cái thai/bào thai
胜迹=di tích nổi tiếng/danh lam thắng cảnh
胞妹=bào muội/em gái ruột
胞弟=bào đệ/em ruột
胶=nhựa cây/mủ cao su/giao/giao (chất dính)
腹心=tim gan/quan trọng/chính/chủ yếu/cốt lõi/thân cận/tâm phúc/tin cẩn/lòng dạ
自作主张=tự tác chủ trương/tự chủ trương

舱房=khoang/khoang phòng/cabin/ca-bin
舵主=đà chủ/Đà chủ
船东=chủ tàu/chủ thuyền
良家女子=lương gia nữ tử/cô gái đàng hoàng
花架子=chủ nghĩa hình thức/động tác võ thuật đẹp/tốt gỗ hơn tốt nước sơn/hoa giá tử/trò mèo

蒙主宠召=được Chúa gọi về/mông chủ sủng triệu
蔻蔻=cây cô-ca/bột cô-ca/cây côca
蝼蚁=sâu kiến/con sâu cái kiến/con kiến hôi/dế và kiến/con sâu cái kiến/con ong cái kiến/loài giun dế/giun dế
行走=hành tẩu/đi/đi lại/cất bước
表演艺术家=biểu diễn nghệ thuật gia/nghệ sĩ biểu diễn

要领=yếu lĩnh/có lợi ích/nội dung chính/nội dung chủ yếu/mấu chốt
观主=quán chủ/quan chủ
角斗场=giác đấu trường/giác đấu tràng/trường giác đấu/tràng giác đấu
计划生育=kế hoạch hoá gia đình/sinh đẻ có kế hoạch
诗赋=thi phú/thi ca và từ phú

谱系=hệ thống gia phả/phả hệ
豪强=hào cường/ngang ngược/ngang tàng/cường hào/cậy thế nạt người/cường hào ác bá
货主=chủ hàng/chủ hàng hoá
贷方=cột cho vay/người cho vay/chủ nợ
赞美诗=thánh ca/bài thánh ca
走为上策=chạy là thượng sách/tẩu vi thượng sách
走卒=tôi tớ/đầy tớ/sai dịch/tẩu tốt/lính hầu
走火=cướp cò/nói quá lời/cháy dây điện/bốc cháy/tẩu hỏa
走犬=tẩu khuyển : đua chó/đua chó
走红=gặp may/gặp vận may/may mắn/hên/được đón tiếp/được hoan nghênh/tẩu hồng，
越广=càng rộng/càng rộng
转徙=di cư/di trú
转移=chuyển di/dời đi/đổi vị trí/thay đổi vị trí/đổi chỗ/chuyển/dời/thay đổi/đổi
轮船=tàu thuỷ/ca-nô/luân thuyền/canô
辖制=quản thúc/quản chế/hạt chế
辣妹=lạt muội/cô em/Sexy Girl (Lạt muội)
边牧=border collie/vừa chăn thả gia súc/Border collie
达尔文主义=chủ nghĩa Đác-uyn/học thuyết Đác-uyn
迎刃而解=giải quyết dễ dàng/nghênh nhận nhi giải
运营商=tổng đài/công ty viễn thông/operator
这老怪=lão quái này/người lão quái này
这门主=môn chủ này/người môn chủ này
迷惑=mê hoặc/mê muội/mê mẩn
通家=thông gia/người trong nghề/người trong ngành
道爷=Đạo gia/đạo gia
遗产=di sản/của để lại
遗嘱=di chúc/trăng trối/lời di chúc/lời trăng trối
遗毒=di độc/nọc độc còn sót lại
遗留=còn sót lại/di lưu/để lại/truyền lại/còn để lại
遗臭=di xú/mang mùi
邓千总=Đặng Thiên tổng/Đặng thiên tổng
那公子=kia công tử/vậy công tử/công tử kia
那师伯=cái kia sư bá/người sư bá kia
那枚=viên kia/cái viên kia/cái viên này
那正主=chính chủ kia/chính chủ kia
那老儿=lão nhi kia/ông già kia
郑千总=Trịnh Thiên tổng/Trịnh thiên tổng
酋长国=tiểu vương quốc/quốc gia tù trưởng
采样=thu thập mẫu/lấy mẫu
铤而走险=bí quá hoá liều/con giun xéo lắm cũng oằn/chó cùng rứt giậu/đói ăn vụng túng làm càn/đĩnh nhi tẩu hiểm/bí quá hóa liều
长姐=trưởng tỷ/chị cả
门下=môn hạ/môn khách/học trò/môn đệ
门儿=môn/cửa nhỏ/môn nhi
门徒=môn đồ/đồ đệ/đệ tử
阖家=toàn gia/cả nhà/cả gia đình
阿弟=a đệ/em trai/chú em/cậu em/tiểu đệ
陈千总=Trần Thiên tổng/Trần thiên tổng
降格=hạ thấp/mất danh giá/giảm giá trị/giảm sút/suy biến/thoái hoá/rả/mủn/giảm phẩm chất/phai/nhạt/giảm giá
陪衬=vật làm nền/làm nền/phụ gia/phụ thêm/làm trội lên/làm nổi bật lên/nền/bồi sấn
集大成者=người tổng kết/tập hợp những người thành công lớn
霸持=bá chiếm/chiếm đoạt/chiếm giữ
霸王龙=khủng long bạo chúa/bá vương long
面料=sợi tổng hợp/diện liêu
韵母=vận mẫu/nguyên âm
顶班=thay ca/đổi ca/nhận ca hộ/hăng hái/tích cực
顽石点头=nói phải củ cải cũng nghe/có thể cải tạo được, quy phục được dù ngu muội, cứng rắn đến đâu/có sức thuyết phục để mọi người tin theo
颁发=ban phát/công bố/ban hành/ra chỉ thị/ra chính sách/thông báo chính thức/truyền bá/phổ biến/phát ra/phát hành/trao tặng/thưởng
颂词=lời ca tụng/lời chúc mừng
飞禽走兽=phi cầm tẩu thú/chim bay cá nhảy/chim trời cá nước/chim và thú/đủ loại động vật
饮誉=nổi tiếng/được ca ngợi/tán tụng
驅使=động cơ/thúc đẩy
马刺=mã thích/Spurs/thúc đẩy
马千总=Mã Thiên tổng/Mã thiên tổng
驸马爷=phò mã gia/phụ mã gia
驿动=dịch động/di chuyển
高中生=học sinh cấp ba/học sinh cấp 3/học sinh trung học đệ nhị cấp
高参=cán bộ tham mưu cao cấp/cao sam/cán bộ tham mưu
鬼主意=mưu ma chước quỷ/chước mưu gian ác/quỷ chủ ý
鬼佬=quỷ lão/người nước ngoài
鳕鱼=cá tuyết/cá thu /Cá tuyết
一个小孩儿=một đứa tiểu hài nhi/một đứa bé
这颗珠子=cái khỏa hạt châu này/hạt châu này/hạt châu này
第四代弟子=đệ tử đời thứ tư/đệ tứ đại đệ tử/đệ tử đời thứ bốn
结束工作=kết thúc công tác/hoàn thành công việc
傻妹妹=muội muội ngốc/em gái ngốc nghếch
连坐骑=cả tọa kỵ/ngay cả vật cưỡi
这个老好人=lão hảo nhân này/người hiền lành này
三百亿=ba mươi tỷ/30 tỉ
你嫂子=tẩu tử ngươi/chị dâu ngươi
宁大少爷=Ninh đại thiếu gia/Ninh đại thiếu gia
兄終弟及=anh chết em kế tục/huynh chung đệ cập/anh hết đến em
老人们=các lão nhân/mấy ông già
黑帮老大=trùm xã hội đen/lão đại xã hội đen
这座府邸里=trong tòa phủ đệ này/bên trong tòa phủ đệ này
你们的店主=chủ quán của các ngươi/điếm chủ của các ngươi
百味陈杂=cảm xúc ngổn ngang/bách vị tạp trần
大人们=các đại nhân/những người lớn/đại nhân nhóm
小学妹=tiểu học muội/em gái tiểu học
骄横跋扈=ngang tàng hống hách/kiêu hoành bạt hỗ/hung hăng bá đạo/kiêu ngạo ngang ngược
这老板=lão bản này/ông chủ này
无理函数=hàm vô tỷ/hàm số vô tỷ
我的家境=gia cảnh của ta/gia cảnh nhà ta
别的叔叔=thúc thúc khác/các thúc thúc khác
曹白鱼=cá be be/cá bẹ dài/cá be be
这鱼人=cái ngư nhân này/người cá này



这小师弟=tiểu sư đệ này

第一名将=đệ nhất danh tướng/danh tướng số một
手机屏幕=màn hình điện thoại di động/màn hình di động/Màn hình điện thoại
冷县长=Lãnh huyện trưởng/Lãnh chủ tịch huyện
你的家境=gia cảnh của ngươi/gia cảnh của cậu
孔千总=Khổng Thiên tổng/Khổng thiên tổng
裘大小姐=Cầu đại tiểu thư/Cừu đại tiểu thư
主引擎=động cơ chính/chủ dẫn kình
她的娘亲=mẹ ruột của nàng/mẫu thân của nàng
连长老=liền trưởng lão/Liên trưởng lão
别人的家庭=gia đình người khác/gia đình của người khác
张底牌=tấm át chủ bài/lá bài tẩy
边千总=Biên Thiên tổng/Biên thiên tổng
小老板=tiểu lão bản/cậu chủ nhỏ/ông chủ nhỏ
张家人=người Trương gia/người nhà họ Trương
老石头=lão thạch đầu/đá cũ
梅总裁=Mai tổng tài/tổng giám đốc Mai
它的妹妹=muội muội của nó/em gái của nó
司马千总=Tư Mã Thiên tổng/Tư Mã thiên tổng
是谁家子弟=là đệ tử/con cái nhà ai
热可可=cà phê nóng/ca-cao nóng/cacao nóng/ca cao nóng
雷三少爷=Lôi tam thiếu gia/Lôi tam thiểu gia
陆家人=người Lục gia/người nhà họ Lục
我的手机号=số di động của ta/số điện thoại di động của ta/số điện thoại của ta
本公子=bản công tử/bổn công tử
你的赞美=ca ngợi của ngươi/lời ca ngợi của ngươi
四大家族之一=một trong tứ đại gia tộc/một trong bốn dòng họ lớn nhất
石家人=người Thạch gia/người nhà họ Thạch
肖千总=Tiếu Thiên tổng/Tiếu thiên tổng
杨家的人=Dương gia người/người của Dương gia
高个弟子=người đệ tử cao/đệ tử cao hơn
新老师=tân lão sư/lão sư mới
那个老年人=ông lão kia/người lớn tuổi kia
这个时期=thời kỳ này/cái thời kỳ này
你母亲=mẫu thân ngươi/mẹ của ngươi/mẹ ngươi
主仆血约=chủ phó huyết ước/{chủ phó huyết ước}
这些公子哥儿=đám công tử ca này/mấy cậu ấm này
光耀门楣=vinh quang cửa nhà/làm rạng rỡ gia tộc/quang diệu môn/mang lại danh dự cho gia đình của một người
焉小王爷=Yên tiểu Vương gia/Yên tiểu vương gia
那儿子=đứa con kia/vậy nhi tử/đứa con trai kia
这个主子=người chủ tử này/người chủ nhân này
四万亿=bốn ngàn tỷ/4000 tỉ
他爷爷=gia gia hắn/gia gia của hắn
三巨头之一=một trong tam cự đầu/một trong ba bá chủ
军事学家=học gia quân sự/nhà quân sự học
能到家=có thể về đến nhà/có thể đến gia
第一目标=mục tiêu thứ nhất/mục tiêu đệ nhất
我家的老头子=lão đầu tử nhà ta/ông già nhà ta
第十道=đạo thứ mười/đệ thập đạo
在手机上=trên điện thoại di động/ở trên điện thoại
韩家人=người Hàn gia/người nhà họ Hàn
咖啡杯子=ly cà phê/ly cà phê
老者的脸上=trên mặt lão giả/trên mặt của ông lão
二代弟子=đệ tử đời hai/Nhị đại đệ tử
镇长大人=trấn trưởng đại nhân/Trấn trưởng đại nhân
单大哥=Đan đại ca/Thiện đại ca
第二重天=đệ nhị trọng thiên/tầng thứ hai
独门秘方=phương pháp độc quyền/công thức gia truyền độc quyền
本小姐地大恩=đại ân của bổn tiểu thư/đại ân của bản tiểu thư
云母=đá vân mẫu/mi-ca
好儿子=hảo nhi tử/con trai ngoan/tốt con trai
这名老者=lão giả này/người lão giả này
老者的提议=đề nghị của lão giả/đề nghị của ông lão
单庄主=Đan trang chủ/Thiện trang chủ
本楼主=bản lâu chủ/Bổn lâu chủ
这一场比试=cuộc tỷ thí này/trận tỉ thí này
小孩子家家=tiểu hài tử gia gia/con nít con nôi
第八根=cây thứ tám/đệ bát cây
那算命大叔=đại thúc coi bói kia/đại thúc xem bói kia
府邸之中=trong phủ đệ/bên trong tòa phủ đệ
他们的手机=điện thoại di động của bọn hắn/điện thoại di động của bọn họ
猫小王爷=Miêu tiểu Vương gia/Miêu tiểu vương gia
老秃驴=lão lừa trọc/con lừa hói già
互望了一眼=liếc mắt nhìn lẫn nhau/hơi liếc mắt nhìn nhau
大金主=đại gia nhiều tiền/đại kim chủ
七小王爷=Thất tiểu Vương gia/Thất tiểu vương gia
蓝发老者=Lam phát lão giả/ông lão tóc lam
这是我爹妈=đây là phụ mẫu ta/đây là cha mẹ ta
素食主义=chủ nghĩa ăn chay/ăn chay
你家大人=đại nhân nhà ngươi/người lớn nhà ngươi
他们的大哥=đại ca của bọn hắn/đại ca của bọn họ
其它国家=quốc gia khác/những quốc gia khác
格子衫=áo ca rô/cách tử sam
在家族内=trong gia tộc/ở trong gia tộc
委员会主席=chủ tịch uỷ ban/Chủ tịch Ủy ban
单王爷=Đan vương gia/Thiện vương gia
疯千总=Phong Thiên tổng/Phong thiên tổng
易主了=đổi chủ/đỗi chủ
单姐姐=Đan tỷ tỷ/Thiện tỷ tỷ
你的老板=lão bản của ngươi/ông chủ của ngươi
老者的神情=lão giả thần sắc/vẻ mặt ông lão
这个老者=lão giả này/ông lão này
行脚商人=hành cước thương nhân/một thương gia chân
八万亿=tám ngàn tỷ/8000 tỉ
你姐姐=tỷ tỷ ngươi/tỷ tỷ của ngươi
抵掌而談=chỉ chưởng nhi đàm/vỗ tay mà bàn
第九道=đạo thứ chín/đệ cửu đạo
继承自=kế thừa từ/thừa hưởng từ/di truyền từ
国家的政策=chính sách của quốc gia/chính sách của quốc gia
我的小弟弟=tiểu đệ đệ của ta/JJ của ta
这庄主=trang chủ này/người trang chủ này
两百多亿=hơn 20 tỷ/hơn hai mươi tỉ
兵家常事=chuyện thường binh gia/phổ biến trong các hoạt động quân sự
我的好兄弟=hảo huynh đệ của ta/anh em tốt của ta
你老子=lão tử ngươi/thằng cha ngươi
老人的身影=lão nhân thân ảnh/thân ảnh của lão nhân
关门弟子=quan môn đệ tử/đệ tử cuối cùng/đệ tử đóng cửa/đệ tử cuối cùng của sư phụ
玻璃肥料=phân tổng hợp có bột thủy tinh/phân tổng hợp có bột thuỷ tinh
单小兄弟=Đan tiểu huynh đệ/Thiện tiểu huynh đệ
这些老头子们=những lão đầu tử này/những ông già này
他老人家=lão nhân gia ông ta/lão nhân gia người
晃动了一下=lắc lư một cái/hoảng động liễu nhất hạ/lúc lắc một cái/lay động một chút
其余弟子=đệ tử còn lại/những đệ tử còn lại
为主要=làm chủ yếu/là chủ yếu
江县长=Giang huyện trưởng/Giang chủ tịch huyện
民族区域自治=khu dân tộc tự trị/khu tự trị/tự chủ khu vực dân tộc
最主要=chính yếu nhất/chính yếu/chủ yếu nhất
姐姐的师傅=sư phụ của tỷ tỷ/sư phó của tỷ tỷ
是什么家伙=là gia hỏa nào/là người gì
第一大派=đại phái đệ nhất/đệ nhất đại phái
大水母=sứa to/đại thủy mẫu
我的女儿=nữ nhi của ta/con gái của ta
这老法师=lão pháp sư này/người lão pháp sư này
你们的房东=chủ nhà của các ngươi/chủ nhà trọ của các ngươi
他们的弟子=đệ tử của bọn hắn/đệ tử của bọn họ
各大门派之间=giữa các đại môn phái/giữa các môn phái lớn
自己的烟管=tẩu thuốc của mình/ống thuốc lá của mình
为主而战=vì chủ mà chiến/vì chúa mà chiến
外门弟子中=trong ngoại môn đệ tử/trong đệ tử ngoại môn
那青衣弟子=thanh y đệ tử kia/đệ tử áo xanh kia
便携式防空导弹=hệ thống phòng không vác vai/tên lửa phòng không di động
把手一指=chỉ tay một cái/chỉ tay một cái
她的家人=người nhà của nàng/người nhà của hắn/gia đình cô
十六计，走为上计=ba mươi sáu chước, chuồn là thượng sách/tam thập lục kế tẩu vi thượng kế, tam thập lục kế tẩu vi thượng sách, trong ba sáu chước, chước chuồn là hơn
龟小王爷=Quy tiểu Vương gia/Quy tiểu vương gia
第一高山=đệ nhất cao sơn/núi cao số một
我们家主=gia chủ của chúng ta/gia chủ nhà ta
米千总=Mễ Thiên tổng/Mễ thiên tổng
单施主=Đan thí chủ/Thiện thí chủ
一家三口=một nhà ba người/một gia đình ba người
主心脏=chủ tâm tạng/trái tim chính
他们的师叔=sư thúc của bọn hắn/sư thúc của bọn họ
另一个老人=một lão nhân khác/một ông già khác
主基调=tư tưởng chính/nhạc dạo chính/chủ cơ điều
你这家伙=ngươi cái tên này/cái tên nhà ngươi/ngươi cái tên này
江主任=Giang chủ nhiệm/chủ nhiệm Giang
那老家伙=lão gia hỏa kia/lão nhân kia
回主人=hồi chủ nhân/bẩm chủ nhân
田阿姨=Điền a di/dì Điền
纨绔子弟们=đám hoàn khố tử đệ/lũ ăn chơi trác tác
男权主义=chủ nghĩa nam quyền/nam quyền
古副县长=Cổ phó huyện trưởng/Cổ phó chủ tịch huyện
调味品全套=bộ đựng gia vị/bộ đồ gia vị/Bộ đồ gia vị
老大了=lão đại rồi/lão đại
于老师=Vu lão sư/với lão sư
单师弟=Đan sư đệ/Thiện sư đệ
这位兄弟=vị huynh đệ kia/vị huynh đệ này
包养的主=chủ trương bao dưỡng/bao nuôi đích chủ trương
麻烦的家伙=phiền toái gia hỏa/tên phiền toái
他们的家产=gia sản của bọn hắn/gia sản của bọn họ
它们的老爸=lão ba của bọn nó/cha của bọn nó
弟子里面=trong hàng đệ tử/trong các đệ tử
那家人=người nhà kia/gia nhân kia
父母俱存=phụ mẫu câu tồn/cha mẹ đều còn
那名师弟=tên sư đệ kia/người sư đệ kia
大人身上=trên người người lớn/trên người đại nhân
叶副县长=Diệp phó huyện trưởng/Diệp phó chủ tịch huyện
熊小王爷=Hùng tiểu Vương gia/Hùng tiểu vương gia
家常小菜=món ăn hàng ngày/cơm rau đạm bạc/món ăn gia đình
看不真切=nhìn không rõ ràng/khán bất chân thiết/nhìn không rõ lắm
左千总=Tả Thiên tổng/Tả thiên tổng
我老婆=lão bà của ta/lão bà ta/vợ của ta
我的妹妹=muội muội của ta/em gái của ta
他们的宗主=tông chủ của bọn hắn/tông chủ của bọn họ
他的老朋友=lão bằng hữu của hắn/bạn cũ của hắn
贼老天=lão tặc thiên/lão thiên khốn kiếp/tặc lão thiên
家族之长=gia tộc chi trưởng/tộc trưởng gia tộc
十六代弟子=đệ tử đời mười sáu/thập lục đại đệ tử
他们的家传=gia truyền của bọn hắn/gia truyền của bọn họ
史学家们=các nhà sử học/các sử gia
我家主公=chúa công nhà ta/chủ công nhà ta
铺面而来=tốc thẳng vào mặt/phô diện nhi lai
单小哥=Đan tiểu ca/Thiện tiểu ca
裘小王爷=Cừu tiểu Vương gia/Cừu tiểu vương gia
主峰之上=chủ phong bên trên/trên chủ phong
胡乡长=Hồ hương trưởng/Hồ chủ tịch xã
主要力量=lực lượng chủ yếu/sức mạnh chủ yếu
江小王爷=Giang tiểu Vương gia/Giang tiểu vương gia
落家里=quên ở nhà/trong Lạc gia
矮人一头=một người lùn/thấp hơn người ta một cái đầu
总经理室=phòng tổng giám đốc/phòng Tổng kinh lý
大人才=đại nhân tài/đại nhân mới
他们的师妹=sư muội của bọn hắn/sư muội của bọn họ
单大伯=Đan đại bá/Thiện đại bá
它的主子=chủ tử của nó/chủ nhân của nó
我姐夫=tỷ phu của ta/tỷ phu ta
单大爷=Đan đại gia/Thiện đại gia
家主和=gia chủ cùng/gia chủ và
主席台上=trên đài hội nghị/trên chủ tịch đài/trên đài chủ tịch
金融家=chuyên gia tài chính/nhà tài chính
综合性大学=đại học tổng hợp/Đại học Toàn diện/Đại học tổng hợp
解剖专家=chuyên gia giải phẫu/chuyên gia giải phẫu
它的仇家=cừu gia của nó/kẻ thù của nó
数以万亿计=tính đến hàng ngàn tỷ/lên tới hàng ngàn tỉ
飞檐走墙=phi diêm tẩu tường/phi diêm tẩu tường(mái cong đi tường)
我的父母=cha mẹ của ta/phụ mẫu ta/cha mẹ ta
主要领导=lãnh đạo chủ yếu/lãnh đạo chủ chốt
黄衣老者=áo vàng lão giả/ông lão mặc áo vàng
哥哥们=các ca ca/các anh em
裘老大=Cừu lão Đại/Cừu lão đại
龙家人=người Long gia/người nhà họ Long
易千总=Dịch Thiên tổng/Dịch thiên tổng
好霸道的力量=lực lượng thật là bá đạo/sức mạnh thật là bá đạo
她们的表哥=biểu ca của các nàng /biểu ca của các nàng
红发老者=lão già tóc đỏ/Hồng phát lão giả/ông lão tóc đỏ
准某部咨行=chuẩn mỗ bộ tư hành/cứ như bản tư văn bộ mỗ
其它弟子=đệ tử khác/những đệ tử khác
城主府里=trong thành chủ phủ/trong phủ thành chủ
妙人儿=diệu nhân nhi/người đẹp
世家子=con cháu thế gia/con cháu nhà quan
令师妹=làm sư muội/lệnh sư muội
这股霸道的气流=cỗ khí lưu bá đạo kia/cổ khí lưu bá đạo kia
一个小弟=một tiểu đệ/một tên tiểu đệ
移动厕所=nhà vệ sinh di động/di chuyển nhà vệ sinh
疯老人=Phong lão nhân/lão già điên
邹家人=trâu gia nhân/người Trâu gia
十四代弟子=đệ tử đời mười bốn/thập tứ đại đệ tử
旅店老板=lữ điếm lão bản/chủ khách sạn
第三境=đệ tam cảnh/cảnh giới thứ ba
许家人=Hứa gia nhân/người nhà họ Hứa
我的家乡=quê hương của ta/gia hương của ta/quê quán của ta
单兄弟=Đan huynh đệ/Thiện huynh đệ
他家里=trong nhà hắn/gia đình hắn
为主导=làm chủ đạo/thành chủ đạo
小舍人=thiếu gia/tiểu công tử
爱漂亮=yêu đẹp/chủ nghĩa thẩm mỹ
马赫主义=tư tưởng Ma-khơ/chủ nghĩa kinh nghiệm phê phán
好霸道=thật bá đạo/thật là bá đạo
费家人=người Phí gia/người nhà họ Phí
戴老师=Đới lão sư/cô Dai
你们的全家=cả nhà của các ngươi/toàn gia của các ngươi
我叔叔婶婶=cô chú ta/thúc thúc thẩm thẩm ta
杜口裹足=bịt miệng bó chân/quá sợ hãi để di chuyển hoặc nói
海叔叔=chú Hải/Hải thúc thúc
吸水沙疙瘩=Quái mụn hút thủy cát/{Quái mụn hút thủy cát}
长老会的敌人=địch nhân của trưởng lão hội/kẻ địch của trưởng lão hội
那弟子=đệ tử kia/vậy đệ tử
老女人=lão bà/bà già
七万亿=bảy ngàn tỷ/7000 tỉ
一个圈套=một cái bẫy/một cái bẫy
这大家伙=đại gia hỏa này/những người kia
家常豆腐=đậu phụ chiên sốt tương cay/đậu phụ gia đình/đậu phụ kiểu nhà
飘然而来=bồng bềnh mà tới/phiêu nhiên nhi lai
老人的面前=trước mqt của lão nhân/trước mặt ông lão
这样的家伙=dạng này gia hỏa/kẻ như vậy/tên gia hỏa như vậy/tên như vậy
赵副县长=Triệu phó huyền trưởng/Triệu phó chủ tịch huyện
刘副县长=Lưu phó huyện trưởng/Lưu phó chủ tịch huyện
这些家伙=bọn gia hỏa này/những người này/những cái thứ này/bọn người kia/đám người kia
在家族之中=trong gia tộc/ở trong gia tộc
数十亿里=mấy tỷ dặm/mấy tỉ dặm
第七境=đệ thất cảnh/cảnh giới thứ bảy
行千总=Hành Thiên tổng/Hành thiên tổng
其他国家=quốc gia khác/những quốc gia khác
你家园=quê hương của ngươi/gia viên của ngươi
单老兄=Đan lão huynh/Thiện lão huynh
这老头=lão nhân này/lão đầu này/ông lão này
那老婆子=vậy lão bà tử/lão bà tử kia
那老头子=này lão đầu tử/lão đầu tử kia/lão già kia
天千总=Thiên Thiên tổng/Thiên thiên tổng
其他的弟子=những đệ tử khác/các đệ tử khác
那小家伙=tiểu gia hỏa kia/tiểu tử kia/tiểu từ kia
我女儿=nữ nhi của ta/con gái của ta
一百四十亿=mười bốn tỷ/14 tỉ
三儿子=tam nhi tử/con thứ ba/ba con trai
胖老头=lão đầu mập/lão mập
单总管=Đan tổng quản/Thiện tổng quản
这帮老头子=đám lão đầu tử này/đám lão già này
任副县长=nhậm phó chủ tịch huyện/Nhâm phó chủ tịch huyện
最为主要=chính yếu nhất/chủ yếu nhất
本小姐=bản tiểu thư/bổn tiểu thư/cô Ben
移动着=di động tới/di động
你的学生=học sinh của ngươi/đệ tử của ta
小侄儿=tiểu chất nhi/cháu nhỏ
大哲学家=đại triết học gia/nhà triết học lớn
秦总裁=Tần tổng tài/tổng giám đốc Tần
那些大人们=các đại nhân kia/đám người lớn kia
大哥哥=đại ca ca/anh Cả
对姐弟=đôi tỷ đệ/đôi chị em
一个个都是=mỗi một cái đều là/mỗi một người đều là
叶家的人=Diệp gia người/người của Diệp gia
武小王爷=Vũ tiểu Vương gia/Vũ tiểu vương gia
鹿千总=Lộc Thiên tổng/Lộc thiên tổng
这个老头子=cái lão nhân này/lão đầu tử này/lão già này
谢谢师姐=tạ tạ sư tỷ/cám ơn sư tỷ
国家公园=vườn quốc gia/công viên quốc gia/Công viên Quốc gia/Công viên quốc gia, vườn quốc gia
雪走=tuyết tẩu/Yubashiri
大人的意思=đại nhân ý tứ/ý của đại nhân
本门的弟子=đệ tử của bổn môn/đệ tử của bản môn
马走日象走田=mã tẩu nhật tượng tẩu điền/mã đi chữ Nhật tượng đi chữ Điền
遗忘之地=di vong chi địa/vùng đất bị lãng quên
他们的家族=gia tộc của bọn hắn/gia tộc của bọn họ
萧家人=người Tiêu gia/người nhà họ Tiêu
乘興而來=thừa hứng nhi lai/nhân hứng mà lại
那只老狐狸=lão hồ ly kia/con cáo già kia
左小王爷=Tả tiểu Vương gia/Tả tiểu vương gia
老参须=rễ sâm già/rễ sâm/lão tham tu
老者的眼睛=ánh mắt của lão giả/con mắt của ông lão
正八儿经=chính bát nhi kinh/chính bát nhi kinh (*)
单公子=Đan công tử/Thiện công tử
拜把子兄弟=bái làm huynh đệ chết sống/bái làm huynh đệ sống chết có nhau
心血管专家=chuyên gia tim mạch/chuyên gia về tim mạch/Chuyên gia về tim mạch
兄弟的性命=tính mạng của huynh đệ/tính mạng của huynh đệ
第十二幅=bức thứ mười hai/đệ thập nhị phúc
这些公子哥=những công tử ca này/các vị công tử này
当冤大头=làm coi tiền như rác/làm công tử Bạc Liêu
老者戒之在得=lão giả giới chi tại đắc/người già phải răn ở sự tham
你们班主=chủ gánh các ngươi/ban chủ các ngươi
代弟子=đời đệ tử/đại đệ tử
金人缄口=ăn nói thận trọng/Hình dung nói năng thận trọng. § ◇Khổng Tử gia ngữ 孔子家語: Khổng Tử quan Chu/toại nhập Thái Tổ Hậu Tắc chi miếu
这个公子=công tử này/người công tử này
李家人=người Lý gia/người nhà họ Lý
国家主席=chủ tịch quốc gia/chủ tịch nước
我的儿子=con của ta/nhi tử của ta/con trai của ta
什么风声=phong thanh gì/cái gì tin tức
地方民族主义=chủ nghĩa dân tộc hẹp hòi/chủ nghĩa dân tộc địa phương/đầu óc địa phương
这老汉=lão hán này/người lão hán này
第十根=đệ thập cây/cây thứ mười
她的手机号=số di động của nàng/số điện thoại di động của nàng
你们大人=đại nhân các ngươi/người lớn các ngươi
方家的敌人=địch nhân của Phương gia/kẻ địch của Phương gia
苏维埃社会主义共和国联盟=Liên bang Cộng hòa Xã hội chủ nghĩa Xô viết/Liên bang Cộng hòa xã hội chủ nghĩa Xô viết
社会主义改造=cải tạo xã hội chủ nghĩa/cải cách xã hội chủ nghĩa
循牆而走=tuần tường nhi tẩu/men tường mà chạy
第八重=đệ bát trọng/tầng thứ tám
单先生=Đan tiên sinh/Thiện tiên sinh
他们的老板=lão bản của bọn hắn/ông chủ của bọn họ
程家人=người Trình gia/người nhà họ Trình
大妹子=Đại muội tử/em gái lớn
她爷爷=gia gia của nàng/gia gia nàng
孟德尔主义=tư tưởng Men-đen/thuyết di truyền học Men-đen
水手们=các thủy thủ/bọn/đám thủy thủ/bọn : đám thủy thủ/bọn thuỷ thủ/bọn thủy thủ
书法大家=thư pháp đại gia/bậc thầy thư pháp
长生不老药=thuốc trường sinh bất lão/trường sinh bất lão dược
第一!=đệ nhất!/số một!
别的长老=các trưởng lão khác/trưởng lão khác
西方国家=quốc gia phương tây/các nước phương Tây
好兄弟=hảo huynh đệ/huynh đệ tốt/anh em tốt
承上文而言=tiếp theo đoạn văn trên mà nói/thừa thượng văn nhi ngôn
"那师母="Vậy sư mẫu/”Cái kia sư mẫu
嫁出去的女儿=gả ra ngoài nữ nhi/nữ nhi đã gả ra ngoài
鸟大爷=Điểu đại gia/đại gia chim
越师姐=Việt sư tỷ/Việt sư tỷ
用手机=dùng di động/lấy di động
富家公子=phú gia công tử/công tử nhà giàu
她们的眼帘=tầm mắt của các nàng/khoé mắt của các nàng
雨小王爷=Vũ tiểu Vương gia/Vũ tiểu vương gia
第一代弟子=đệ tử đời thứ nhất/đệ nhất đại đệ tử
我二叔=Nhị thúc ta/nhị thúc của ta
谢谢哥哥=cảm ơn ca ca/cám ơn ca ca
他们的爷爷=gia gia của bọn hắn/gia gia của bọn họ
抢人家=cướp người ta/đoạt nhân gia
第一回合=hiệp một/đệ nhất hiệp/hiệp thứ nhất/Lượt đi
为关门弟子=làm quan môn đệ tử/là quan môn đệ tử
飘然而落=bồng bềnh hạ xuống/phiêu nhiên nhi lạc
神之国度=Thần Chi Quốc Độ/quốc gia của thần
单堂主=Đan đường chủ/Thiện đường chủ
亲爱的儿子=thân ái nhi tử/con trai cưng ơi
这个帮主=cái bang chủ này/người bang chủ này
她的女儿=nữ nhi của nàng/con gái của nàng
别的兄弟=các huynh đệ khác/huynh đệ khác
这个堂主之位=cái chức đường chủ này/cái chức đường chủ kia
唱歌跑调=hát lạc nhịp/ca hát và chạy
小姐的能力=tiểu thư năng lực/năng lực của tiểu thư
本宗主=Bổn tông chủ/bản tông chủ
伸手一指=chỉ một ngón tay/chỉ tay một cái
肖堂主=Tiếu Tiếu chủ/Tiếu đường chủ
樊大小姐=Phàn [đại tiểu thư/Phàn đại tiểu thư/Phiền đại tiểu thư
熊老三=Hùng lão Tam/Hùng lão tam
二儿子=nhị nhi tử/con thứ hai
七百多亿=hơn bảy mươi tỷ/hơn 70 tỉ
你们两兄弟=hai huynh đệ các ngươi/hai anh em ngươi
天小王爷=Thiên tiểu Vương gia/Thiên tiểu vương gia
加深印象=gia thêm ấn tượng/làm sâu sắc thêm ấn tượng/để tạo ấn tượng sâu sắc hơn với ai đó
大人情=đại nhân tình/ân huệ lớn/nhân tình lớn
不为所动=bất vi sở động/không hề bị lay động/không di chuyển/vẫn không bị lay động
老乌龟=lão ô quy/con rùa già
那个国家=quốc gia kia/quốc gia nào
云宗主=Vân tông chủ/Vân Tông chủ
母亲身边=bên người mẫu thân/bên cạnh mẫu thân
自己地女儿=nữ nhi của mình/nữ nhi của chính mình
各家学说=các gia học thuyết/học thuyết của mỗi gia đình
老婆的话=lão bà/lời của lão bà
我的好妹子=hảo muội tử của ta/em gái ngoan của ta
雷副县长=Lôi phó huyện trưởng/Lôi phó chủ tịch huyện
引而伸之=dẫn nhi thân chi/kéo cho duỗi ra
单老太=Đan lão thái/Thiện lão thái
行屍走肉=hành thi tẩu nhục/The Walking Dead
这家伙=gia hỏa này/người này/thằng này/gia hoả này/cái tên này/tên này
软妹子=nhuyễn muội tử/em gái mềm mại
傾耳而聽=khuynh nhĩ nhi thính/nghiêng tai mà nghe
路小王爷=Lộ tiểu Vương gia/Lộ tiểu vương gia
那老妇=lão phụ kia/bà lão kia
老娘的敌人=địch nhân của lão nương/kẻ địch của lão nương
这座府邸里面=trong tòa phủ đệ này/bên trong tòa phủ đệ này
你手机=điện thoại di động của ngươi/điện thoại di động ngươi
我的手机号码=số di động của ta/số điện thoại di động của ta
嫡系子弟=đích hệ tử đệ/con cháu đích tôn
十六计，走为上策=ba mươi sáu chước, chuồn là thượng sách/tam thập lục kế, tẩu vi thượng sách, ba mươi sáu chước, chước chuồn là hơn
这帮老家伙=đám lão gia này/đám lão già này
梅家人=người Mai gia/người nhà họ Mai
他的兄弟姐妹=huynh đệ tỷ muội của hắn/anh chị em của hắn
单师爷=Đan sư gia/Thiện sư gia
班主任老师=giáo viên chủ nhiệm/lão sư chủ nhiệm lớp
你的手机号=số di động của ngươi/số điện thoại di động của ngươi
跪父母=lạy phụ mẫu/lạy cha mẹ
综合办=phòng làm việc tổng hợp/phòng tổng hợp
臭老头=Xú lão đầu/lão già thối tha/lão đầu thối/ông già thối
那个妹妹=cô em gái kia/cô muội muội kia
钟千总=Chung Thiên tổng/Chung thiên tổng
我的主意=ta chủ ý/chủ ý của ta
电话交换机=tổng đài điện thoại/chuyển đổi điện thoại/Tổng đài điện thoại
他们的妹妹=muội muội của bọn hắn/em gái của bọn họ
马小王爷=Mã tiểu Vương gia/Mã tiểu vương gia
好哥哥=hảo ca ca/Anh trai tốt/Người anh hảo
谢家人=người Tạ gia/người nhà họ Tạ
单老弟=Đan lão đệ/Thiện lão đệ
我们的女儿=nữ nhi của chúng ta/con gái của chúng ta
儿子的事情=nhi tử sự tình/chuyện của con
师妹的性命=tính mạng của sư muội/tính mạng của sư muội
长老身上=trưởng lão trên người/trên người trưởng lão
她的仇家=cừu gia của nàng/kẻ thù của nàng
鹿师弟=Lộc sư đệ/Lộc  sư đệ
四阿哥=Tứ a ca/Tứ A Ca
叶小姐=Diệp tiểu thư/cô Diệp
大人的东西=đại nhân đồ vật/đồ vật của người lớn
这儿子=này nhi tử/con trai này/cái này con trai/đứa con trai này
单哥哥=Đan ca ca/Thiện ca ca
黄衣长老=Áo Vàng trưởng lão/trưởng lão áo vàng
叠加起来=điệp gia lên/chất chồng lên
那人家=vậy nhân gia/nhà kia/kia nhân gia/này nhân gia
你的妹妹=muội muội của ngươi/em gái của ngươi
古老的文字=cổ lão văn tự/chữ viết xa xưa
梦家人=Mộng gia người/người Mộng gia/người nhà họ Mộng
大总管=Đại tổng quản/tổng giám đốc
小粉红=tiểu phấn hồng/màu hồng nhỏ/những người theo chủ nghĩa dân tộc mạng trẻ tuổi của Trung Quốc
雨宗主=Vũ tông chủ/Vũ Tông chủ
子事父母=tử sự phụ mẫu/con thờ cha mẹ
何等的霸道=bực nào bá đạo/bá đạo bực nào
核心弟子们=các hạch tâm đệ tử/các đệ tử hạch tâm
亿分之一=một phần ức/một phần tỷ/một phần trăm triệu
补缀乾坤=quản lý quốc gia/cai trị đất nước
众外门弟子之中=trong những ngoại môn đệ tử/trong những đệ tử ngoại môn
第三等=đệ tam đẳng/cấp thứ ba
这样的人家=nhà như vậy/cái dạng này nhân gia
我的母亲=mẫu thân của ta/mẹ của ta
四朝元老=nguyên lão bốn triều/tứ triều nguyên lão
领主们=các lãnh chúa/các lĩnh chủ
眩晕之中=trong mê muội/trong hôn mê
他的妹妹=muội muội của hắn/em gái của hắn
母亲的事情=mẫu thân sự tình/chuyện của mẫu thân
一张底牌=một con át chủ bài/một lá bài tẩy
单师姐=Đan sư tỷ/Thiện sư tỷ
你的仇家=cừu gia của ngươi/kẻ thù của ngươi
那化妆师=thợ trang điểm kia/người chuyên gia trang điểm kia
第四纪地质学=địa chất kỷ đệ tứ/Địa chất đệ tứ
学家们=đám học giả/các học gia
那位老板=vị lão bản kia/vị ông chủ kia
单大小姐=Đan đại tiểu thư/Thiện đại tiểu thư
方副县长=Phương phó huyện trưởng/Phương phó chủ tịch huyện
文无第一=văn vô đệ nhất/văn không có đệ nhất
来杀我儿子=tới giết con của ta/tới giết nhi tử của ta/tới giết con ta
马家人=người Mã gia/người nhà họ Mã
罗家人=người La gia/người nhà họ La
陶千总=Đào Thiên tổng/Đào thiên tổng
第一对=đôi thứ nhất/thứ nhất đối/đệ nhất đối
自己的老公=lão công của mình/chồng của mình
强大的人物=nhân vật cường đại/cường đại nhân vật
最古老=cổ xưa nhất/xưa nhất/cổ lão nhất
米小王爷=Mễ tiểu Vương gia/Mễ tiểu vương gia
央人作保=ương nhân tác bảo/cầu cạnh người làm bầu chủ
百乘之家=bách thặng chi gia/nhà có trăm cỗ xe
人类的国度=quốc gia của nhân loại/quốc độ của nhân loại/quốc gia của con người
他们的姐姐=tỷ tỷ của bọn hắn/tỷ tỷ của bọn họ
萧总裁=Tiêu tổng tài/tổng giám đốc Tiêu
霸道的力量=lực lượng bá đạo/sức mạnh bá đạo
她的屁股眼=lỗ đít nàng/lỗ nhị của nàng
五小王爷=Ngũ tiểu Vương gia/Ngũ tiểu vương gia
比武台上=đài luận võ bên trên/trên đài tỷ võ
你的老朋友=lão bằng hữu của ngươi/bạn cũ của ngươi
你爷爷=gia gia ngươi/gia gia của ngươi
本小姐的手掌心=lòng bàn tay của bản tiểu thư/lòng bàn tay của bổn tiểu thư
谢总裁=Tạ tổng tài/tổng giám đốc Tạ
在唱歌=tại hát/đang hát/đang ca
这些外门弟子=những ngoại môn đệ tử này/những đệ tử ngoại môn này
一个多情=một cái đa tình/một kẻ đa tình
叶老三=DIệp lão tam/Diệp lão tam
楚家人=Sở gia nhân/người nhà họ Sở
老者的意思=ý của lão giả/ý của ông lão
下第一=dưới đệ nhất/loại kém nhất
丈人家=trượng nhân gia/nhà bố vợ
他大哥=đại ca hắn/đại ca của hắn
传三过四=nói chuyện tầm phào/nói chuyện bá láp
归公子=thuộc về công tử/Quy công tử
那名老者=tên lão giả kia/người lão giả kia
曼德家族=Mạn Đức Gia Tộc/gia tộc Mạn Đức
当亲妹妹一般对待=đối đãi như thân muội muội/đối đãi như em gái ruột
我们大哥=đại ca của chúng ta/đại ca chúng ta
其他兄弟=các huynh đệ khác/những huynh đệ khác
你们的头儿=lão đại của các ngươi/thủ lĩnh của các ngươi
田小王爷=Điền tiểu Vương gia/Điền tiểu vương gia
拿出手机=lấy điện thoại di động ra/cầm ra di động/lấy di động/lấy điện thoại ra
还要大上=còn muốn lớn hơn/càng lớn hơn
莫宗主=Mạc tông chủ/Mạc Tông chủ
孔小王爷=Khổng tiểu Vương gia/Khổng tiểu vương gia
他的家庭=gia đình của hắn/gia đình của hẳn
这两者=hai cái này/hai người này
城主府中=trong phủ thành chủ/trong thành chủ phủ
顾家人=người Cố gia/người nhà họ Cố
单老二=Đan lão nhị/Thiện lão nhị
十五代弟子=đệ tử đời mười lăm/thập ngũ đại đệ tử
双糖=di-sa-ca-rít/disacarít
好妹妹=hảo muội muội/em gái ngoan/em gái tốt
自己老大=lão đại của mình/lão đại mình
哪位大人=vị đại nhân kia/vị đại nhân nào
灰袍老者=Hôi bào lão giả/ông lão áo xám
自忖有些实力的家族=gia tộc tự nghĩ có chút thực lực/gia tộc tự nghĩ có chút  thực lực
你老人家=lão nhân gia người/lão nhân gia ngươi
算命老头=lão đầu coi bói/lão đầu xem bói
这个老妪=lão ẩu này/bà lão này
长老外=trưởng lão ngoài ra/trường lão ngoài ra
付一个亿=trả một tỷ/trả một trăm triệu
外门弟子们=các ngoại môn đệ tử/các đệ tử ngoại môn
一个模特儿=một người mẫu/một model
我们的老朋友=lão bằng hữu của chúng ta/bạn cũ của chúng ta
黄家人=người Hoàng gia/người nhà họ Hoàng
这座府邸之中=trong tòa phủ đệ này/bên trong tòa phủ đệ này
老人的心理=lão nhân tâm lí/tâm lý của ông lão
她的主子=chủ tử của nàng/chủ nhân của nàng
一门之主=nhất môn chi chủ/môn chủ một môn phái
未来老公=chồng tương lai/lão công tương lai
弟弟妹妹们=các đệ đệ muội muội/đám đệ đệ muội muội
你娘亲=mẫu thân ngươi/mẹ ngươi
我的老板=lão bản của ta/ông chủ của ta
那些个=những cái này/những cái này
谢谢大姐=tạ tạ đại tỷ/cảm ơn đại tỷ
三小姐=Tam tiểu thư/cô Ba
教人家=dạy người ta/giáo nhân gia
那老夫=vậy lão phu/lão phu kia
国家安全=an toàn quốc gia/an ninh quốc gia
你的家庭=gia đình của ngươi/gia đình của bạn
谢谢少爷=cám ơn thiếu gia/cảm tạ thiếu gia
内门弟子中=trong nội môn đệ tử/trong đệ tử nội môn
小主人=tiểu chủ nhân/chủ sở hữu nhỏ
总检察长=tổng kiểm sát trường/tổng chưởng lý
寻常人家=gia đình bình thường/tầm thường nhân gia
牡丹虽好全凭绿叶扶持=mẫu đơn tuy đẹp, nhưng vẫn phải dựa vào lá nâng/mẫu đơn tuy đẹp nhưng cần lá đến đỡ
第四重天=đệ tứ trọng thiên/tầng thứ bốn
教导主任=thầy chủ nhiệm/chủ nhiệm giáo dục/giám đốc giáo dục/giám đốc giảng dạy
更加入=vừa gia nhập/càng gia nhập hơn
在家族=ở gia tộc/khi gia tộc
麻小王爷=Ma tiểu Vương gia/Ma tiểu vương gia
家主的嫡长子=con trai lớn của gia chủ/con trưởng đích tôn của gia chủ
人民民主专政=chuyên chính dân chủ nhân dân/chế độ độc tài dân chủ nhân dân
六万亿=sáu ngàn tỷ/6000 tỉ
尽地主之谊=tận tình địa chủ hữu nghị/tận tình địa chủ/đóng vai trò là người dẫn chương trình
这老妪=lão ẩu này/bà lão này
十一代弟子=đệ tử đời mười một/thập nhất đại đệ tử
着手机=điện thoại di động/cầm di động
第二强=mạnh thứ hai/đệ nhị cường
公子少爷们=các công tử thiếu gia/các công tử thiểu gia
霸道无比的力量=lực lượng vô cùng bá đạo/sức mạnh vô cùng bá đạo
他们的家世学问=gia thế học vấn của bọn họ/gia thế học vấn của bọn hắn
老疯子=lão già điên/Lão phong tử/lão điên/ông già điên
第九重天=đệ cửu trọng thiên/tầng thứ chín
兄弟情谊=tình nghĩa huynh đệ/tình anh em
大老虎=đại lão hổ/con cọp lớn/con hổ lớn
百足之虫死而不僵=côn trùng trăm chân chết còn giãy giụa/bách túc chi trùng tử nhi bất cương/trâu bò vãi đạn/bách túc chi trùng tử nhi bất cương (Chú thích: Côn trùng trăm chân, đến chết vẫn còn giãy dụa)/rắn chết vẫn còn nọc/Bách túc: con rết trăm chân, chết mà không ngã, dùng để hình dung nhân vật,  quý tộc hoặc hào môn thế gia có thế lực to lớn, tuy đã suy bại nhưng sức ảnh hưởng vẫn còn tồn tại
掌盘子=thổ phỉ lão đại/trùm ăn cướp/chưởng bàn tử
好霸气=thật là khí phách/thật bá đạo
我们的身家=tài sản chúng ta/thân gia chúng ta
宁公子=Ninh công tử/Ninh công tử
日益增加=gia tăng hàng ngày/tăng hàng ngày
玩着手机=ngoạn di động/chơi với điện thoại di động
妾本儒家女=thiếp tôi vốn là con gái nhà học trò/thiếp bản nho gia nữ
侃侃而談=khản khản nhi đàm/cứng cỏi mà nói
二爷爷=Nhị gia gia/ông hai
幕后老板=sau màn lão bản/lão bản sau màn/Ông Trùm giấu mặt
叶鞘=đọt/ngọn/lá chủ
老人的右手=tay phải của lão nhân/tay phải của ông lão
这个中年大叔=trung niên đại thúc này/vị đại thúc tuổi trung niên này
遗弃之地=di khí chi địa/vùng đất bị vứt bỏ/Di Khí Chi Địa
单弟弟=Đan đệ đệ/Thiện đệ đệ
家族之间=giữa gia tộc/trong gia tộc
剑走偏锋=kiếm tẩu thiên phong/phá cách/không theo khuôn mẫu/không theo cách thường/không theo lẽ thường/kiếm đi thiên phong/Jian Zoupianfeng, bút danh của tiểu thuyết gia hiện đại sung mãn
手机铃声=chuông điện thoại di động/chuông điện thoại/nhạc chuông điện thoại di động
国之重臣=trọng thần một nước/quốc gia trọng thần
那个老板娘=bà chủ kia/lão bản nương kia
单老先生=Đan lão tiên sinh/Thiện lão tiên sinh
正主任=chính chủ nhiệm/chính chủ nhiệm
姐姐的威严=uy nghiêm của tỷ tỷ/uy nghiêm của  tỷ tỷ
攀鲈=cá rô đồng/cá rô/Cá rô
斲轮老手=người giàu kinh nghiệm/tay lão luyện
大爷大妈=đại gia đại mụ/bác trai bác gái/bác gái
第三代弟子=đệ tử đời thứ ba/đệ tam đại đệ tử
干部们=các cán bộ/đám cán bộ
主动技能=kỹ năng chủ động/active skill
终身不娶=cả đời không lập gia đình/cả đời không cưới/không kết hôn suốt đời
王家人=Vương gia nhân/người Vương gia/người nhà họ Vương
候小王爷=Hậu tiểu Vương gia/Hậu tiểu vương gia
大伯家=nhà đại bá/nhà bác
疯老道=lão đạo điên/Phong lão đạo
胸無主宰=hung vô chủ tể/như sách Sử ký nói/trong lòng không trung thành với ai
账房先生=tiên sinh kế toán/ông Phòng/kế toán
人间一切=nhân gian nhất thiết/nhân gian tất cả
周副县长=Chu phó huyện trưởng/Chu phó chủ tịch huyện
既来之则安之=nhập gia tùy tục/sống ở đâu thì theo phong tục ở đấy/đã đến rồi thì nên ở lại/đã tới thì an tâm ở lại
太傅大人=Thái Phó đại nhân/thái phó đại nhân
这殿主=điện chủ này/người điện chủ này
门不当户不对=môn không đăng hộ không đối/môn bất đương hộ bất đối/không môn đăng hộ đối/môn bất đăng hộ bất đối/cửa không đúng hộ gia đình là sai
大地主=đại địa chủ/chủ đất/một chủ đất lớn
大鱼儿=cá lớn/Đại Ngư nhi
归教主=quy giáo chủ/Quy giáo chủ
十大长老=thập đại trường lão/thập đại trưởng lão
那些兄弟们=những huynh đệ kia/các huynh đệ kia
皇室成员=thành viên hoàng thất/thành viên hoàng gia
你们的仇家=cừu gia của các ngươi/kẻ thù của các ngươi
破坏专家=chuyên gia phá hoại/phá hủy các chuyên gia
这帮家伙=đám gia hoả này/tên gia hỏa này/đám người này
铁兄弟=huynh đệ thân thiết/Thiết huynh đệ
城主府里面=trong thành chủ phủ/trong phủ thành chủ
那户人家=gia đình kia/nhà nào
老人的身体=thân thể của lão nhân/thân thể của ông lão
边小王爷=Biên tiểu Vương gia/Biên tiểu vương gia
麻师弟=Ma sư đệ/Ma  sư đệ
仲第=trọng đệ/em thứ hai
钟小王爷=Chung tiểu Vương gia/Chung tiểu vương gia
花大价钱=dùng nhiều tiền/bỏ ra số tiền lớn/dùng giá cao
小先生=Tiểu tiên sinh/tiểu giáo viên/ông Xiao
肖家人=người Tiếu gia/người nhà họ Tiếu
这家长=người gia trưởng này/này gia trưởng
美女主播=mỹ nữ chủ bá/người dẫn chương trình xinh đẹp
她母亲=mẫu thân của nàng/mẫu thân nàng
三十亿=ba tỷ/ba tỉ
那府邸=phủ đệ kia/tòa phủ đệ kia
九叔公=cửu thúc công/Cửu thúc công
单老三=Đan lão tam/Thiện lão tam
这具身体的主人=chủ nhân của cái thân thể này/chủ nhân thân thể này
苍老身影=thân ảnh già nua/thương lão thân ảnh
母胎SOLO=độc thân từ trong trứng/solo mẹ và thai nhi
单老头=Đan lão đầu/Thiện lão đầu
主要防守力量=lực lượng phòng thủ chủ yếu/sức mạnh phòng thủ chủ yếu
蔡乡长=Thái hương trưởng/Thái chủ tịch xã
老师的问题=lão sư vấn đề/vấn đề của lão sư
卡路里=Ca-lo-ri/ca-lo-ri
杜家人=người Đỗ gia/người nhà họ Đỗ
单老板=Đan lão bản/Thiện lão bản
其他家族=gia tộc khác/những gia tộc khác
青山堂主=Thanh Sơn đường chủ/Thanh sơn đường chủ
我妹子=muội tử ta/em gái của ta
倍增加=gia tăng gấp bội/tăng lên gấp bội
那样的家伙=kẻ như vậy/gia hỏa như vậy
好姐姐=tỷ tỷ tốt/Hảo tỷ tỷ/chị gái tốt
易小王爷=Dịch tiểu Vương gia/Dịch tiểu vương gia
大帅哥=đại soái ca/đại suất ca/anh chàng đẹp trai
第一秘书=thư ký thứ nhất/đệ nhất bí thư
周某人=Chu mỗ nhân/tên Chu nào đó
老司机=lão tài xế/tài xế già/người lái xe cũ/một bàn tay cũ tại cái gì đó
我师姐=sư tỷ ta/sư tỷ của ta
我的家人=người nhà của ta/gia nhân của ta
方主播=chủ kênh họ Phương/streamer họ Phương
大堂姐=đại đường tỷ/chị Đại Sảnh
老人的攻击=công kích của lão nhân/sự công kích của lão nhân
四十多亿=hơn bốn tỷ/hơn bốn tỉ
那些内门弟子=những nội môn đệ tử kia/những đệ tử nội môn kia
这个主意=cái chủ ý này/ý đồ này
自己的妹夫=muội phu của mình/em rể của mình
单老儿=Đan lão nhi/Thiện lão nhi
小学弟=tiểu học đệ/em trai tiểu học
三谷主=tam cốc chủ/Tam cốc chủ
那女孩儿=nữ hài nhi kia/cô bé gái kia
单小王爷=Đan tiểu Vương gia/Đan tiểu vương gia/Thiện tiểu vương gia
孩儿他娘=mẹ hài nhi/mẹ bọn nhỏ/hài nhi mẹ nó
法网灰灰疏而不漏=pháp võng hôi hôi/sơ nhi bất lậu
孙副县长=Tôn phó huyện trưởng/Tôn phó chủ tịch huyện
为老不尊=già mà không kính/già mà không đứng đắn/già mà mất nết/vì lão bất tôn
左倾机会主义=chủ nghĩa cơ hội/chủ nghĩa cơ hội 'tả khuynh'
大兄弟=đại huynh đệ/ông anh/người anh em lớn
老人的脸色=sắc mặt của lão nhân/sắc mặt của ông lão
顾家公子=Cố gia công tử/công tử nhà họ Cố
轻咦一声=khẽ di một tiếng/khẽ ồ lên một tiếng
大国主=đại quốc chủ/Ookuninushi
新家族=gia tộc mới/gia tộc mới
毛主义=Mao chủ nghĩa/Chủ nghĩa Mao
小手机=điện thoại di động/điện thoại di động nhỏ/nhỏ di động
这果子=cái quả này/trái cây này/trái cây kia
房间的主人=gian phòng chủ nhân/chủ nhân của gian phòng
这个纨绔子弟=tên hoàn khố tử đệ này/tên con em nhà giàu này
方家人=người Phương gia/người nhà họ Phương
秦家人=người Tần gia/người nhà họ Tần
三小王爷=Tam tiểu Vương gia/Tam tiểu vương gia
拾級而豋=thiệp cấp nhi đăng/liền bước noi từng bực mà lên
正式弟子=đệ tử chính thức/đệ tử chính thức
江叔叔=Giang thúc thúc/chú Giang
大倒苦水=kêu ca kể khổ/đại đảo khổ thủy
家装设计=gia trang thiết kế/thiết kế trang trí nhà
如何收场=kết thúc như thế nào/kết cuộc như thế nào
乾爺=can gia/cha hờ
那个老师=lão sư kia/người lão sư kia
慈母多败儿=mẹ chiều con hư/Con hư tại mẹ/từ mẫu dạy hư con
第一军团=quân đoàn thứ nhất/đệ nhất quân đoàn
单家族=Đan gia tộc/Thiện gia tộc
大头目=Đại đầu mục/ông chủ
这位老妪=vị lão ẩu này/vị bà lão này
第一人=đệ nhất nhân/người thứ nhất/người số một
總經理=tổng giám đốc/tổng kinh lý
冰可乐=cô ca lạnh/Coca băng
第一门派=môn phái thứ nhất/đệ nhất môn phái
牛嚼牡丹=trâu gặm mẫu đơn/bò nhai mẫu đan
农家人=người nhà nông/người Nông gia
老朋友们=các lão bằng hữu/đám bạn già
那些老头子=những lão đầu tử kia/những lão già kia
仓廪实而知礼节=kho lương đầy mới biết lễ tiết/thương lẫm thực nhi tri lễ tiết
第九根=đệ cửu cây/cây thứ chín
异化系的卡片=card dị hóa/{card dị hóa}
叶家人=người Diệp gia/người nhà họ Diệp
掏出手机=lấy điện thoại cầm tay ra/lấy điện thoại di động ra/lấy di động ra/lấy điện thoại ra
矮个弟子=người đệ tử lùn/đệ tử lùn hơn
大长老的实力=đại trường lão thực lực/thực lực của đại trưởng lão
飘然而去=phiêu nhiên mà đi/phiêu nhiên nhi khứ/nhẹ nhàng đi
那个老妪=lão ẩu kia/bà lão kia
多加注意=gia tăng chú ý/chú ý thêm
黄副县长=Hoàng phó huyện trưởng/Hoàng phó chủ tịch huyện
那个老道士=lão đạo sĩ kia/cái lão đạo sĩ kia
好徒弟=hảo đồ đệ/đồ đệ tốt
握着手机=cầm di động/cầm điện thoại di động
第一阶=đệ nhất giai/cấp thứ nhất/cấp một
这老僧=lão tăng này/người lão tăng này
国家命运=vận mệnh quốc gia/số phận của đất nước
没人家=không nhân gia/không có nhân gia
这娃娃=oa nhi này/thằng nhóc này
敌人的家庭=gia đình của địch nhân/gia đình của kẻ địch
文长先生=Văn Trường tiên sinh/Văn trường tiên sinh
小母狗=tiểu mẫu cẩu/em chó cái
这个顽固老头=lão đầu ngoan cố này/lão già ngoan cố này
你们的儿女=con cái của các ngươi/nhi nữ của các ngươi
大人的事情=đại nhân sự tình/chuyện của người lớn
姐姐的身份=tỷ tỷ thân phận/thân phận của tỷ tỷ
我父母=cha mẹ ta/phụ mẫu ta
说些什么=nói cái gì/nói cái gì đó/nói những gì
七大家=thất đại gia/Thất Đại Gia Tộc
凤家人=người Phượng gia/người nhà họ Phượng
十三代弟子=đệ tử đời mười ba/thập tam đại đệ tử
武千总=Vũ Thiên tổng/Vũ thiên tổng
你的母亲=mẹ của ngươi/mẫu thân của ngươi
单老哥=Đan lão ca/Thiện lão ca
无理根=căn vô nghĩa/căn vô tỷ
家累千金坐不垂堂=gia luy thiên kim/tọa bất thùy đường
单师祖=Đan sư tổ/Thiện sư tổ
想打我的主意=có chủ ý với ta/muốn cua ta/có ý đồ nhằm vào ta
龟师弟=Quy sư đệ/Quy  sư đệ
单师妹=Đan sư muội/Thiện sư muội
唱作人=ca sĩ sáng tác/hát như một người đàn ông
铁家人=người Thiết gia/người nhà họ Thiết
连兄弟=liền huynh đệ/Liên huynh đệ
老少爷们=lão thiếu gia môn/đám già trẻ/các lão thiếu gia
我们老板=lão bản của chúng ta/lão bản chúng ta
买家具=mua gia cụ/mua gia cụ/mua đồ nội thất
其他的外门弟子=những ngoại môn đệ tử khác/những đệ tử ngoại môn khác
好老师=lão sư tốt/hảo lão sư
白家人=người Bạch gia/người nhà họ Bạch
我爷爷奶奶=ông bà của ta/gia gia nãi nãi của ta
单小弟=Đan tiểu đệ/Thiện tiểu đệ
小儿女=tiểu nhi nữ/các con nhỏ
这样的学员=đệ tử như vậy/học viên như thế
三十多亿=hơn ba tỷ/hơn ba tỉ
这老妇人=lão phụ nhân này/lão bà này
她弟弟=đệ đệ của nàng/đệ đệ nàng
小干部=tiểu cán bộ/cán bộ nhỏ
府邸里面=trong phủ đệ/bên trong tòa phủ đệ
这女孩儿=nữ hài nhi này/bé gái này
你的老婆=lão bà của ngươi/vợ của ngươi
丐帮的总舵=tổng đà của Cái Bang/tổng đà của Cái bang
你阿姨=a di ngươi/dì của ngươi
咱们家族=gia tộc chúng ta/gia tộc chúng ta
初中毕业=tốt nghiệp trung học/tốt nghiệp trung học đệ nhất cấp
一天下来=ngày kế/kết thúc mỗi ngày
单大姐=Đan đại tỷ/Thiện đại tỷ
我家公子=công tử nhà ta/Công tử nhà tôi
那狂野霸道的力量=lực lượng cuồng dã bá đạo kia/sức mạnh cuồng dã bá đạo kia
他的家园=gia viên của hắn/quê hương của hắn
他们的女儿=nữ nhi của bọn hắn/nữ nhi của bọn bọ/con gái của bọn họ
霸道无比=vô cùng quyết đoán/vô cùng bá đạo/vô cùng ngang ngược/vô cùng độc tài/vô cùng quân phiệt
国之大事=đại sự quốc gia/sự kiện quốc gia
行小王爷=Hành tiểu Vương gia/Hành tiểu vương gia
两三百亿=20-30 tỷ/20, 30 tỉ
陈家人=người Trần gia/người nhà họ Trần
未婚生子=chưa kết hôn đã có con/chưa lập gia đình có con
单大人=Đan đại nhân/Thiện đại nhân
他们的家属=người nhà của bọn hắn/gia thuộc của bọn họ
他的家人=người nhà của hắn/gia đình anh ta
三万亿=ba ngàn tỷ/3000 tỉ
伏特加=rượu Vodka/phục đặc gia
唐家人=người Đường gia/người nhà họ Đường
它的老婆=lão bà của nó/vợ của nó
这老师=lão sư này/người lão sư này
自己的姐夫=tỷ phu của mình/anh rể của mình
单师哥=Đan sư ca/Thiện sư ca
白班儿=ca ngày/kíp ngày
称兄道弟起来=xưng huynh đạo đệ/xưng huynh gọi đệ
单老爷=Đan lão gia/Thiện lão gia
那个小家伙=tiểu gia hỏa kia/tên tiểu tử kia
这家主=gia chủ này/người gia chủ này
母亲的照顾=chiếu cố của mẫu thân/chăm sóc của mẫu thân
我的老朋友=lão bằng hữu của ta/bạn cũ của ta
看下手机=xem di động/nhìn di động
我的仇家=cừu gia của ta/kẻ thù của ta
他弟弟=đệ đệ của hắn/đệ đệ hắn
那母亲=mẫu thân kia/vậy mẫu thân
你老公=lão công ngươi/chồng ngươi
昆虫标本=tiêu bản côn trùng/mẫu côn trùng/Tiêu bản côn trùng
几个人手=mấy người trợ thủ/mấy cái nhân thủ
对方的手机=điện thoại của đối phương/điện thoại di động của đối phương
她的移动=nàng di động/sự di động của nàng
打手机=gọi di động/đánh di động
家族的人=gia tộc người/người của gia tộc
那兄弟=huynh đệ kia/vậy huynh đệ
一蹦老高=nhất bính lão cao/nhảy lên thật cao
这老人=lão nhân kia/lão nhân này/ông già này
第一天才=đệ nhất thiên tài/thiên tài số một
学前期=giai đoạn mầm non/giai đoạn mẫu giáo
他们的老大=lão đại của bọn hắn/lão đại của bọn họ
你家小姐=tiểu thư nhà ngươi/cô gái nhà cô
这老头子=lão đầu tử này/lão già này
于姐姐=với tỷ tỷ/Vu tỷ tỷ
众外门弟子=bọn ngoại môn đệ tử/bọn đệ tử ngoại môn
玉家人=người Ngọc gia/người nhà họ Ngọc
赤杨=cây dương đỏ/cây tổng quán sủi
蒙大小姐=được đại tiểu thư/Mông đại tiểu thư
叶老二=DIệp lão nhị/Diệp lão nhị
本大人=bản đại nhân/bổn đại nhân
十四弟=thập tứ đệ/Thập tứ đệ/Thập Tứ đệ
那个老头=lão đầu kia/ông lão kia
自己的亲兄弟=anh em ruột của mình/huynh đệ ruột thịt của mình
蒙小王爷=Mông tiểu Vương gia/Mông tiểu vương gia
我小姨=tiểu di ta/dì ta
国家杯=cúp quốc gia/cúp quốc
阎家人=người Diêm gia/người nhà họ Diêm
离开家庭=rời gia đình/rời khỏi gia đình
五万亿=năm ngàn tỷ/5000 tỉ
这个老板=ông chủ này/người lão bản này
陶小王爷=Đào tiểu Vương gia/Đào tiểu vương gia
我老板=lão bản của ta/lão bản ta
这些大哥=những người đại ca này/những đại ca này
他们的老婆=lão bà của bọn hắn/vợ của bọn họ
你老婆=lão bà ngươi/vợ của ngươi
冷小王爷=Lãnh tiểu Vương gia/Lãnh tiểu vương gia
逃走的机会=cơ hội đào tẩu/cơ hội chạy trốn
曹家人=người Tào gia/người nhà họ Tào
叶家的家主=Diệp gia gia chủ/gia chủ của Diệp gia
第十二重=đệ thập nhị trọng/tầng thứ mười hai
这老者=lão giả này/người lão giả này
他们的哥哥=ca ca của bọn hắn/ca ca của bọn họ
最主要的目的=mục đích chính yếu nhất/mục đích chủ yếu nhất
国家政策=chính sách quốc gia/chính sách của nhà nước
我的学生=học sinh của ta/đệ tử của ta/học trò của ta
一翻白眼=trợn trắng mắt/nguýt một cái
这类外门弟子=thứ ngoại môn đệ tử này/thứ đệ tử ngoại môn này
死亡的威胁=tử vong uy hiếp/sự uy hiếp của cái chết
十二代弟子=đệ tử đời mười hai/thập nhị đại đệ tử
求人家=xin người ta/cầu nhân gia
它的女儿=nữ nhi của nó/con gái của nó
这个元老=nguyên lão này/người nguyên lão này
唰唰唰=bá bá bá/xoạt xoạt xoạt
这死老头=tử lão đầu này/lão già đáng chết này
关老家伙=quan lão gia này/quan lão gia này
你们的娘亲=mẹ ruột của các ngươi/mẫu thân của các ngươi
老兄们=các lão huynh/các lão huynh
零和博弈=trò chơi zero-sum/trò chơi tổng bằng không
第一大势力=đệ nhất đại thế lực/thế lực lớn số một
就是你姐=chính là tỷ tỷ của ngươi/chính là chị ngươi
城主府之中=trong thành chủ phủ/trong phủ thành chủ
他的老婆=vợ của hắn/lão bà của hắn/vợ của hắn ta
它的娘亲=mẹ ruột của nó/mẫu thân của nó
大处落墨=giải quyết việc quan trọng trước/nắm mấu chốt/tập trung công sức vào khâu chủ yếu
您的手机=điện thoại của ngài/di động của ngài
学弟学妹=học đệ học muội/đàn em và em gái
这小师妹=tiểu sư muội này/người tiểu sư muội này
这鬼天气=cái thời tiết mắc toi này/quỷ thiên khí này
为首的老者=lão giả dẫn đầu/ông lão dẫn đầu
他的娘亲=mẹ ruột của hắn/mẫu thân của hắn
你们的血肉=huyết nhục của các ngươi/máu thịt của các ngươi
其他弟子=đệ tử khác/những đệ tử khác
单小姐=Đan tiểu thư/Thiện tiểu thư
赏光参加=vui lòng mà tham gia/đánh giá cao mà tham gia
修者们=các tu giả/đám tu giả
他的手机号=số di động của hắn/số điện thoại di động của hắn
二万亿=hai ngàn tỷ/2000 tỉ
你的主子=chủ tử của ngươi/chủ nhân của ngươi
第一滴血=giọt máu đầu tiên/đệ nhất tích huyết
我的再生父母=tái sinh phụ mẫu của ta/cha mẹ sống lại của ta
心者道之主宰=tâm là cái chúa tể của đạo/tâm giả đạo chi chủ tể
我的好妹妹=hảo muội muội của ta/em gái ngoan của ta
可望而不可卽=trông thì rõ nhưng khó tới gần/khả vọng nhi bất khả tức/khá trông mà chẳng khá tới gần
时小姐=Thì tiểu thư/Thời tiểu thư
因为敌人的主力=nhóm chủ lực của địch nhân/nhóm chủ lực của kẻ địch
十八代弟子=đệ tử đời mười tám/thập bát đại đệ tử
这个老头=lão đầu này/ông lão này
三大家族之一=một trong tam đại gia tộc/một trong ba gia tộc lớn
穿着讲究=giải thích cường điệu/đục lỗ/khoan lỗ/giải thích cường điệu/ăn mặc cầu kỳ
敌人的主力=chủ lực của địch nhân/chủ lực của kẻ địch
张家的人=Trương gia người/người của Trương gia
毛千总=Mao Thiên tổng/Mao thiên tổng
他的父母=cha mẹ của hắn/phụ mẫu hắn/cha mẹ hắn
前台小姐=nhân viên lễ tân/lễ tân tiểu thư
六十多亿=hơn sáu tỷ/hơn 6 tỉ
林家人=người Lâm gia/Lâm gia nhân/người nhà họ Lâm
在家族里=trong gia tộc/ở trong gia tộc
对翅膀=đôi cánh/đôi cánh
海军总部=tổng bộ hải quân/Trụ sở Hải quân
本盟主=bổn minh chủ/bản minh chủ
顾副县长=Cố phó huyện trưởng/Cố phó chủ tịch huyện
叶老太=DIệp lão thái/Diệp lão thái
在玩儿=đang chơi/đang ngoạn nhi
温小王爷=Ôn tiểu Vương gia/Ôn tiểu vương gia
毛小王爷=Mao tiểu Vương gia/Mao tiểu vương gia
大民族主义=chủ nghĩa đại dân tộc/chủ nghĩa dân tộc lớn
她们的老板=lão bản của các nàng /lão bản của các nàng
我姐妹=tỷ muội ta/tỉ muội ta/tỷ muội của ta
敌人的主要攻击目标=mục tiêu công kích chủ yếu của địch nhân/mục tiêu công kích chủ yếu của kẻ địch
冷千总=Lãnh Thiên tổng/Lãnh thiên tổng
她的老板=lão bản của nàng/ông chủ của nàng
龙宗主=Long tông chủ/Long Tông chủ
什么大人物=đại nhân vật gì/đại nhân vật nào
任长老=Nhâm trưởng lão/Nhâm trường lão
他的仇家=cừu gia của hắn/kẻ thù của hắn
那个老人=lão nhân kia/ông già kia
单老前辈=Đan lão tiền bối/Thiện lão tiền bối
肖副县长=Tiếu phó huyện trưởng/Tiếu phó chủ tịch huyện
搬家公司=công ty dọn nhà/di chuyển công ty
最后一个=cái cuối cùng/người cuối cùng
老大的事情=lão đại sự tình/chuyện của lão Đại
七代弟子=đệ tử đời bảy/thất đại đệ tử
单大公子=Đan đại công tử/Thiện đại công tử
单妹妹=Đan muội muội/Thiện muội muội
十三姨娘=dì mười ba/thập tam di nương
吃霸王餐=ăn cơm chùa/ăn bữa ăn bá vương/Ăn quỵt
银发老者=lão giả tóc bạc/ngân phát lão giả/lão giả tóc bạch kim/ông lão tóc bạc
大师哥=đại sư ca/anh đại sư
单千总=Đan Thiên tổng/Đan thiên tổng
候师弟=Hậu sư đệ/Hậu  sư đệ
内门弟子们=các nội môn đệ tử/các đệ tử nội môn
哪个老板=người lão bản nào/ông chủ nào
我弟弟=đệ đệ ta/đệ đệ của ta
雨千总=Vũ Thiên tổng/Vũ thiên tổng
连手枪=cả súng ngắn/ngay cả súng lục
这位老板=vị lão bản này/vị ông chủ này
他们的师弟=sư đệ của bọn hắn/sư đệ của bọn họ
好女儿=con gái tốt/hảo nữ nhi
主殿中=trong chủ điện/trong chủ điện
附庸家族=gia tộc phụ thuộc/phụ dong gia tộc
最核心=trọng yếu nhất/cốt lõi nhất/chủ yếu nhất
联姻之事=chuyện thông gia/chuyện đám hỏi
担架上=trên cáng cứu thương/trên băng ca
英联邦=liên bang Anh/Khối thịnh vượng chung/Khối thịnh vượng chung của các quốc gia Anh
灵 镉 精=linh cách tinh- Cadmium/{linh cách tinh- Cadmium}
家族的力量=gia tộc lực lượng/lực lượng của gia tộc
八小王爷=Bát tiểu Vương gia/Bát tiểu vương gia
他们的家主=gia chủ của bọn hắn/chủ nhà bọn họ
他的女儿=nữ nhi của hắn/con gái của hắn
那个家庭=cái gia đình kia/gia đình nào
我的主子=chủ tử của ta/chủ nhân của ta
十七代弟子=đệ tử đời mười bảy/thập thất đại đệ tử
小哥哥=tiểu ca ca/anh trai nhỏ
第六重=đệ lục trọng/đệ lục trọng‘/tầng thứ sáu
瞬间移动=thuấn gian di động/di động trong nháy mắt/dịch chuyển tức thời/di chuyển ngay lập tức
任经理=chủ nhiệm quản lý/Nhâm quản lý
她的背景=bối cảnh sau lưng của nàng/gốc gác của nàng
本主任=bổn chủ nhiệm/bản chủ nhiệm
第七重=đệ thất trọng/tầng thứ bảy
历史题材=đề tài lịch sử/chủ đề lịch sử
胎位不正=thai ngược/vị trí thai nhi không chính xác/Thai ngược
夷考其行=di khảo kì hành/lấy lòng công bằng mà xét sự hành vi của người
身家殷實=thân gia ân thật/mình nhà giàu có
老者这样的人=người như lão giả/người như ông lão
他们的母国=mẫu quốc của bọn hắn/mẫu quốc của bọn họ
大先生=đại tiên sinh/ông Đại
白发老人=lão nhân tóc trắng/bạch phát lão nhân
你大爷=đại gia ngươi/đại gia mày
那老娘=vậy lão nương/bà lão kia
搬石头=khiêng đá/di chuyển đá
他们的娘亲=mẹ ruột của bọn hắn/mẫu thân của bọn họ
田主任=Điền chủ nhiệm/Giám đốc Điền
诸神的国度=chư thần quốc độ/quốc gia của chư thần
本老爷=bản lão gia/bổn lão gia
那个妹子=muội tử kia/cô em gái kia
那老贼=này lão tặc/người lão tặc kia
这块地方=cái địa phương này/khu vực này
田千总=Điền Thiên tổng/Điền thiên tổng
她家族=gia tộc của nàng/gia tộc nàng
十五亿=1.5 tỷ/mười lăm tỷ/1,5 tỉ
地底遗迹=di tích lòng đất/địa để di tích
为主上=là chủ thượng/là chủ nhân
貴介第=quý giới đệ/em tôn quý của ngài
三代弟子=đệ tử đời ba/Tam đại đệ tử
他的家底=của cải của nhà hắn/gia để của hắn
老家伙们=đám lão già này/các lão gia/đám lão già
第七重天=đệ thất trọng thiên/tầng thứ bảy
马克思主义理论=lý luận chủ nghĩa Marc/Lý thuyết Mác xít/Lý luận chủ nghĩa Mác
不主故常=không theo khuôn mẫu/không dính vào các quy ước cũ
单帮主=Đan bang chủ/Thiện bang chủ
话音落下=thoại âm rơi xuống/tiếng nói vừa ra/dứt tiếng/lời nói kết thúc/vừa dứt lời
在家族中=trong gia tộc/ở trong gia tộc
这些老家伙=những lão gia hỏa này/lão gia hỏa này
这家伙还是=gia hỏa này vẫn là/người này còn là
收回手机=lấy điện thoại lại/lấy lại điện thoại di động
眩晕内=trong mê muội/trong hôn mê
新玩意儿=trò mới/tân ngoạn ý nhi/có trò gì mới
他们的家庭=gia đình của bọn hắn/gia đình của bọn họ
精神病专家=chuyên gia tâm thần/chuyên gia về bệnh tâm thần/Chuyên gia bệnh tâm thần
这小家伙=tiểu gia hỏa này/tên tiểu tử này
家庭伦理=gia đình luân lí/đạo đức gia đình
两百五十亿=25 tỷ/25 tỉ
这个老家伙=lão gia hỏa này/cái lão gia hỏa này/lão già này
粉色祖母绿=đá beryl hồng/morganite/pink beryl/phấn sắc tổ mẫu lục
九代弟子=đệ tử đời chín/cửu đại đệ tử
他们的小弟=tiểu đệ của bọn hắn/tiểu đệ của bọn họ
那老人=lão nhân kia/ông già kia
他家族=gia tộc của hắn/gia tộc hắn
那个教主=giáo chủ kia/người giáo chủ kia
本帅哥=bổn suất ca/bản soái ca/anh chàng đẹp trai này
外门弟子之中=trong ngoại môn đệ tử/trong đệ tử ngoại môn
仰之彌高=ngưỡng chi di cao/ngửa lên trông thấy càng cao
裘二公子=Cầu nhị công tử/Cừu nhị công tử
傻儿子=nhi tử ngốc/con trai ngốc
任小王爷=Nhâm tiểu Vương gia/Nhâm tiểu vương gia
美丽的小姐=tiểu thư xinh đẹp/tiểu thư mỹ lệ
家具家电=gia cụ gia điện/đồ nội thất và thiết bị gia dụng
其他外门弟子=những ngoại môn đệ tử khác/những đệ tử ngoại môn khác
等人参加=đám/bọn người tham gia/đám người tham gia
"家"="nhà"/"gia"
单老师=Đan lão sư/Thiện lão sư
回家主=hồi gia chủ/bẩm gia chủ
兆吨=triệu tấn/ngàn tỷ tấn
大姐姐=đại tỷ tỷ/chị cả
他们的加入=sự gia nhập của bọn hắn/sự gia nhập của bọn họ
这个妹妹=cô muội muội này/cô em gái này
本长老=bản trưởng lão/bổn trưởng lão/Trưởng lão Ben
古老而久远=cổ lão mà cửu viễn/cổ lão mà xa xưa
家族传统=truyền thống dòng họ/truyền thống gia tộc
本阁主=bản Các chủ/Bổn các chủ
风千总=Phong Thiên tổng/Phong thiên tổng
单盟主=Đan minh chủ/Thiện minh chủ
在打我的主意=đánh ta chủ ý/đang có ý đồ xấu với ta
妖孽哥=Yêu nghiệt đại ca/{Yêu nghiệt đại ca}
自己女儿=nữ nhi của mình/nữ nhi mình
你们的身家=tài sản của các ngươi/thân gia của các ngươi
这玩意儿=cái đồ chơi này/cái trò này/món đồ này/cái đồ vật này
第三军团=quân đoàn thứ ba/đệ tam quân đoàn
姬大小姐=Cừu đại tiểu thư/Cơ đại tiểu thư
主建筑=kiến trúc chủ đạo/kiến trúc chủ
那大哥=vậy đại ca/đại ca kia
单大叔=Đan đại thúc/Thiện đại thúc
四皇叔=Tứ hoàng thúc/tứ hoàng thúc
第一栈=đệ nhất khách điếm/đệ nhất khách sạn
来约束=để ước thúc/để ràng buộc
他们的家世=gia thế của bọn hắn/gia thế của bọn họ
本门弟子=đệ tử bản môn/đệ tử bổn môn
这名士兵=cái tên lính này/tên lính này/người binh sĩ này
单伯父=Đan bá phụ/Thiện bá phụ
总控室=tổng điều khiển/tổng khống thất
紫衣老者=lão giả áo tím/ông lão mặc áo tím
爷爷们=các gia gia/gia gia nhóm
家主的身份=thân phận của gia chủ/thân phận gia chủ
焉千总=Yên Thiên tổng/Yên thiên tổng
你的老大=lão đại của ngươi/lão Đại của ngươi
综合医院=bệnh viện đa khoa/Bệnh viện Đa khoa/Bệnh viện tổng hợp, bệnh viện đa khoa
开司米=len ca-sơ-mia/len sơn dương
女老师们=các nữ lão sư/các cô giáo
我的老婆=lão bà của ta/vợ của ta
一些大人=một số đại nhân/một ít người lớn
老玩家=lão ngoạn gia/người chơi già dặn kinh nghiệm
亩许大=lớn gần mẫu/to khoảng một mẫu
这个主人=cái chủ nhân này/chủ nhân này/người chủ nhân này
沈二公子=Thẩm nhị công tử/cậu hai Thẩm
这些老鼠=cái đám chuột này/những con chuột này
家门前=trước cửa nhà/trước gia môn/trước nhà
母亲和=mẫu thân cùng/mẫu thân và
这个教主=giáo chủ này/người giáo chủ này
知止而后有定=tri chỉ nhi hậu hữu định/biết nơi yên ở rồi mới định được chi
垂垂老朽=già yếu lưng còng/lão già lưng còng
那老头=lão đầu kia/lão nhân kia/ông lão kia
这老头的力量=lực lượng của lão đầu này/sức mạnh của ông lão này
这座府邸内=trong tòa phủ đệ này/bên trong tòa phủ đệ này
田老师=Điền lão sư/cô Điền
这长老=trưởng lão này/người trưởng lão này
十八亿=mười tám ức/1.8 tỷ
他们的主子=chủ tử của bọn hắn/chủ nhân của bọn họ
单老怪=Đan lão quái/Thiện lão quái
我的老家=quê nhà của ta/lão gia của ta
幕后主使者=người chủ sử sau màn/kẻ điều khiển sau hậu trường
弃车保帅=bỏ xe giữ tướng/khí xa bảo suất/bỏ xe bảo tướng/bỏ xe bảo vệ soái ca
猫千总=Miêu Thiên tổng/Miêu thiên tổng
法属波利尼西亚=Polynesia thuộc Pháp/French Polynesia/Pô-li-nê-di thuộc Pháp
她的老婆=lão bà của nàng/vợ của nàng
三大家族=tam đại gia tộc/ba gia tộc lớn
你们兄弟的性命=tính mạng của huynh đệ các ngươi/tính mạng của huynh đệ các ngươi
老人的面目=bộ mặt của lão nhân/bộ mặt của ông lão
戎菽=nhung thúc/giống đậu to
代家主=đại gia chủ/đời gia chủ
丐帮的弟子=đệ tử của Cái Bang/đệ tử của Cái bang
在家从父=tại gia tòng phụ/ở nhà từ Cha
郭家人=người Quách gia/người nhà họ Quách
龙小王爷=Long tiểu Vương gia/Long tiểu vương gia
第一个念头=ý niệm đầu tiên/cái ý niệm đầu tiên
我的娘亲=mẫu thân của ta/mẹ ruột của ta
江家人=người Giang gia/người nhà họ Giang
弟弟的模样=bộ dáng của đệ đệ/dáng dấp của đệ đệ
她的父母=cha mẹ của nàng/phụ mẫu nàng/cha mẹ nàng
大少爷作风=tác phong cậu ấm/tác phong công tử
大家族子弟=con em đại gia tộc/con cháu đại gia tộc
大人的名号=tên gọi của đại nhân/đại nhân đích danh hào
单长老=Đan trưởng lão/Thiện trưởng lão
办公室主任=chủ nhiệm phòng làm việc/chủ nhiệm văn phòng
我家族的力量=lực lượng của gia tộc ta/sức mạnh của gia tộc ta
妇人们=chúng phụ nhân/các phu nhân
裘千总=Cừu Thiên tổng/Cừu thiên tổng
弥天之眸=di thiên chi mâu/con mắt đầy trời
单管家=Đan quản gia/Thiện quản gia
雷家人=người Lôi gia/người nhà họ Lôi
那个算命大叔=người đại thúc coi bói kia/người đại thúc xem bói kia
紫发老者=lão giả tóc tím/ông lão tóc tím
她姐姐=tỷ tỷ nàng/tỷ tỷ của nàng
个十五六岁的少年=cái thiếu niên mười lăm mười sáu tuổi/một thiếu niên mười lăm mười sáu tuổi
段家人=người Đoàn gia/người nhà họ Đoàn
拿手机=cầm điện thoại/lấy điện thoại di động/lấy di động
俞家人=người Du gia/người nhà họ Du
十代弟子=đệ tử đời mười/thập đại đệ tử
太老伯=thái lão bá/hàng tôn trưởng hơn bác
那些大哥=những người đại ca kia/người đại ca kia
抹雪白=dính bông tuyết/vệt trắng tuyết
她的老师=lão sư của nàng/sư phụ của nàng/thầy của nàng/giáo viên của nàng
那位老爷子=vị lão gia kia/lão gia tử kia
那老师=lão sư kia/vậy lão sư/người lão sư kia
下星期天=chủ nhật tới/chủ nhật tuần sau
不老不死=bất lão bất tử/không già không chết
李乡长=Lý hương trưởng/Lý chủ tịch xã
女儿女婿=nữ nhi nữ tế/con cái con rể
它们的主人=chủ nhân của bọn chúng/chủ nhân của bọn nó
的家宅=gia trạch/gia đình
眩晕里面=trong mê muội/trong hôn mê
这个新老师=lão sư mới này/người lão sư mới này
靡有孑遺=mĩ hữu kiết di/chẳng còn một ai
你家族=gia tộc của ngươi/gia tộc ngươi/gia tộc của người
头童齿豁=đầu trọc răng thưa/Đầu hói răng hở. Hình dung dáng người già yếu cằn cỗi. ☆Tương tự: lão thái long chung 老態龍鍾.
孙家人=Tôn gia người/người nhà họ Tôn/gia đình tôn gia
哈布斯堡家族=gia tộc Habsburg/gia đình Habsburg
五六百亿=50-60 tỷ/50, 60 tỉ
墨掌柜=ông chủ Mặc/Mặc chưởng quỹ
姜小王爷=Khương tiểu Vương gia/Khương tiểu vương gia
小家族=tiểu gia tộc/gia tộc nhỏ/gia đình nhỏ
本大爷=bản đại gia/bổn đại gia
你们的家伙=tiểu tử của các ngươi/gia hỏa của các ngươi
女学员们=các nữ đệ tử/các nữ học viên
大仇家=đại cừu gia/kẻ thù lớn
加尔=Gia Nhĩ/gia nhĩ
那楼主=vậy lâu chủ/cái kia lâu chủ
这样的女孩儿=nữ hài nhi kiểu này/bé gái như thế
你的老师=lão sư của ngươi/sư phụ của ngươi/thầy của ngươi/giáo viên của ngươi
这老儿=lão nhi này/ông già này
大型强子对撞机=Máy gia tốc hạt lớn/Máy va chạm Hadron Lớn
这座府邸中=trong tòa phủ đệ này/bên trong tòa phủ đệ này
别的老师=các lão sư khác/lão sư khác
在等.=đang chờ./đang các loại.
唏哩哗啦=lách ca lách cách/lạch cạch
把手机关掉=tắt điện thoại di đông/tắt điện thoại di động
这小姨子=tiểu di tử này/cô em vợ này
雨雪交加=vũ tuyết giao gia/mưa tuyết cùng chất thêm lên/mưa và tuyết xen kẽ
各大领主=các đại lãnh chúa/các đại lĩnh chủ
外门弟子中斗得=đấu trong ngoại môn đệ tử/đấu trong đệ tử ngoại môn
自己的父母=cha mẹ của mình/phụ mẫu của chính mình
主机游戏=game console/trò chơi máy chủ lưu trữ
他们的家境=gia cảnh của bọn hắn/gia cảnh của bọn họ
那个老头子=lão đầu tử kia/lão già kia
这王家=Vương gia này/vương gia này
这个星球=cái tinh cầu này/tinh cầu này
无理式=biểu thức vô nghĩa/biểu thức vô tỷ
龙师弟=Long sư đệ/Long  sư đệ
老视眼=mắt lão/viễn thị
主观唯心主义=chủ nghĩa duy tâm chủ quan/duy tâm chủ quan
姻亲关系=quan hệ nhân thân/mối quan hệ thông gia
这个死老头=tử lão đầu này/lão già đáng chết này
候千总=Hậu Thiên tổng/Hậu thiên tổng
当世冠=nhân vật hàng đầu của thời đại/người đứng đầu thời đại/đương đại đệ nhất nhân
不善终=không chết già : kết thúc an lành/không chết tử tế
你的身家=thân gia của ngươi/thân thế của ngươi/dòng dõi của ngươi
那店主=điếm chủ kia/người điếm chủ kia
苏家人=người Tô gia/người nhà họ Tô
老成的样子=dáng vẻ lão thành/bộ dáng lão thành
本少爷的身份=thân phận của bổn thiểu gia/thân phận của bổn thiếu gia
这群老人=đám lão nhân này/đám lão già này
快到了尽头=sắp tận/sắp đến kết thúc
大富人家=đại phú nhân gia/gia đình giàu sang
这位守门的老头=lão đầu giữ cửa này/ông già giữ cửa này
他们的家臣=gia thần của bọn hắn/gia thần của bọn họ
入主出奴=vào chủ ra tớ/tin coi như vàng, nghi coi là rác/tin theo thuyết này thì đề cao nó, còn bài xích thuyết khác
这老贼=lão tặc này/người lão tặc này
老人死了=lão nhân đã chết/lão nhân chết rồi
死流徒杖笞=tử lưu đồ trượng di/là năm hình
族中子弟=đệ tử trong tộc/đệ tử trong tộc/con cháu trong tộc
你的家人=người nhà của ngươi/gia đình anh
服装设计师=chuyên gia thiết kế thời trang/nhà thiết kế thời trang/nhà thiết kế trang phục
快递小哥=shipper tiểu ca/anh trai chuyển phát nhanh
那老汉=lão hán kia/người lão hán kia
马克思主义发展史=lịch sử phát triển chủ nghĩa Marc/Lịch sử phát triển chủ nghĩa Mác
一家四口=một nhà bốn người/một nhà bốn miệng/một gia đình bốn người
圆千总=Viên Thiên tổng/Viên thiên tổng
整个家族=toàn cả gia tộc/cả gia tộc
老者的身上=trên người lão giả/trên người ông lão
这些老板=những lão bản này/những ông chủ này
那些老家伙们=những lão gia hỏa kia/những lão gia hỏa đó
众长老=tất cả trưởng lão/các trưởng lão
种族隔离=chủng tộc cách ly/a-pác-thai/chủ nghĩa phân biệt chủng tộc
本尊主=Bổn tôn chủ/bản tôn chủ
我们老大=lão đại của chúng ta/lão đại chúng ta
姬大公子=Cừu đại công tử/Cơ đại công tử
好姐妹=hảo tỷ muội/chị em tốt
他们的小妹=tiểu muội của bọn hắn/tiểu muội của bọn họ
老者的身体=thân thể của lão giả/thân thể của ông lão
大勇若怯大智若愚=đại dũng thì giống như sợ sệ đại trí thì giống như ngu muội/đại dũng thì giống như sợ sệt/đại trí thì giống như ngu muội
这个苦主=cái khổ chủ này/người khổ chủ này
七长老=Thất trưởng lão/thất trường lão
当大老婆=làm đại lão bà/làm vợ lớn
庞大的家族=gia tộc khổng lổ/gia tộc khổng lồ
徐家人=người Từ gia/người nhà họ Từ
自己老婆=lão bà của mình/lão bà mình
最主要的原因=nguyên nhân chủ yếu nhất/nguyên nhân chủ yếu
温千总=Ôn Thiên tổng/Ôn thiên tổng
取出手机=lấy điện thoại di động ra/lấy di động ra
国家的行政权=quyền hành chính của quốc gia/quyền hành chính của quốc gia
老连长=lão liên trưởng/đại đội trưởng cũ
他姐夫=tỷ phu hắn/anh rể hắn
强大人物=cường đại nhân vật/nhân vật cường đại
自己的双胞胎弟第=đệ đệ sinh đôi của mình/đệ đệ sinh đôi của mình
老人的脸上=trên mặt của lão nhân/trên mặt của ông lão
倾家荡产的话=táng gia bại sản/nếu táng gia bại sản
曾爷爷=tằng gia gia/cụ tổ/ông cố
顾千总=Cố Thiên tổng/Cố thiên tổng
死老头=lão già chết tiệt/tử lão đầu/lão già đáng chết
牡丹雖好全仗綠葉扶=mẫu đơn tuy đẹp/mẫu đơn tuy đẹp nhưng vẫn phải dựa vào lá/nhưng vẫn phải dựa vào lá
任叔叔=Nhâm thúc thúc/chú Nhậm
"是主人="Là chủ nhân/"Vâng thưa chủ nhân
我爷爷=gia gia của ta/gia gia ta/ông nội của ta/ông ta/ông nội ta/ông tôi
我妹夫=muội phu ta/em rể ta
这个中国的老板=Trung Quốc lão bản/Trung Quốc lão bản này
洛家人=người Lạc gia/người nhà họ Lạc
我的老师=lão sư của ta/sư phụ của ta/thầy giáo của ta/thầy của ta/giáo viên của ta
新入弟子=đệ tử mới vào/đệ tử mới vô/đệ tử mới tới
一二·九运动=phong trào 9-12-1935쳌 đã phát động phong trào kháng Nhật cứu nước. Mục tiêu phản đối chủ nghĩa đế quốc Nhật Bản xâm lược vùngHoa Bắc và chính sách thoả hiệp của chính phủ Quốc dân, kêu gọi nhân dân cả nước đứng lên chống Nhật cứu nước. Phong trào nhanh chóng lan rộng cả nước, chuẩn bị điều kiện cho phong trào chống Nhật cứu nước từ năm 1937)/phong trào 9-12-1935 đã phát động phong trào kháng Nhật cứu nước/phong trào 9-12/phong trào 9-12-1935
碧冬茄=dạ yến thảo/thuốc lá cảnh (petunia)/bích đông gia
段小姐=Đoàn tiểu thư/cô Đoàn
行抵某處=hành để mỗ xứ/đi đến xứ mỗ
浪荡公子=công tử phóng đãng/công tử lãng đãng
拜恩私室=vì lợi ích riêng/vị tư tình/vì tình riêng không đếm xỉa đến lợi ích quốc gia
瞬移到=thuấn di đến/teleport đến
逐出家门=trục xuất khỏi gia môn/trục xuất khỏi cửa/đuổi ra khỏi nhà/trục xuất khỏi nhà
那老者=lão giả kia/ông lão kia
这个妹夫=người muội phu này/người em rể này
老瞎子=Lão Hạt Tử/lão già mù
哪家公子=công tử nhà nào/công tử nhà nào đó
它的老板=ông chủ của nó/lão bản của nó
你叔叔=thúc thúc của ngươi/thúc thúc ngươi
在家族里面=trong gia tộc/ở trong gia tộc
它的母亲=mẹ của nó/mẫu thân của nó
任庄主=đảm nhiệm trang chủ/Nhâm trang chủ
我的祖母=tổ mẫu của ta/tổ mẫu ta
另一名长老=một tên trưởng lão khác/một trưởng lão khác
第一剑=đệ nhất kiếm/kiếm thứ nhất
良家子弟=gia đình tử tế/con em nhà lành
科学家们=các nhà khoa học/các khoa học gia
归千总=Quy Thiên tổng/Quy thiên tổng
掌门的弟子=chưởng môn đệ tử/đệ tử của chưởng môn
大美人儿=đại mỹ nhân nhi/đại mỹ nhân
富贵人家=nhà giàu sang/gia đình giàu có
行走间=lúc hành tẩu/trong lúc đi
更加大=càng thêm lớn/càng gia tăng hơn
老人的脸庞=lão nhân gương mặt/khuôn mặt của ông lão
学生会主席=hội chủ tịch sinh viên/chủ tịch Hội học sinh/Chủ tịch Hội Sinh viên
二小王爷=Nhị tiểu Vương gia/Nhị tiểu vương gia
右倾机会主义=chủ nghĩa cơ hội hữu khuynh/nghiêng phải chủ nghĩa cơ hội
我老公=lão công ta/chồng ta
这些乡巴佬=đám nhà quê này/những hương ba lão này
调味品架=khay gia vị/giá đựng đồ gia vị/Giá đựng đồ gia vị
这对母子=hai mẹ con này/hai mẫu tử này
那个城主=cái thành chủ kia/người thành chủ kia
你的娘亲=mẫu thân của ngươi/mẹ ruột của ngươi
单小妹=Đan tiểu muội/Thiện tiểu muội
大女儿=đại nữ nhi/con gái lớn
鹿小王爷=Lộc tiểu Vương gia/Lộc tiểu vương gia
那个老者=lão giả kia/ông lão kia
沈姐=Thẩm tỷ/Thẩm tỷ
他的老板=lão bản của hắn/ông chủ của hắn
把手机=đưa di động/đem điện thoại di động/cầm di động
忝眷=thiểm quyến/gia quyến của kẻ hèn mọn này
总点击=tổng điểm vote/tổng lượng view
三千亿=ba ngàn ức/ba trăm tỷ
大门大户=đại môn đại hộ/gia đình giàu có
也是大家=cũng là mọi người/cũng là đại gia
自己家族=gia tộc mình/gia tộc của chính mình
债主们=đám chủ nợ/các chủ nợ
段小王爷=Đoàn tiểu Vương gia/Đoàn tiểu vương gia
某一个人=một người nào đó/một mình mỗ
包副县长=Bao phó huyện trưởng/Bao phó chủ tịch huyện
你弟弟=đệ đệ ngươi/đệ đệ của ngươi
顾小王爷=Cố tiểu Vương gia/Cố tiểu vương gia
单大嫂=Đan đại tẩu/Thiện đại tẩu
牡丹虽好全仗绿叶扶持=mẫu đơn tuy đẹp, nhưng vẫn phải dựa vào lá nâng/mẫu đơn tuy đẹp nhưng cần lá đến đỡ
归小王爷=Quy tiểu Vương gia/Quy tiểu vương gia
扫了他一眼=quét mắt nhìn hắn một cái/liếc mắt nhìn hắn
你姐夫=tỷ phu ngươi/của ngươi tỷ phu/anh rể ngươi
最惠国待遇=ưu đãi tối huệ quốcnhất/ưu đãi tối huệ quốc/điều trị quốc gia ủng thích nhất
第一?=đệ nhất?/số một?
你妹妹=muội muội ngươi
移动速度=tốc độ di chuyển/tốc độ di động
一个小男孩儿=một tiểu nam hài nhi/một tiểu hài nhi
一代弟子=đệ tử đời một/nhất đại đệ tử
"那师祖="Vậy sư tổ/”Cái kia sư tổ
大人的命令=đại nhân mệnh lệnh/mệnh lệnh của đại nhân
利用价值=giá trị lợi dụng/giới trị lợi dụng/giá trị lợi dụng
白发老者=lão giả tóc trắng/lão già tóc bạc/ông lão tóc trắng
田家人=người Điền gia/người nhà họ Điền
为国母=vi quốc mẫu/là quốc mẫu
加入帮派=gia nhập băng nhóm/tham gia băng đảng
他的老友=lão hữu của hắn/lão hữu của hắn
一千一百多亿=hơn 110 tỷ/hơn 110 tỉ
九万亿=chín ngàn tỷ/9000 tỉ
他手机=hắn điện thoại di động/di động của hắn
他们的老爷=lão gia của bọn hắn/lão gia của bọn họ
他的老师=lão sư của hắn/giáo viên của hắn
他们的主人=chủ nhân của bọn hắn/chủ nhân của bọn họ
大爷爷=Đại gia gia
这位老人=vị lão nhân này
小家伙们=lũ tiểu gia hỏa/bọn tiểu tử

题材新颖=đề tài mới mẻ/chủ đề mới lạ
内门弟子之间=trong nội môn đệ tử/trong đệ tử nội môn
且戰且走=thả chiến thả tẩu/vừa đánh vừa chạy
我们家族=gia tộc bọn ta/gia tộc chúng ta
龟仙人=Quy tiên nhân/lão thần rùa/lão rùa thần/Rùa Tiên
她的妹妹=muội muội của nàng/em gái của nàng
穿着红袍的老者=lão giả mặc hồng bào/ông lão mặc áo bào đỏ
江湖儿女=nhi nữ giang hồ/con cái giang hồ
这里的主人=chủ nhân nơi này/chủ nhân của nơi này
马尔萨斯主义=tư tưởng Man-tuýt/chủ nghĩa nhân mãn/tư tưởng Malthus
你们的家园=gia viên của các ngươi/quê hương của các ngươi
牡丹虽好全仗绿叶扶=mẫu đơn tuy đẹp nhưng vẫn phải dựa vào lá/mẫu đơn tuy đẹp/nhưng vẫn phải dựa vào lá
老夫的性命=tính mạng của lão phu/tính mạng của lão phu
败坏门楣=hủy hoại thanh danh/Làm hư hại tiếng tăm gia đình.  ◎Như: hữu liễu giá chủng tác gian phạm khoa đích nhi tử/chân thị bại hoại môn mi 有了這種作姦犯科的兒子/真是敗壞門楣.
任老爷子=Nhâm lão gia tử/Nhậm lão gia tử
老梆子=lão bang tử/tên mõ già

赵家人=người Triệu gia/người nhà họ Triệu
本洞主=Bổn động chủ/bản động chủ
统计表格=bảng thống kê/biểu mẫu thống kê
武无第二=võ vô đệ nhị/võ không có đệ nhị
打狗欺主=đánh chó khinh chủ/đánh chó bắt nạt chủ sở hữu

第五境=đệ ngũ cảnh/cảnh giới thứ năm
叶千总=Diệp Thiên tổng/Diệp thiên tổng
第十重=đệ thập trọng/tầng thứ mười
一教之主=nhất giáo chi chủ/đứng đầu một giáo
他们家族=gia tộc bọn họ/gia tộc của bọn họ
那紫发老者=lão giả tóc tím kia/ông lão tóc tím kia


他的主子=chủ tử của hắn/chủ nhân của hắn
老者的面前=trước mặt của lão giả/trước mặt ông lão
那大小姐=vậy Đại tiểu thư/Đại tiểu thư kia
他的家门=gia môn của hắn/gia tộc của hắn
平面模特=model poster/người mẫu ảnh bìa/người mẫu đồ họa
这个老人=lão nhân này/ông già này
那您老=vậy ngài/vậy lão gia ngài
差人家=sai người ta/kém nhân gia
宗主的女儿=tông chủ con gái/con gái của tông chủ
亿万分之一=một phần ngàn tỉ/một phần tỷ
肖小王爷=Tiếu tiểu Vương gia/Tiếu tiểu vương gia
女儿的模样=bộ dáng của nữ nhi/dáng dấp của nữ nhi
女舍监=bà quản gia/matron
您老了=ngài lão/ngài già rồi
美女老师=mỹ nữ lão sư/cô giáo xinh đẹp
他的手机号码=số đtdđ của hắn/số điện thoại di động của hắn
他的弟弟=đệ đệ của hắn/em trai của hắn
翻手机=xoay điện thoại di động/phiên di động
这老家伙=lão gia hỏa này/lão này
他们家长=bọn họ gia trưởng/gia trưởng của bọn họ
这教主=giáo chủ này/người giáo chủ này
三巨头=Tam cự đầu/Tam bá chủ
给人家当=cho người ta làm/cấp nhân gia làm
晚辈们=bọn vãn bối/các vãn bối/các vãn bối
摸出手机=lấy ra điện thoại di động/móc điện thoại di động ra
大老师=Đại lão sư/giáo viên lớn
这个小娃娃=tiểu oa nhi này/đứa bé này
那个老板=lão bản kia/người ông chủ kia

有加成=có bổ trợ/có gia thành
国家政权=chính quyền quốc gia/chính quyền quốc gia
老员工=lão công nhân/công nhân viên kỳ cựu/viên chức cũ
