四儿=Tứ nhi
四嫂=Tứ tẩu
四少主=Tứ thiếu chủ
四某=Tứ mỗ
四皇儿=Tứ hoàng nhi
八叔=Bát thúc
八妹=Bát muội
八姐=Bát tỷ
八姨=Bát di
八家=Bát gia
八师叔=Bát sư thúc
八弟=Bát đệ
八老怪=Bát lão quái
久哥=Cửu ca
九儿=Cửu nhi
九姨太=Cửu di thái
九嫂=Cửu tẩu
九少主=Cửu thiếu chủ
付家=Phó gia
伍先生=Ngũ tiên sinh
六儿=Lục nhi
六叔=Lục thúc
六姨太=Lục di thái
六弟=Lục đệ
九妹=Cửu muội
七师叔=Thất sư thúc
六哥=Lục ca
六家=Lục gia
四哥=Tứ ca
四姐=Tứ tỷ
四姨=Tứ di
四爷=Tứ gia
七哥=Thất ca
三叔=Tam thúc
三姨=Tam di
三家=Tam gia
三师叔=Tam sư thúc
三师祖=Tam sư tổ
八爷=Bát gia
十三姨=thập tam di
四叔=Tứ thúc
四家=Tứ gia
四师叔=Tứ sư thúc
四弟=Tứ đệ