//câu khó

//câu hiếm
挡着老子的路=cản đường của lão tử
挪移而开=na di tránh đi
手机屏幕上是=trên màn ảnh điện thoại di động là
摸摸姐姐吗=sờ tỷ tỷ một cái không
此剑阵=cái kiếm trận này
牡丹花瓣上=trên cánh hoa mẫu đơn
蔡家人=người Thái gia
朱家人=người Chu gia/người nhà họ Chu
牟爷=tìm kiếm gia gia
百多来下=đến hơn trăm cái
它的好兄弟=hảo huynh đệ của nó
她的手机里面=trong điện thoại di động của nàng
那座府邸里面=bên trong tòa phủ đệ kia
他背后的家族=gia tộc sau lưng của hắn
神的子民们=các con dân của thần
老人的脑海之中=trong đầu của ông lão
身穿红衣的老者=ông lão mặc áo đỏ
那穿着黄衣的长老=trưởng lão mặc áo vàng kia
老者的扑杀=sự vồ giết của ông lão
她家族的财产=tài sản của gia tộc nàng
此座主峰=toà chủ phong này
它的兄弟们=các huynh đệ của nó
加入了战场=đã gia nhập chiến trường
这位主将=vị chủ tướng này
大家出身=đại gia xuất thân
第一炼丹大师=đệ nhất luyện đan đại sư
他的霸道和柔情=bá đạo và nhu tình của hắn
那样一位师弟=một vị sư đệ như vậy
老夫的手心=lòng bàn tay lão phu
有些国家=có vài quốc gia
大哥的事儿=chuyện của đại ca
他妹妹=muội muội của hắn
母亲的翼护=che chở của mẫu thân
长久从事=tham gia vào một thời gian dài
这些高官子弟们=những cao quan tử đệ này
那些老道士=những lão đạo sĩ kia
它的义妹=nghĩa muội của nó
老板的房间=phòng của lão bản
那些堂主=những đường chủ kia
那寨主=người trại chủ kia
我们姐妹=tỷ muội chúng ta
你们的家长=gia trưởng của các ngươi
这些主事者=những người chủ trì này
老大地=lão đại mà
那疯老人=lão già điên kia
府邸门前=trước cửa phủ đệ
这位年轻公子=vị công tử trẻ tuổi này
那位小哥=vị tiểu ca kia
它们的师妹=sư muội của bọn nó
他的比试=cuộc tỷ thí của hắn
大人的吩咐=phân phó của đại nhân
总指挥部里面=trong bộ tổng chỉ huy
