加九锡=gia cửu tích/thêm chín thiếc

加塞=gia tắc
加御=gia ngự
加持上=gia trì lên
加持于=gia trì ở
咔察=ca sát
和事佬=hòa sự lão

哥几个=mấy ca

哥忍=ca nhịn
哥手=ca thủ
加莎=gia toa
唐家的人=người của Đường gia
商务舱=khoang thương gia
嘉丽=gia lệ
在比斗中=ở trong tỷ đấu
土老财=thổ lão tài
大儿媳=đại nhi tức
大佬会=đại lão hội
大个儿=đại cá nhi

大姐头=đại tỷ đầu
姆口=mỗ khẩu
姐们儿=tỷ môn nhi
奉家师=phụng gia sư
宝家=bảo gia

家书=thư nhà/gia thư
一耙=một bừa cào
五加皮=ngũ gia bì
御姐本=ngự tỷ bản
总号=tổng hào
惑主=hoặc chủ
拘羁=câu thúc
整株=cả cây
栋叔=đống thúc
树哥=thụ ca
样张=trang in mẫu
样机=nguyên mẫu
母亲节=mẫu thân tiết
母圣=mẫu thánh

母泉=mẫu tuyền

母神=mẫu thần


母鼠=mẫu thử
灯黑=muội đèn
点主=điểm chủ

第一衰=đệ nhất suy
红模子=bản chữ mẫu
约束力=lực ước thúc
老两口=lão lưỡng khẩu
老吗=già sao
更大伯=càng đại bá hơn
五儿媳=ngũ nhi tức
更老边=càng lão Biên hơn
更其主=càng kỳ chủ hơn
弄潮儿=lộng triều nhi/lộng triều nhân
弯儿=chỗ cong/loan nhi