云妹=Vân muội
五弟=Ngũ đệ
二表妹=Nhị biểu muội
三伯=Tam bá
三十而立=tam thập nhi lập
三哥=tam ca
三姐=tam tỷ
三姨太=Tam di thái
三嫂=Tam tẩu
三朝元老=tam triều nguyên lão
乐姐=Nhạc tỷ
九伯=Cửu bá
九叔=Cửu thúc
九姐=Cửu tỷ
九姨=Cửu di
九师祖=Cửu sư tổ
乾儿=Càn nhi
二城主=nhị thành chủ
二女儿=nhị nữ nhi
二姨太=Nhị di thái
二弟=nhị đệ
二当家=Nhị đương gia
二老板=Nhị lão bản
二表嫂=nhị biểu tẩu
五老=Ngũ lão
五伯=Ngũ bá
周先生=Chu tiên sinh
周叔=Chu thúc
周妹=Chu muội
周姐=Chu tỷ
周姨=Chu di
周嫂=Chu tẩu
周家的人=người của Chu gia
周师伯=Chu sư bá
周师叔=Chu sư thúc
周总=Chu tổng
周母=Chu mẫu
周老七=Chu lão thất
周老六=Chu lão lục
周老爷=Chu lão gia
周门主=Chu môn chủ
四姨=Tứ di
姜姐=Khương tỷ