矩贤=Norikata
阿雅克肖=Ajaccio
阿杰莉娜=Angelina
陆斯恩=Lucien
雁夜=Kariya
雅痞=yuppie/Nhã Đồ
雅尔塔=Yalta
雅库茨克=Yakutsk
雅灭蝶=yamete
雅诗兰黛=Estée Lauder/Estee lauder
雌激素=estrogen/oestrogen
雨果=Hugo
雪佛兰=Chevrolet
雷克顿=Renekton
雷夫=Leff
雷根斯堡=Regensburg
雷明顿=Remington
雷欧=Leo
雷茵=Rain
雷诺阿=Renoir/Pierre-Auguste Renoir
雾之丘=Kirigaoka
霍恩=Horn
雷藏=Raizou
露姬=Tsuyu-Hime
雷姆=Rem
雷姬=Reki
雷娅=Leah
阿黑颜=ahegao/A Hắc Nhan
阿雷西博=Arecibo
三代雷影=Raikage đệ tam
御阪=Misaka