陆记=bí thư Lục
陈书记=Trần bí thư
陈三少=Trần tam thiếu
陆少侠=Lục thiếu hiệp
陇兄=Lũng huynh
陈医生=Trần bác sĩ
陈大少=Trần đại thiếu
陈大师=Trần đại sư
陈大郎=Trần đại lang
陈太后=Trần thái hậu
陈夫人=Trần phu nhân
陈妈=Trần mụ
陈妈妈=Trần mụ mụ
陈妍=Trần Nghiên
陈姑娘=Trần cô nương
陈姓=họ Trần
陈娘=Trần nương
陈婆婆=Trần bà bà
陈府=Trần phủ
陈掌柜=Trần chưởng quỹ
陈朝=triều Trần
陈父=Trần phụ
陈相公=Trần tướng công
陈舅=Trần cữu
陈镖头=Trần tiêu đầu
陈院长=Trần viện trưởng
陶府=Đào phủ
雨卿=Vũ khanh
雷婶=Lôi thẩm
霍府=Hoắc phủ
霍夫人=Hoắc phu nhân
霍氏=Hoắc thị
霍姓=họ Hoắc
霍将军=Hoắc tướng quân
霍兄=Hoắc huynh
霍卿=Hoắc khanh
陶小王爷=Đào tiểu vương gia
单师哥=Đan sư ca
单老爷=Đan lão gia
单大人=Đan đại nhân
叶家的家主=Diệp gia gia chủ
叶老二=Diệp lão nhị
顾副县长=Cố phó huyện trưởng
叶老太=Diệp lão thái
七小王爷=Thất tiểu vương gia
田阿姨=Điền a di