第=thứ
九=chín/cửu
以=lấy/dùng/dĩ/với
战=chiến
养=nuôi/dưỡng
三=ba/tam
人=người/nhân
在=tại/đang/ở/再/lại
城=thành
外=bên ngoài/ngoại/ra/ở ngoài
隐=ẩn
处=chỗ/nơi/xử
大=lớn/đại
睡=ngủ/thụy
一=một/một khi/nhất/vừa
觉=cảm giác/giấc
到=đến/đáo/được
天=trời/ngày/thiên/bầu trời
黑=đen/hắc/hack
时=lúc/thì/khi/giờ/thời
才=mới/tài
翻=lật/trở mình
墙=tường
入=nhập/vào/đi vào
随=theo/tùy
便=liền/dễ/lại/tiện
找=tìm/hoa
间=ở giữa/gian/đang lúc
饭=cơm/phạn
馆=quán
吃=ăn/cật/đồ ăn
顿=bỗng nhiên/ngừng lại/đốn/ngừng/bữa/tấn/trận
量=lượng/đo
计=kế/tính
向=hướng/hướng về phía/hướng về/xưa đến nay
变=biến/thay đổi
成=thành
和=cùng/và/hòa/như
黄=hoàng/vàng
脸=mặt/kiểm/khuôn mặt/vẻ mặt/sắc mặt/biểu cảm
丑=xấu/Sửu
汉=hán
道=đạo/đường/nói/đường đi
要=muốn/yếu/phải/quan trọng/nếu/sắp
证=chứng/chứng nhận
实=thực/đầy
我=ta/ngã
话=lời nói/nói
并=cũng/đồng thời/tịnh
不=không/bất
困=khốn/buồn ngủ/khốn/vây/vây khốn
难=khó/nan/khó khăn/nạn
只=chỉ/con/cái/chích
作=làm/tác
个=cái/người/quả/cá
测=đo/trắc
试=thử/thí/thi
可=nhưng/có thể/cũng/khả/đáng/thể
知=biết/tri
是=là/thị/đúng/vâng/phải
否=không/hay không/phủ/phủ định
出=ra/xuất
卖=bán/mại
两=hai/lượng/lưỡng
感=cảm giác/cảm/cảm (giác)
有=có/hữu
趣=thú
连=ngay cả/liền/liên/cả/liên tục/nối/đại đội
忙=bận bịu/vội vàng/bề bộn/mang
问=hỏi/vấn
为=vì/làm/là/vi/vì là/thành
把=đem/thanh/bả/ván
握=nắm/ác/cầm
形=hình
势=thế/xu thế
们=nhóm/môn/các/cửa/bọn họ
各=các/tất cả/đều/mỗi/mỗi người
重=nặng/trọng/trùng
中=bên trong/trúng/trung/giữa/trong
均=đồng đều/quân/cùng/đều/đều
设=thiết
线=tuyến/dây/đường/sợi dây
眼=mắt/nhãn
他=hắn/nó/khác/她
多=nhiều/thêm/cỡ nào/đa
家=nhà/gia
份=phần/phân/phận
掩=che đậy/ dấu/yểm/che/đậy/dấu
饰=sức
这=cái này/giá/này/vậy/đây
听=nghe/thính
命=mệnh/mạng/lệnh/mệnh lệnh
于=tại/cho/vu/với/hơn
上=bên trên/lên/trên/trước/thượng
安=an/sao
排=sắp xếp/hàng/bài/đứng hàng/trung đội
潜=lẻn/lặn/tiềm
返=trở lại/phản
再=lại/tái/nữa/sẽ
看=nhìn/khán/xem
行=đi/được/hành/nghề/làm/hạnh
能=có thể/năng/có thể/năng lực
保=bảo đảm/bảo/bảo vệ
当=khi/làm/coi là/đương/nên/đem/đáng/coi
推=đẩy/thôi
想=nghĩ/muốn/nhớ/tưởng
杀=giết/sát
点=điểm/giờ/chút/gật
同=cùng/đồng
失=mất/thất
好=tốt/hảo/được/thật/dễ/thích/xong
方=phương/mới/vuông
日=ngày/nhật/mặt trời/xxx
怎=sao/chẩm
从=từ/theo/tòng
来=đến/tới/lai
溜=trượt/lưu/chuồn mất/dải/chạy
微=hơi/vi
笑=cười/tiếu
兄=huynh
思=nghĩ/tưởng nhớ/tư
虑=lo
非=không phải/phi/không/không phải là
常=thường
缜=chẩn
明=minh/sáng
白=trắng/bạch/phí công
你=ngươi/cậu
含=ngậm/nén/chứa/hàm
面=mặt/bột/diện/mì
内=bên trong/nội
奸=gian
对=đối/đúng/đối với/với/đôi
吧=đi/a/ba/sao/không/chứ/nữa
略=hơi/sơ lược/lược
尬=giới/ngượng
直=thẳng
接=tiếp/nhận/nối
嘛=mà/ma/thôi/đây/đi/được/nha/sao
尴=lúng túng khó xử
坦=thản/tank
言=nói/ngôn/lời
既=đã/vừa/ký/rồi/tức/thì là
诚=thành
合=hợp
就=liền/thì/tựu/ắt/thành/chính
用=dùng/dụng/cần
客=khách
气=khí/chọc tức/tức giận/tức/giận
虽=dù/mặc dù
认=nhận/nhận thức
识=biết/thức
深=sâu
初=sơ/ban đầu
碰=đụng/bính/va/chọi/chạm/phanh
且=lại/mà lại/tạm/thả/mà
立=lập/đứng
状=trạng/hình dáng
态=thái/trạng thái
但=nhưng/vậy
却=lại/nhưng
早=sớm/tảo
惺=tinh
相=tướng/cùng nhau/lẫn nhau/tương
心=tâm
定=định/bình tĩnh
乃=chính là/nãi/là
英=anh
雄=hùng
辈=bối
则=thì/tắc thì/tắc/lại/là/bản
绝=tuyệt
会=sẽ/biết/lại/hội/chút//回
与=cùng/dữ/và/giống như/cho
提=xách/nói/lấy/nâng/đề/dẫn/nhắc đến
议=nghị
欣=hân/vui mừng
然=nhưng/không sai/nhiên
那=kia/cái kia/vậy/cái nào/đâu/nào/đó
更=càng/canh/đổi/lại thêm/hơn
老=lão/già/rất
离=cách/rời/ly
开=mở/lái/khai/nở/sôi/nổ/chạy
事=sự tình/sự/chuyện
瞒=giấu/giấu diếm/man/lừa gạt/dấu diếm
过=qua/quá/từng/đã từng/tội/sai lầm
朋=bằng/bằng hữu
友=bạn/hữu
没=không có/ngập/chìm/chưa/mất
打=đánh/đả
算=tính/toán/tính toán/coi là
长=dài/mọc/trưởng/trường/sinh trưởng/lớn
期=kỳ
何=gì
叫=gọi/để/bảo/làm/khiếu/kêu
康=khang
鞘=vỏ (kiếm, đao)/sao
利=lợi/sắc
此=này/thử/ấy/bèn/đây
智=trí
谋=mưu
武=võ/vũ
功=công/công lao
选=tuyển/chọn
小=nhỏ/tiểu
苤=phiết
下=hạ/dưới/xuống/lần
整=cả/chỉnh/đều/sửa sang/làm
正=chính/đang/dương/thẳng
由=từ/do/tùy/bởi
划=vạch/hoạch/vẽ/hoa/họa
若=như/nếu
说=nói/thuyết
生=sinh/sống/
性=tính/tính chất
或=hoặc/có lẽ/có thể
夺=đoạt
得=đến/phải/được/đắc/bị/mắc
她=nàng/mụ/nàng/他
芳=phương
弟=đệ
亲=thân/hôn
致=gây nên/gửi tới/dồn
误=lầm
陷=hãm/vùi lấp
阱=tịnh
其=nó/nàng/kỳ/hắn/ngoài/của nó/
尚=còn/chú trọng/vẫn còn
转=chuyển
折=gãy/xếp/chiết khấu/lộn/gấp
又=lại/hựu/vừa
扯=kéo/xé/xả
土=thổ/đất
关=quan/đóng/nhốt/cửa ải
系=hệ/thắt
穿=xuyên/mặc
针=châm
引=dẫn/rút/rời xa/thên
派=phái
触=sờ/đụng
边=bên cạnh/vừa/bên/biên/một bên/phe/cạnh
负=phụ/cõng/thua/âm/cậy/phụ
都=đều/cũng/đô/thủ đô
责=trách
腹=bụng
本=vốn/bản
亦=cũng/diệc
错=sai/thác/kém/lỗi
发=phát/tóc/
种=loại/trồng/chủng/gan/giống
怀=mang/hoài/ngực
疑=nghi
至=đến/tới/chí
甚=rất/cái gì/quá mức/rất : gì
么=a/sao
仍=vẫn/dựa theo/nhưng
未=chưa/vị/Mùi
风=gió/phong/phong cách
被=bị/được/chăn
隆=long
列=liệt/nhóm/đoàn/hàng
八=tám/bát
高=cao
手=tay/thủ
胖=béo/mập
子=tử/con
冯=phùng
缓=chậm/trì hoãn/hoãn
摇=dao/dao động/rung/lắc
目=mắt/mục/con mắt
射=bắn/xạ
注=chú/rót
色=sắc
扼=ách/chặn/bóp
解=giải/hiểu/am hiểu/mổ
释=thả/thích
番=phiên/lần
后=sau/hậu/sau khi/phía sau
夥=hỏa/khỏa
父=cha/phụ
切=cắt
暗=ám/ngầm/tối/ngu muội/thầm
消=tiêu/tiêu tan
息=hơi thở/tức
所=chỗ/sở/viện
动=động/di chuyển
全=toàn/toàn bộ
掌=chưởng/bàn tay
而=mà
广=rộng/quảng/rộng rãi
竟=lại/mà/cánh/ắt/rốt cuộc/nhất định/cuối cùng/càng
借=mượn/cho mượn/tá
毒=độc
呆=ngốc/nán lại/ở
住=ở/được/lại
半=nửa/bán/rưỡi
晌=thưởng
懂=hiểu/đổng/u mê/bối rối
苦=khổ/đắng
恐=sợ/chỉ
怕=sợ/phạ
破=phá
脑=não
袋=túi/xách
透=thấu
键=khóa/chốt
像=giống/tượng/giống như
醒=tỉnh
般=bàn/giống như/vậy
里=bên trong/lý/dặm/trong/ở bên trong
远=xa
互=lẫn nhau/hỗ
产=sinh/sản
自=từ/tự/đương nhiên/tự thân/tự nhiên
敝=tệ
国=nước/quốc
久=lâu/cửu
经=trải qua/kinh
训=huấn
练=luyện
鹞=diều hâu
鹰=ưng/Ưng
飞=bay/phi/非
数=số/đếm/mấy/sổ/trách mắng/kể/cân nhắc/tỉnh phỏng/luôn luôn/kể ra
迅=nhanh chóng/tấn
速=nhanh/tốc/tốc độ
传=truyền/truyện
递=đưa/lần lượt
别=đừng/khác/chia ly/biệt/chớ/giắt
鸟=chim/điểu
儿=nhi/con
袭=tập/tập (kích)
虞=ngu/lo lắng
空=không/khoảng trống/khoảng không/vô ích/rảnh/trống
场=trận/tràng/trường/cuộc/cơn/đợt/màn
最=nhất/tối/rất
帮=giúp/bang/đám/mép
容=cho/dung/sắc mặt
厉=lệ/nghiêm khắc
害=hại
扁=dẹp/làm thịt/bẹp/đánh
毛=lông/mao/cọng lông
畜=súc
牲=sinh
它=nó/tha/khác
迷=mê
吗=sao/ư/mạ/không/chưa/à
做=làm/tố
套=bộ/đeo/vỏ/bộ đồ/buộc
特=đặc biệt/đặc/đặc (biệt)/rất
比=so/bỉ/so với
山=núi/sơn
川=xuyên/sông
河=sông/hà
流=lưu/chảy
辨=phân biệt
配=phối/xứng
赞=tán/khen
语=ngữ
惜=tiếc
承=nhận/thừa/thừa nhận
祖=tổ
露=lộ
二=hai/nhị
悠=du
往=hướng/vãng/đã qua/đi/hướng về
考=kiểm tra/thi/khảo thi
应=ứng/đáp/ứng với/nên
违=làm trái/không tuân/vi
背=cõng/lưng/khiêng/bối/sau lưng/đọc/kém/học thuộc
宗=tông
令=khiến/lệnh/làm/làm cho
研=nghiên
究=cứu
领=lĩnh/cổ/dẫn
乾=càn
咳=khục/khái/khụ/ho khan/khặc
声=âm thanh/thanh/tiếng
指=chỉ/ngón tay
己=mình/mấy
太=quá/thái/rất
丰=phong
富=giàu
很=rất
易=dễ/dịch/dễ dàng/đổi
岔=xóa
十=mười/thập/mươi/chục
万=vạn
千=ngàn/thiên/nghìn/ngàn
摆=bày/bãi/mở
干=làm/cạn/khô/kiền
回=về/hồi/quay về/lần/trả lời
少=thiếu/ít/trẻ
夜=đêm/dạ
际=tế
也=cũng/vậy/cũng/thì
因=bởi vì/nhân/nguyên nhân/dựa vào
前=trước/tiền
起=lên/khởi/dậy/cái
程=trình
理=lý/để ý
该=nên/cai/cái kia
信=tin/thư/tín
足=đủ/chân/túc
分=phân/điểm/phần/phút
析=tích
已=đã/thôi/dĩ
假=giả/nghỉ
唯=duy
标=tiêu/đánh dấu/ngọn/nhãn hiệu
死=chết/tử
机=cơ/máy bay/máy
渔=cá
饵=mồi/mồi
钓=câu/điếu/lưỡi câu
反=phản/ngược
主=chủ/chúa
先=trước/tiên/trước tiên
决=quyết/vỡ
条=đầu
件=kiện/món
追=truy/đuổi/theo đuổi
免=miễn
进=tiến/vào/tiến vào
受=thụ/chịu/bị/được
敌=địch
劣=kém
境=cảnh
皱=nhăn/mặt nhăn/cau
眉=lông mày
截=đoạn/chặn/tiệt
果=quả
附=phụ
近=gần/cận
某=nào đó/mỗ//một
务=vụ
肯=chịu/khẳng/đồng ý/tán thành/bằng lòng
遭=bị/lần/tao
确=xác thực
例=lệ
监=giám/giam
视=xem/thị/nhìn kỹ/coi
静=tĩnh/Shizuka
等=chờ/các/các loại/mấy người/mấy/bằng/mấy cái/vân vân
寻=tìm/tầm
去=đi/khứ
止=dừng/dừng lại
节=tiết/lễ/knot
枝=nhánh/cành
惹=gây/nhạ/làm cho/rước lấy/chọc
简=giản/giản đơn
单=đơn/đan
清=thanh/trong/rõ ràng/sạch
楚=sở
汗=mồ hôi/hãn/đổ mồ hôi
四=bốn/tứ
侍=hầu/tùy tùng
门=cửa/môn/cánh cửa/们/khẩu
跟=cùng/theo/cân/giống như/như là
影=ảnh/Kage
龙=rồng/long
卷=quyển/cuốn/quăn
挡=cản/ngăn cản/đáng/chặn
任=mặc cho/đảm nhiệm/lần/nhiệm/cho dù/Nhậm/nhiệm kỳ
加=thêm/gia
拚=vứt/biện
俱=đều
伤=tổn thương/thương
幸=hạnh/may mắn
运=vận
况=huống/huống hồ
兼=kiêm
桓=hoàn
绽=phun/trán
根=cây/rễ/căn/rễ : cái
淡=nhạt/đạm
题=đề/đề tài
愕=kinh ngạc/ngạc
猜=đoán/sai/ngờ
即=tức/là
刚=vừa/cương/mới vừa/cứng/cương
代=thay mặt/đời/thay/đại
犬=khuyển/chó
守=thủ
口=miệng/ngụm/khẩu/thanh
永=vĩnh/vĩnh viễn/lâu dài
刺=đâm/gai/thứ/thích
段=đoạn
付=giao
仲=trọng
将=đem/sẽ/tướng/tương/sắp
掉=rơi/mất/bỏ/đi
硬=cứng rắn/cứng rắn (ngạnh)
涌=tuôn ra/trào
尊=tôn
敬=kính
肃=túc
怪=quái/trách/quá
纵=tung/túng
横=hoành
倒=ngược lại/ngã/đảo/đổ/lộn/ngược/cũng/rót
愚=ngu
蠢=xuẩn/ngu xuẩn/ngu
旋=xoáy
请=mời/xin/thỉnh/xin mời
恕=tha thứ/thứ cho
箸=đũa/trứ
冒=bốc lên/mạo
险=hiểm
逃=trốn/đào
畏=sợ
缩=co lại/lui
今=nay/bây giờ/kim
照=chiếu/so sánh/noi theo/theo
办=xử lý/làm/bạn/đủ
必=tất/nhất định/tất nhiên
须=cần/râu/tu
支=chi/thứ/nhánh/giữ/cầm
持=cầm/trì/nắm
族=tộc
奈=nại
叹=thán
首=thủ/đầu/bài
尾=đuôi/vĩ
百=trăm/bách
倍=lần/bội
暴=bạo
藏=giấu/trốn/cất/tạng/tàng
围=vây
攻=công
击=kích
见=thấy/gặp/kiến/xem
光=quang/chỉ riêng/ánh sáng/sạch/chỉ
惫=bại
表=biểu/đồng hồ/bề ngoài/đơn/bày tỏ
讲=giảng/kể/nói
择=chọn/chọn
王=vương/vua
义=nghĩa
采=hái/khai thác/ngắt/thải
取=lấy/thủ
筋=gân
妙=diệu/hay
姑=cô
名=tên/danh
拍=đập/đấu/quay/chụp/phách/đánh
台=đài/thai/bàn
愧=thẹn/xấu hổ/quý
完=xong/hết/hoàn
摸=sờ/mò/mạc/tìm tòi
还=còn/trả/hoàn/vẫn/còn chưa
创=sáng tạo/sáng lập/chế/thương
哈=a/cáp/hắc/ha
凭=bằng
字=chữ/tự
混=hỗn/lăn lộn/trộn lẫn/lăn lộn
似=như/giống như/tự/dường như/tựa như/hình như
水=nước/thủy
乳=sữa/nhũ
交=giao/nộp/đóng
融=tan
争=tranh/tranh giành
倾=nghiêng/khuynh
轧=yết
震=chấn
撼=lay
望=nhìn/ngắm/vọng/trông chờ/nhìn qua
现=hiện/xuất hiện
马=ngựa/mã
称=xưng/hiệu/danh hiệu/cân
够=đủ/với/cú
共=chung/tổng
批=nhóm/phê
歼=diệt
灭=diệt
属=thuộc
忌=kị
制=chế
造=tạo
矛=mâu
盾=thuẫn/lá chắn
冲=xông/trùng/hướng/xung
突=đột
存=tồn
乎=hồ/tử
伸=duỗi với
搭=dựng/đáp/đi
肩=vai/kiên
凑=góp/đụng/tập hợp/gom góp/thấu/họp/tiếp cận
故=cho nên/cố/nguyên nhân
谓=vị/gọi là
愈=càng/dũ/khỏi bệnh
勇=dũng
基=cơ/dựa vào
些=chút/ta/chút ít/những/nhiều
送=đưa/tặng/tiễn/tiễn đưa/tống
助=trợ/giúp
修=tu/xây/sửa
宜=nghi/nên/thích hợp
莫=chớ/màn/không ai/sờ/mạc
体=thể
塞=nhét/nút/bỏ vào
民=dân
狠=hung ác/ngoan/ngận/tàn nhẫn
血=máu/huyết
液=dịch
闻=nghe/ngửi/văn
激=kích
丈=trượng
豪=hào
奋=phấn
寸=tấc/inch/thốn
赴=phó
油=dầu/du/mỡ
镬=hoạch
奉=phụng/dâng tặng
陪=bồi/cùng/theo/tiếp/đền
底=ngọn nguồn/đáy/thực chất/cùng/cuối
答=đáp
佛=Phật/phật
强=mạnh/cường/mạnh mẽ
秃=trọc/hói/ngốc
哩=đấy/lý/dặm
抽=rút/quất/trừu/nảy/lấy ra/nhổ/đánh/hút
凉=lạnh/mát
登=trèo lên/đăng
减=giảm
昔=tích/xưa kia
年=năm/niên/tuổi
落=rơi/lạc
荒=hoang/Hoang
僧=tăng
讶=quái lạ
真=thật/thực/chân
留=lưu
桩=cọc/cái cọc
另=khác/lánh
隋=tùy
廷=đình/triều đình
右=phải/bên phải
禄=lộc/Lộc
护=hộ/bảo hộ
北=bắc
蕃=phiên
军=quân
裴=bùi
矩=cự/củ
地=địa
盖=đóng/che/đắp/nắp
世=thế/đời
文=văn/đồng
响=vang/tiếng nổ/hưởng/vang dội
改=đổi/sửa
历=lịch
图=đồ/hình/cầu
恰=vừa/đúng/vừa lúc
曹=tào
叛=phản/phản bội
结=kết
忠=trung
耿=cảnh
公=công/đực
临=lâm/gặp/trước khi
终=cuối cùng/hết/chung
拿=cầm/nã/nắm
颅=sọ
祭=tế
奠=điện
趟=lội/chuyến
趁=thừa dịp/sấn
热=nóng/nhiệt/nhiệt nóng
闹=náo
伦=luân
染=nhiễm/nhuộm
崇=sùng
遂=liền/thích thú
仅=vẻn vẹn/chỉ
抛=ném/phao/vứt/quăng
低=thấp
呢=đâu/đây/đây này/ni/mà/mất/chứ
啦=rồi/nữa/lạp/rồi
浑=đục/mơ hồ/hồ đồ/thô/tự nhiên
沸=sôi
腾=đằng
骂=mắng/chửi/mạ
句=câu/cú
粗=thô/to
断=đoạn/nhất định/gãy/đánh gãy/cắt
痛=đau nhức/đau/thương
快=nhanh/khoái/mau/hơn/sắp
逢=gặp/phùng
遇=gặp/ngộ
扣=trừ/chụp/khấu trừ/cài
傻=ngốc/sỏa/ngu
耳=tai/mà thôi
花=hoa/tiêu/tiêu xài/tốn
洞=động/lỗ
添=thêm/thiêm
酒=rượu/tửu
亏=thua thiệt/lỗ/thiếu/khuy/mệt/thiếu (thiệt thòi)/thiệt thòi
旅=lữ/hành trình
享=hưởng
靠=dựa vào/sát lại/kháo/cập/dựa vào
沉=chìm/nặng/trầm/lặn
吟=ngâm
总=tổng/dù sao vẫn/chung quy/cuối cùng
跋=bạt
者=người/giả/cái
旦=sáng
索=tác
片=phiến/mảnh
路=đường/lộ
码=mã/ngựa/yard/con ngựa/gõ
曾=từng/tằng/bèn
仔=tử
细=mảnh/tế
泊=đỗ
船=thuyền
艘=chiếc/chiến thuyền
挂=treo/hack
旗=cờ/flag/kỳ
帜=xí
良=lương/người lương thiện
美=đẹp/mỹ
招=chiêu/nhận/làm/nhận tội
牌=bài/nhãn hiệu
瞩=chúc
车=xe/xa
鉴=giám/xem cho
使=làm/dùng/khiến/sử/làm cho/khiến cho/sử (khiến cho)/sứ
赶=đuổi/cản/đưa
无=không/vô
掳=bắt/cướp
劫=cướp/kiếp
戒=giới/cai
备=chuẩn bị/bị
让=để/nhường/bảo
游=du lịch/bơi/du
痴=si
耸=đứng thẳng
胛=giáp
环=vòng/hoàn
扫=quét
铺=trải/phô/phố/cửa hàng
稀=hiếm
疏=sơ
顾=chú ý/ngoảnh đầu/thăm/cố
颇=có phần/khá
迁=dời/thiên
座=tòa/tọa/ngồi/toà
仿=phảng phất/mô phỏng
域=vực
旺=vượng
毕=tất
市=thành phố/thị/chợ/mua/thị trường
占=chiếm/chiêm
紧=gấp/chặt/nhanh
陆=lục
逼=bức/ép
优=ưu
物=vật
饶=tha/làm cho/tha cho
平=bình/phẳng/hòa/mét vuông
姓=họ/tính
活=sống/công việc/hoạt
管=quản/ống
谁=ai/người đó/người nào/thùy/đó/kẻ đó
治=trị/quản lý
举=nâng/cử/giơ/cử động
杯=chén/ly/gia/bôi
凝=ngưng
洌=liệt
担=gánh
妃=phi
暄=huyên
诈=lừa dối/gạt
德=đức/Druid
偷=trộm/thâu/lén
东=đông/nghĩa vụ chủ nhà
西=tây
荆=gai/Kinh
罪=tội/khổ
歉=xin lỗi
甘=cam/ngọt
范=phạm
卫=vệ/Vệ
步=bước/bộ
钉=đinh
妄=vọng
挫=áp chế
岂=há/khởi/há lại
皆=đều/đều là/giai/toàn là/cũng/tất cả
喝=uống/quát/hây
嘿=hắc/này
避=tránh
示=bày ra
敢=dám/cảm/tiến lên/bạo dạn/có dũng khí
饮=uống/ẩm/đồ uống
尽=tận/tẫn/tận
店=cửa hàng
饱=no bụng/ăn no/no
食=ăn/thực
醉=say
剩=thừa/thặng/thừa lại/còn dư lại/còn lại
冷=lạnh/lãnh
除=trừ
狗=chó/cẩu/con chó
窝=ổ
予=cho/dư
室=thất/phòng
需=cần/nhu
求=cầu/tìm/trách/xin/ngang/van
渴=khát
拥=ủng/cầm giữ
娇=kiều
妻=vợ/thê
爱=yêu/ái/thích/tình yêu
乐=vui/mừng/nhạc
希=hi
倦=mệt mỏi
雨=mưa/vũ
温=ấm/ôn/hâm nóng
暖=ấm/noãn/ấm áp
香=hương/thơm/hương thơm/thơm mát
洁=khiết
佳=tốt
唉=ai/ôi
柔=nhu
姐=tỷ/tả
锐=duệ/sắc nhọn/nhuệ
石=thạch/đá
青=thanh/xanh
璇=tuyền
愿=nguyện/nguyện vọng
谐=hài
颤=rung động/chiến/run rẩy
忍=nhẫn
告=cáo/kiện/nói với
诉=tố
走=đi/chạy/tẩu
始=bắt đầu/thủy/mới
益=ích
书=sách/thư/viết
录=lục/ghi chép/quay/sao chép
记=nhớ/ghi/ký/cái
月=nguyệt/tháng/trăng
谈=đàm/nói/đàm luận
描=tô lại/copy
述=thuật
音=âm
赋=phú
象=tượng/giống như/voi/giống
奏=tấu
宅=trạch/chỗ ở
蝙=biên
蝠=bức/dơi
府=phủ
异=dị/khác
超=siêu/cực kỳ/Chao
箫=tiêu
次=lần/thứ
限=hạn
陈=trần
尤=càng
晓=hiểu
皿=mãnh/bồn
恨=hận
写=viết/tả/ghi
後=sau/hậu
婉=uyển
凄=thê
滥=lạm
调=điều/giọng
区=khu
肺=phổi
腑=phủ
韵=vận
斧=búa
哀=ai/buồn bã
聆=linh
踏=đạp
禁=cấm
幻=huyễn
置=đưa/mua/trí
窗=cửa sổ/song
朵=đóa
鲜=tươi/tiên/quang vinh
放=thả/phóng/để/đuổi/bỏ/chiếu
楼=lâu/lầu
隔=cách/ngăn
阂=ngại
澈=triệt
粉=phấn/fan/bún/hồng/bột
碎=nát/toái/vỡ/bể/nát tan
亢=cang
昂=ngang
扬=giương/dương/vung/hất
彷=bàng
洄=hồi
渊=uyên
海=biển/hải
缠=quấn/triền/dây dưa
每=mỗi/thường/từng/mỗi khi/mỗi lần
符=phù
烙=in dấu/nướng
衔=ngậm/hàm/liên tiếp
丝=tia/tơ/ti
毫=hào/chút nào
瑕=hà
疵=tỳ
泛=hiện/hiện lên/hiện ra
乏=mệt/thiếu/phạp
摄=nhiếp/chụp
魄=phách
嗉=tố
召=triệu/cho đòi
教=giáo/dạy/để/bị
抑=ức
独=độc
夕=tịch
阳=dương
绵=miên
怜=yêu/thương
慕=mộ
惘=ngơ ngẩn
弧=cung/hình cung/cầu vòng
寂=tịch
翱=cao
翔=liệng/bay liệng
於=với/sinh/于
原=nguyên
壤=nhưỡng
迂=vu
净=chỉ toàn/sạch
延=diên/kéo dài
展=triển/giương/发
跨=vượt/vượt qua/nhảy qua
越=càng/vượt/việt
局=cục/(ván) cục
宫=cung
脱=thoát/cởi
亡=vong/mất
辞=từ
噩=ác mộng/ngạc
幅=bức/biên độ
忆=ức/(ký) ức
浮=phù/lơ lửng/di động
绪=tự
挈=khiết
闯=xông/sấm
律=luật
剔=loại bỏ/cạo
荷=hà
叶=lá/diệp
滴=giọt/nhỏ/tích/tích
莹=oánh/óng ánh
珠=châu
抹=bôi/xóa/mạt/vệt
斜=nghiêng/tà/vẹo
继=kế
续=tục/tiếp theo
玉=ngọc
搁=đặt
林=lâm/rừng
木=mộc/gỗ/cây
缝=khe hở/vá/may
隙=khe hở
洒=vẩy/rơi vãi/sái/tẩy/chót vót/tung
皎=sáng/kiểu
灿=rực rỡ
烂=nát/thối rữa/lạn/nát vụn
徐=từ
轮=vòng/luân/vành/tua
廓=khuếch
框=khung
烈=liệt/cháy mạnh/ác/mạnh
画=họa/vẽ/bức tranh/họa (vẽ)/tranh
幽=u
萦=oanh
绕=quấn/nhiễu/cuộn/ôm trọn/lượn quanh
填=lấp/điền
满=đầy
漩=tuyền
休=đừng/nghỉ/hưu/thôi
忘=quên
轻=nhẹ/khinh/khẽ
垂=rủ xuống/thùy/buông xuống
螃=bàng
献=hiến
给=cho/cấp/bị
堡=bảo/lâu đài
飘=phiêu/tung bay/thổi/nhẹ nhàng
滋=tư/két
味=vị
朝=hướng/sớm mai/sớm/triều
瞧=nhìn/tiều/trông trộm/coi
漫=khắp/mạn/tràn đầy/ướt sũng
央=ương/van xin/trung tâm
奴=nô
吹=thổi/xuy
乘=thừa/lợi dụng/thừa lúc/ngồi/cưỡi/nhân/x
诺=nặc/ừm/vâng/dạ
善=thiện/tốt
介=giới/trung gian
雅=nhã
纯=thuần/tinh khiết
呼=hô
吸=hút/hấp/hít
波=sóng/đợt/làn/ba/
拂=phật
荡=đãng
甜=ngọt/điềm
带=mang/đái/đeo/kéo/vùng/đai/lẫn
馨=hinh
较=so sánh/khá/tương đối
旱=hạn
胸=ngực/hung
狭=hẹp
窄=hẹp/chật vật
徒=đồ/uổng phí
歌=ca/bài hát
麽=sao
贪=tham
陇=lũng
蜀=thục
坐=ngồi/tọa
牙=răng/nha
窥=dòm/dòm ngó
勿=chớ/vật
缺=thiếu/khuyết
移=dời
仰=ngửa/ngưỡng
唇=môi/thần
启=khải
词=từ
睛=con ngươi
盯=chằm chằm/trành/nhìn chăm chú/nhìn chòng chọc
差=kém/chênh lệch/soa/sai/xui xẻo/sai dịch/error
跳=nhảy/khiêu/đập
卓=trác
旁=bên cạnh/bàng/cạnh/bên
许=hứa/cho phép/tán dương/đính hôn
俯=cúi/phủ/cúi xuống
揉=vò/văn vê/nhu/thuận/vân vê/nhào nặn
丽=lệ
亮=sáng/lượng/sáng lên/phát sáng/rộng mở/lên giọng/to tiếng/bày ra/hiện ra
弯=cong/loan/chỗ ngoặt/khom/ngoặt (khom)
盼=trông mong/phán
妍=nghiên
梨=lê
颊=gò má
秀=tú/thanh tú
脖=cái cổ
颈=cổ/cái cổ/cảnh/gáy
倏=chợt
诱=dụ
雪=tuyết
肤=da
距=cách/cự
遥=xa
纱=sa
吻=hôn/vẫn/mép/môi
探=dò xét/tham/dò/thăm
纤=tiêm
肚=bụng/dạ dày
耐=nhịn
烦=phiền
鞋=giày
笨=đần/bổn/ngu/dốt
拙=vụng/kém cỏi
靴=giày
盘=bàn/cuộn/mâm
膝=đầu gối/đầu gối
脊=sống lưng/sống
挨=chịu/lần lượt/ai/kề bên
舒=thư
服=phục/dùng/mặc/uống
梢=sao/ngọn
虚=hư
茫=mang
圆=tròn
浩=hạo
瀚=hãn
候=đợi
素=làm/tố/món chay
欢=hoan/vui mừng
喜=vui/mừng/thích/hỉ
晚=muộn/chiều muộn/tối
替=thay
昏=bất tỉnh/hôn/ngất
愁=sầu/buồn/ưu sầu
恒=hằng
星=tinh/sao
驰=trì
收=thu/nhận/bắt
观=xem/quan/quán
剧=kịch/phim
迎=nghênh
浅=cạn/nhạt/nông/thiển
薄=mỏng/bạc
判=phán/xử
谨=cẩn
俏=xinh đẹp
腿=chân
喳=tra
瓜=dưa/qua
男=nam
敏=mẫn
郎=lang/đám/chúng
格=cách/nghiên cứu/ô vuông/ô
度=độ
压=ép/áp/đè
灼=đốt/sáng tỏ/lửa đốt sáng/chước
涡=cơn xoáy
皮=da/lì lợm/vỏ/lì
警=cảnh
惕=kính sợ
刁=kén ăn/xảo quyệt
钻=chui/khoan/dùi/xuyên/toản/kim cương
赐=ban thưởng/ban cho/thưởng
措=xử chí
及=cùng/và/cập/kịp/tới
芒=mang/mũi nhọn
闪=tránh/lóe/chuồn/nhanh chóng/thiểm/chợt hiện
蹙=nhàu
拖=kéo/tha
红=đỏ/hồng
慌=hoảng/sợ
脚=chân/cước
烟=khói/thuốc/yên/thuốc lá
火=lửa/hỏa
攀=trèo/víu/phàn
趋=xu thế
骛=theo đuổi
睐=liếc/lãi
荣=vinh/quang vinh
娘=nương/mẹ/mẹ
矫=kiểu
伪=ngụy
栈=sạn
崖=sườn núi/nhai
泻=tả/cuồn cuộn/chảy nước
瀑=thác nước
驻=trú
赏=thưởng/phần thưởng/thưởng thức
迹=dấu vết/tích
咄=đốt/ô hay
锋=phong/mũi
弄=làm/làm cho/kiếm/lộng/chuẩn bị/chơi
乱=loạn/bậy
架=đỡ/khung/cái/chiếc/giá/đánh/trận
论=luận/nói/bàn về
媸=xuy
锺=đồng hồ/chung
谷=cốc
伴=bạn
坟=mộ phần/phần/phần mộ
茔=oanh/phần
兜=túi/vòng/lượn
浇=tưới/giội/dội
谢=tạ/tạ ơn/cảm ơn
噗=phốc/hơi thở phù/hút bập bập/hút từng hơn ngắn
众=chúng
七=bảy/thất
准=chuẩn/đúng/chính xác/cho phép
晨=thần/sáng sớm
帆=buồm
南=nam/Minami
侧=bên cạnh/trắc/sườn/bên/chếch/phe/nghiêng
洋=dương
溶=tan/dung
辰=thần/Thìn
吊=xâu/treo/câu
碍=ngại
吩=phân
咐=phó
驶=chạy/chạy nhanh
岸=bờ
航=hàng
术=thuật
纳=nạp
左=trái/tả/bên trái
雾=sương mù/vụ
馀=dư
模=mô hình/khuông/mô hình (khuôn đúc)
糊=dán/hồ/cháy
巨=cự/to/lớn
馄=hồn
号=hào/số/hiệu/kêu/số hiệu/gào
专=chuyên
型=hình
稳=ổn
几=mấy/hầu như/vài
筹=trù
依=theo/y theo/dựa vào
五=năm/ngũ
甩=vung/súy/vứt/vẫy/bỏ rơi
斤=cân
虎=hổ
估=đánh giá
拾=nhặt/mười
舰=hạm
拟=mô phỏng/nghĩ/nghĩ ra
舟=thuyền
勉=miễn/nỗ lực
唔=ngô/A.../đừng/a
式=thức/Shiki
古=cổ
惯=quen/thói quen/nuông chiều
蛋=trứng/đản
聚=tụ/họp/xóm
忖=nghĩ kĩ
舌=lưỡi
伙=băng/hỏa
尖=nhọn/tiêm/the thé/nhạy bén/mũi
阔=rộng/khoát/rộng rãi/giàu
甲=giáp/A
板=tấm/bản/cửa
桅=cột buồm
构=cấu
浪=sóng/lãng
徵=trưng
忽=chợt/hốt
咒=chú/rủa/nguyền rủa
嵌=khảm
圈=vòng/quyển/giới
哂=mỉm cười/cười
噢=úc/oh/ừ
呈=hiện/hiện lên/trình
瞬=giây lát/trong nháy mắt
着=lấy/mắng
料=liệu/liều
午=trưa/buổi trưa/Ngọ
匆=thông
疾=tật/nhanh
仗=cầm/trận
竹=trúc
谦=khiêm
陵=lăng
斟=châm
酌=rót/chước
膜=màng
昨=hôm qua
仪=nghi/dụng cụ/(dụng cụ)
鼻=mũi
灰=tro/xám/bụi/hôi
俗=tục
云=mây/vân/nói
营=doanh
翼=cánh/dực
谅=lượng
包=bao/túi
括=quát
驾=giá/điều khiển
嫌=ngại
巧=xảo/khéo léo/đúng dịp
渡=độ/chở/sang
眸=mắt/con mắt/mâu/con ngươi mắt
乡=hương/thôn quê
糕=bánh ngọt
饼=bánh/bính
坡=sườn núi
捱=chống cự
昼=ban ngày
充=mạo xưng/sung/nạp
化=hóa/tan
急=gấp/cấp/cấp bách
逞=sính
踪=tung
顶=đỉnh/đính
晴=tình/trời trong xanh
涛=đào/sóng/sóng lớn/
祥=tường/Tường
逐=trục
冠=quan
层=tầng/tằng
礁=đá ngầm san hô
犹=còn/vẫn còn
悸=sợ
舷=mạn thuyền
降=hàng/giảm
坏=xấu/hỏng/hư/phôi/phá hư
拐=ngoặt/gậy/lừa gạt/quải/nạng
捕=bắt/bổ
捉=bắt/hái/tróc/nắm bắt
骤=đột nhiên/chợt
增=tăng
胁=uy hiếp/hiếp
危=nguy
器=khí/ (cụ)
弩=nỏ
箭=tiễn/mũi tên/tiến
投=ném/quăng/đầu
封=phong
尘=bụi/trần
股=cỗ/cổ/luồng/đùi/sợi/dòng/cổ phần
埋=chôn/mai/vùi
挖=đào/oạt/móc
泥=bùn/nê
松=lỏng/tùng
腥=tanh
凶=hung/ác/hung ác
斥=khiển trách/chê/khai thác/xích/đuổi/bác/dò
抗=kháng
拒=cự
偶=ngẫu/ta/chợt/ngẫu nhiên/thỉnh thoảng/tượng/rối
诛=tru/giết
怨=oán
酬=thù
拔=nhổ/bạt/rút/nhổ/rút ra
舱=khoang thuyền/khoang
甫=vừa/phủ
抵=chống đỡ
涯=nhai
概=khái
念=niệm/đọc
泽=trạch
贯=xâu/quan/quán
潇=tiêu
豁=thông suốt
达=đạt
跃=vọt/nhảy
彻=triệt
眠=ngủ
遍=lượt/khắp/biến/lần/khắp cả
滚=lăn/cút/cổn/chảy cuồn cuộn/sôi/lặn đi
熟=quen/chín/thục/thục (quen thuộc)
叙=tự/nói
覆=che
敲=gõ/xao/đập
读=đọc/độc/xem/học
酸=chua/đau xót/axit/toan/chua xót/Toan (a-xit)/mệt
志=chí
偏=lệch/lại/thiên
辣=cay/lạt
胃=dạ dày
据=theo/cư/cứ/căn cứ
奥=áo
换=đổi/thay/hoán/đổi lại/đổi
胎=thai
骨=xương/cốt
洗=tẩy/tắm/rửa/giặt rửa/giặt
髓=tủy
短=ngắn/đoản
母=mẫu/mẹ/cái
六=sáu/lục/ngưu
循=theo
序=tự
渐=dần/dần dần/tiệm
挥=vung
诀=quyết/bí quyết
尝=nếm/từng/thường
验=nghiệm
迳=kính
晰=tích/rõ ràng
仇=thù
帘=màn/mảnh vải
站=đứng/trạm
蝴=hồ
蝶=bướm/điệp
宽=rộng/khoan/chiều rộng
袍=bào
布=vải/bố
极=cực/vô cùng
具=cỗ/cụ/có/bày đủ/đủ/đồ/(chiếc) có
慑=nhiếp
庆=khánh
沫=mạt/bọt
溅=tung tóe/tiên/bắn tung tóe
咆=bào
哮=gào/hao
舵=đà/tay lái
束=buộc/bó/chùm
缚=trói/trói buộc
浓=nồng/đậm đặc/nùng/đặc/dày
周=tuần/chu/xung quanh/vòng
碧=bích
绿=lục/xanh biếc/xanh
冰=băng/rét/đá
寒=lạnh/hàn
咸=mặn
湿=ẩm ướt/thấp/ướt
峻=tuấn
轰=oanh/ầm
逾=hơn/vượt qua
弹=đạn/đánh/gảy/bắn/nảy
绳=dây thừng
歪=lệch nghiêng
颗=khỏa/viên/khối
销=tiêu
报=báo
砸=nện/tạp/đập bể/đập
糟=hỏng bét/tao/nát
躲=tránh/trốn/đóa
倚=dựa/ỷ
赖=lại/ỷ lại/dựa vào/nhờ cậy/vô lại
衡=hoành/nhất định
箍=quấn/đai/siết/cô
散=tán
撒=vung/tát/tản/tung ra/xòe ra/xức/làm càn
迫=bách/sát/vội vã
齐=đủ/tề
堪=có thể
组=tổ
燃=đốt
坚=kiên
蓦=đột nhiên
戟=kích
胆=gan/đảm/mật/can đảm/Can đảm
割=cắt/cát
贼=tặc/trộm/kẻ trộm
金=kim/vàng
讨=lấy/đòi
叱=quát
臻=đạt đến
级=cấp/bậc
擅=thiện/tự ý
质=chất
彬=bân/nho nhã
参=tham gia/vạch tội/sâm/tố/tham
俊=tuấn
群=bầy/đàn/nhóm/quần
捣=đảo
残=tàn
砾=đá sỏi
印=ấn/in
宇=vũ
宙=trụ
脏=bẩn/tạng
扩=khuếch trương
详=tường
阅=duyệt
拇=mẫu/ngón cái
慧=tuệ
纬=vĩ
衣=áo/y
学=học
牛=trâu/ngưu/bò
习=tập/quen
迥=khác hẳn
径=đường/kính
督=đốc
喉=hầu/cổ họng
脐=tề/rốn/yếm cua
殖=thực
阴=âm
杂=tạp/hỗn tạp/lẫn lộn
践=giẫm đạp/thực hiện
塑=tố/nặn
徽=huy
契=khế/văn tự
拳=quyền
叉=xiên
瞑=minh
窍=khiếu
贫=bần/lắm mồm/nghèo
穷=nghèo/cùng
携=mang theo/dắt
宝=bảo
库=kho/khố
狂=cuồng/điên cuồng
沦=luân
锁=khóa/tỏa
匙=chìa/thìa
竖=dựng thẳng
莲=sen/liên
井=giếng/tỉnh/井
掬=cúc
绞=giảo/xoắn/vắt
归=về/thì/thuộc về/quy
缥=phiêu
缈=miểu
恍=bừng tỉnh/hoảng
惚=hốt
渺=miểu/mịt mù
冥=minh
崩=sập/băng/sụp đổ/vỡ
溃=bại
笃=đốc/soạt
藉=tạ
艇=thuyền/tàu
载=chở/lại/tái/tải/năm/ghi
汹=hung
怒=giận/nộ
猛=mãnh/mãnh liệt
劲=kình/sức lực
翘=vểnh/vểnh lên/kiều
峰=phong/ngọn núi/Phong
掠=cướp/lướt
滑=trượt/trợt/trơn trượt
瞪=trừng
恃=ỷ lại/thị
沙=cát/sa
滩=bãi/ghềnh/than/thác
坑=hố/lừa/hãm hại/cái hố/lừa bịp/vũng hố
档=ngăn/hồ sơ/đương/cấp/bậc
奔=chạy/bôn
矢=mũi tên/tiễn
居=cư
撞=đụng/chàng/khua/va
乖=ngoan/nghe lời/quai/láu lỉnh/thông minh
喊=hô/hảm/quát/gọi/kêu
夷=di
损=tổn hại/cay độc
爆=bạo
僮=đồng
迟=trễ/trì
凌=lăng
迸=tóe
铁=sắt/thiết
呜=ô
角=sừng/vai diễn/góc/giác/nhân vật
捏=bóp/nắm/niết/nặn
懈=trễ/lười
挚=chí
升=thăng/lên chức
尺=xích/thước
仓=kho/thương/cabin/chiếm giữ/kho thóc
皇=hoàng/Hoàng
阻=ngăn/ngăn trở
堕=đọa/rơi rụng
冉=nhiễm
惑=nghi ngờ/hoặc
狼=sói/lang
狈=bái
卒=tốt/chết
挟=mang/hiệp/cầm/kẹp
胜=thắng
臂=cánh tay
麻=tê dại/đay/sợi đay/chập choạng/ma
侵=xâm
厚=dày/hậu/dầy
螺=xoắn ốc/loa
屑=mảnh
笔=bút
哗=hoa/xôn xao/ồn ào/rào
酝=ủ
酿=nhưỡng/cất
积=tích
蓄=súc
乌=ô
笼=cái lồng
罩=che đậy/tráo/cái lồng
抓=bắt/trảo/trảo/gãi/
匹=thớt/thất
扑=nhào/phốc/bổ nhào
蛇=rắn/xà
惊=kinh
骇=giật mình/hãi
诡=quỷ
劈=bổ/phách/chẻ/chém
溯=ngược dòng/tố
欲=muốn/dục
盈=doanh/đầy đủ
呛=sặc/sang/hắc
电=điện
芷=chỉ
暂=tạm
稍=hơi/sảo/chút
耽=kéo dài/đam
拉=kéo/lạp/hướng
捎=mang hộ
裂=nứt/nứt ra/rách
颠=điên/đỉnh/xóc
簸=sàng
掷=ném/trịch/quăng
肆=tứ
尸=thi
蜂=ong/phong
纷=lộn xộn
跌=ngã/điệt/hạ
栏=cột/thanh/lan
振=chấn
聋=điếc
嘶=tê/hí/híz-khà-zzz
显=hiển/lộ ra/lộ vẻ/hiện ra
待=đợi/đãi/chờ/ở
儒=nho
斯=tư
悍=hung hãn
铮=tranh/loong coong
锵=bang/thương/cheng/keng/BOANG...
网=lưới/net/võng/ NET/mạng
吭=lên tiếng/cổ họng
退=lui/thoái/thối/lùi
韧=mềm dai/nhận/dẻo dai
懔=lẫm
遁=độn/chui
颓=sụt
夹=kẹp/giáp/chen lẫn/gắp
惨=thảm
蓬=bồng/oành
壁=bích/vách tường
晦=hối
椽=chuyên
征=chinh/trưng thu
堵=chắn/chận
玩=chơi/đùa/ngoạn
掀=vén/nhấc lên/nhấc
严=nghiêm
摧=phá vỡ/tồi
桶=thùng/dũng
恋=luyến/yêu
晃=lắc/hoảng/lay động/sáng ngời
晕=choáng/chóng mặt/vựng/vầng sáng/ngất/choáng váng
喻=dụ/ví
闲=nhàn/rảnh rỗi
喀=rắc
喇=còi/lạt
君=quân/-kun
珍=trân
贴=thiếp/dán
泰=thái
停=ngừng/đình/dừng
肠=ruột/tràng
懵=mộng
灾=tai/tai họa
殿=điện
拣=lấy/chọn/kiếm
澄=trừng/trong vắt
睁=trợn
砰=phanh/ầm/bịch/phịch
塔=tháp
庭=đình
园=vườn/viên
挺=rất/gắng/đĩnh/ủng hộ/cố gắng/khẩu/thẳng
伟=vĩ
慢=chậm/mạn/nhờn
袖=tay áo/tụ
扰=nhiễu/quấy nhiễu
普=phổ
衲=nạp
庄=trang
梁=lương/xà nhà/dầm
闭=bế/đóng/nhắm
敛=liễm
劳=cực khổ/lao
佝=câu
鼓=trống/cổ/vỗ
哄=hống/dỗ/lừa/dỗ dành
刹=sát
椎=chùy
逊=kém/tốn
伏=nằm/ẩn náu/phục/nằm sấp
淌=trôi/chảy
慈=từ
缘=duyên/duyến
悟=ngộ
什=thập/cái
禅=thiền
顽=ngoan
迦=già
悲=buồn/bi
悯=mẫn
咬=cắn/giảo
类=loại/tương tự/thứ/giống như
哑=câm/ách/khàn
罢=thôi/xong/bỏ đi
歹=xấu/ác quỷ
恶=ác/buồn nôn
察=xem xét/xét
邃=thúy
慎=thận
罕=hi hữu
寺=chùa/tự
吐=nôn/nhả/thổ/ói
岁=tuổi/tuế
龄=linh
呃=ách/ạch
胡=hồ
岩=nham
繁=phồn
舍=bỏ/xá
祠=từ
篑=quĩ
恭=cung/cung kính
疲=mệt/mỏi mệt
爬=bò/ba/gãi/cào
络=lạc
元=nguyên/đồng
灯=đèn
枯=khô
挣=kiếm/giãy/tranh/tránh/giãy (kiếm được)
扎=đâm/buộc/mổ/trát/ghim
磨=mài/ma
毅=nghị/kiên quyết
蚁=kiến/con kiến/nghĩ
肌=cơ
秋=thu/thời kì
朗=lãng
弃=vứt bỏ
防=phòng/phòng ngự
裹=khỏa
纸=giấy/chỉ/tử
浸=thấm/ngâm
托=nhờ/nắm/thác/nâng
悔=hối hận/会
诓=lừa gạt/gạt/lừa
骗=lừa gạt/phiến
竭=kiệt
累=mệt mỏi/luy/mệt
欠=thiếu/thiếu nợ/khiếm/ngáp/nợ
遑=hoàng
锣=la/cái chiêng
眩=huyễn
锄=cuốc
孔=lỗ/khổng
维=duy/chiều/chiều không gian
寥=liêu
罗=la/lưới
适=vừa/thích
肉=thịt
筏=bè/phiệt
蕴=uẩn/bao hàm
沟=câu/kênh mương/rãnh mương
袈=ca
裟=sa
茅=mao
规=quy
森=sâm/dày đặc
霸=bá
牢=lao/bền vững/nhà tù/tù
棍=côn
辛=tân/cực nhọc/
撑=chống đỡ/căng cứng/xanh/no/đủ/chống
农=nông
耕=cày/canh
彩=màu/thương/thải
斑=ban/lốm đốm/Madara
斓=lan
披=khoác/khoác trên vai
羊=dê
褂=áo khoác
裙=váy
曳=dắt
裤=quần
绑=buộc/trói
虫=trùng
蚊=muỗi
帕=khăn/bọc
苏=tô/Tô
缴=giao nộp
怯=e sợ
堆=chồng/đống/chồng chất/đôi/đắp
搏=đọ sức/đập/bác
叽=chít/kít/chít chít/chít chít (zhitsss)
咕=cô/cục cục
噜=lỗ/vò/líu ríu/nói nhiều
珑=lung
串=xuyên/xuyến/chuỗi
醋=dấm/dấm chua/thố
译=dịch
篇=thiên/quyển sách
貌=mạo
钮=nút/tay cầm
端=đầu/bưng/mang/đoan
巴=ba/mong
泼=giội
呻=thân
涉=liên quan/trải qua/vượt
曰=nói/viết/gọi
辟=tích
籍=tịch
蕾=nụ/lôi
岭=lĩnh
姿=tư/tư thế/dáng dấp
驱=khu
病=bệnh
瓶=bình
陋=lậu
寮=lều
映=chiếu/ánh
抬=nhấc/khiêng/giơ lên/sĩ/đánh/mang
抢=đoạt/thưởng/cướp
惶=hoảng sợ
村=thôn
朴=phác
旧=cũ/cựu
价=giá/giới/giá cả
钱=tiền/tiễn
懒=lười/lại/lãn/làm biếng/mệt mỏi/kiệt sức
腰=eo/thắt lưng
耗=hao tổn
屋=phòng
鸡=gà/kê/con gà
烛=nến/đèn cầy
蔽=che
焚=đốt
烧=đốt/sốt/thiêu/nướng/xào/cháy/nấu
疤=sẹo
侠=hiệp
街=đường phố/nhai/phố/chợ
址=chỉ
拼=liều/hợp lại/ghép
品=phẩm/phẩm (品)
新=mới/tân
溪=suối
寄=gửi
贵=quý/đắt
江=sông/giang
湖=hồ
敞=mở
沿=xuôi theo/duyên/ven/bờ/mép/dọc theo
赫=hách/Hertz
惦=nghĩ về/nhớ
郑=trịnh
谎=láo/dối
播=truyền bá
欺=lấn/ức hiếp/bắt nạt
约=hẹn/ước/ước chừng
倌=quan
巷=ngõ hẻm
草=cỏ/cây cỏ/thảo
厢=toa/mái hiên
撤=rút/rút lui/triệt
酷=khốc
盛=thịnh/đựng
田=ruộng/điền
野=dã
树=cây/thụ/dựng
狞=dữ tợn
掣=xiết
绰=xước
装=trang/chứa/giả/lắp/giả bộ/làm ra vẻ/sắp xếp/cài đặt
僚=liêu
货=hàng/hóa
咽=nuốt
毙=đánh chết/giết
丛=bụi/tùng/bụi rậm/hợp/bụi rậm
赤=đỏ/xích
裸=lõa/trần/khỏa thân
卧=nằm/ngọa
摔=quẳng/ngã/suất/đánh ngã/té
啸=khiếu/rít gào
泄=tiết
辜=cô/tội
弱=yếu/nhược
愤=phẫn
捷=nhanh/thắng
膛=thân/lồng ngực/thang/ngực
喂=uy/cho ăn/này/đút
匝=vòng/táp
喷=phun
涮=xuyến/rửa
插=cắm/chọc vào/sáp/xuyên vào/trồng/cấy/xuyên
扭=xoay/uốn éo/nữu/quay tay
豆=đậu
额=trán/ngạch/ách
卵=trứng/noãn
爷=gia
冶=dã
鱼=cá/ngư
嘴=miệng/chủy
踢=đá/thích
屁=cái rắm
扮=đóng vai/đóng/giả trang/phẫn/quấy/nhào đều
拦=cản/ngăn đón/lan/ngăn
赔=bồi
催=thúc/thôi/thúc dục/thúc giục
促=gấp rút
怏=ưởng
怠=lười biếng/đãi
闷=buồn bực/im lìm/muộn/ngạt
哼=hừ/hanh/a
膊=cánh tay
授=thụ/dạy
卑=ti/thấp hèn
获=lấy được
亭=đình
殊=thù/khác biệt/đặc biệt
废=phế
伶=linh
综=tổng/tông/tống
爹=cha/đa
葛=cát
黯=ảm
聊=trò chuyện/tán gẫu
侄=điệt/chất
委=ủy
嚷=trách móc/nhượng/cho/kêu gào
焰=diễm
俚=lý
嫁=gả/giá
祸=họa
粮=lương/lương thực
爪=trảo/móng
烬=tẫn
猎=săn/liệp
峙=trì
矮=thấp/ải/lùn
扇=phiến/quạt
睹=thấy/đổ/thấy
艳=diễm/tươi đẹp
窈=yểu
窕=điệu
凛=lẫm/run sợ
纡=quanh co
卜=bốc/bói
帅=soái/đẹp trai/ngầu
巡=tuần
涂=bôi/đồ
炭=than
集=tập/(tụ) tập
贤=hiền
忧=lo
搜=lục soát/sưu
揽=ôm/ôm đồm
俩=hai/lưỡng
政=chính
济=tế
寨=trại
账=sổ sách/món nợ
吓=dọa/hách/hù dọa/sợ/doạ
哲=triết
润=nhuận
劝=khuyên/khuyến/khích lệ
艰=gian
抖=run/đẩu/run rẩy/phấn chấn
洪=Hồng
擒=cầm/bắt/tóm
狡=giảo hoạt
猾=hoạt
枪=thương/súng/phát đạn/đạn
剌=ngượng nghịu
削=gọt
呐=a/nột/...(nột-nói chậm!!!)
雀=tước
仳=tỷ
援=viện binh
讯=tin tức/nhanh/tin
桃=đào
输=thua/vận chuyển/thâu/truyền/nhập
熊=gấu/hùng
锢=cố
嗖=sưu/vèo/vù
粒=hạt/lạp/viên
砍=chặt/khảm/chém
虹=cầu vồng
乍=chợt/sạ
窖=hầm
崔=thôi
丧=tang
控=khống
挤=chen/lách vào
蹑=nhiếp
寡=quả
滞=trệ
夸=khen/khoa trương/khoa/khoe
慝=thắc
銮=loan
咚=đông
匾=biển
辉=huy/sáng chói
煌=hoàng
宾=tân
殷=ân
勤=cần/chuyên cần
建=xây/kiến
筑=trúc/xây
阶=giai/cấp/bậc
苑=uyển
壮=tráng/cường tráng
辆=chiếc
华=hoa
踵=chủng
邻=lân cận/hàng xóm
院=viện/sân
预=dự
订=đặt trước/đính
霉=nấm mốc
棋=cờ/quân cờ
舞=múa/vũ/võ
抱=ôm/bão
焦=tiêu/cháy/sốt ruột/cháy sém/lo lắng
啼=gáy
春=xuân
杏=hạnh
慰=an ủi
孤=cô
痕=ngấn/vết
潺=sàn
叮=đinh/đốt/keng
嘱=chúc/dặn bảo
宏=hồng
楝=luyện
搂=ôm/lâu/vơ/quơ/kéo
丙=bính
唤=gọi/hoán/kêu
哥=ca
谱=phổ
侯=hầu
爽=thoải mái/sảng khoái
颜=nhan
桂=quế
梅=mai
杞=kỷ
梓=tử/Azusa
椅=ghế dựa/ghế/ghế tựa
张=trương/tờ/mở/giương
筝=tranh
银=ngân/bạc
闾=lư
圃=phố
榭=tạ
池=hồ/ao/trì
沼=chiểu
妓=kỹ/kỹ (nữ)
唱=hát
旖=y
旎=nỉ
弦=dây cung/huyền
宁=thà/ninh
窃=trộm
抉=quyết
嗅=ngửi
薰=huân/hun
怩=ngượng nghịu/ny
软=mềm/nhuyễn
供=cung cấp/cúng
豫=dự
玻=kính
蔓=mạn
洽=hiệp
莺=oanh
燕=yến
琴=đàn/cầm/Gin
询=tuân/hỏi ý kiến
彼=kia/đối phương
婢=tỳ
拜=bái/lạy/bye
驭=ngự
漂=phiêu/trôi/nổi/thổi
傲=ngạo
肘=khuỷu tay/khửu tay
衫=áo
襟=vạt áo
纹=văn/vân
捆=trói/khổn/buộc/bó
坎=khảm
挽=kéo/xắn/vãn
按=theo/theo như/án/vỗ/ấn/chứng cứ/theo : đè
躯=thân/thân thể
福=phúc
铃=linh/chuông
健=kiện
啊=a/hả/ah
婴=anh
孩=hài
怫=phật
拨=phát/gẩy
淙=tông
申=thân
脆=giòn
躺=nằm/thảng
渗=thấm
坍=than
塌=sập/lõm xuống/sụp/giường/榻~
怖=sợ
检=kiểm
暇=rảnh
闺=khuê/khuê phòng
寞=mịch
憧=sung
憬=cảnh
袱=phục
团=đoàn/vo
媚=mị
丫=nha
佩=đeo/bội
衬=lót/sấn
屏=bình phong/màn hình/hơi
蛮=rất/man
焕=hoán
睫=tiệp
坛=đàn/vò
敷=thoa
衍=diễn
恼=buồn bực/ảo não/não
饴=di
悬=treo/huyền/nâng
枕=gối
扶=đỡ/vịn/phù
腮=má/mang/quai hàm
俘=bắt được/bắt được (tù binh)
虏=bắt/bắt làm nô lệ
擦=xát/lau/xoa/sát/cọ xát lấy
垣=viên
瓦=ngói/miếng ngói/watt
潮=triều
寇=khấu
僻=tịch/tích
酣=hàm
员=viên/đủ/thành viên
补=bổ/bù
矣=vậy/rồi
轴=trục
寿=thọ
颌=quai hàm
哧=xoẹt/xoạt
惧=sợ
溺=chìm/nịch
财=tài
资=tư
源=nguyên
巩=củng
宿=túc
宰=làm thịt/tể/chủ trì
纠=sửa chữa
涩=chát chát
巢=tổ/sào/sào huyệt
戴=mang
幢=tràng
恩=ân/dạ/ừ
咿=y
钟=chuông/đồng hồ/chung/chuông / đồng hồ
瘦=gầy/sấu
苍=thương
咪=meo/mễ
槛=hạm
柬=giản
漆=sơn/nước sơn
厅=sảnh
岳=nhạc/ngọn núi
盟=minh
祝=chúc
婆=bà
遣=phái/khiến/khiển/sai
恻=xót xa
蒜=tỏi
侥=gặp may mắn
妇=phụ
轩=hiên
誓=thề
幌=màn trướng
煞=sát
值=giá trị/gặp/trị giá/trực
疗=liệu
肥=mập
拢=lũng/áp sát
炙=thiêu đốt
毁=hủy
卸=gỡ/đẩy/cởi/tá/tháo
囊=túi
匪=phỉ
夏=hạ/Hạ
暌=khuê
竺=trúc
谛=đế
衷=trung
妒=ghen
锥=khoan/trùy
揭=bóc/vạch trần
唐=Đường/nhà Đường/đường
赌=cược/đánh bạc/đổ/đánh cược/đánh cược
剂=tề
宣=tuyên
悦=duyệt/vui mừng
舐=liếm
押=áp
仆=bộc
率=suất/tỷ số/dẫn đầu/suất (*tỉ lệ)
绍=thiệu
粹=túy
扛=gánh/khiêng
惟=duy
蛾=nga
丁=đinh
蛔=hồi
雷=lôi/sấm
霆=đình
钧=quân
吉=cát
导=đạo
倘=thảng/nhưng
肢=chi
挑=chọn/chống/chọc/khều/thiêu/khiêu/gánh/hất
烁=nhấp nháy
硕=to lớn
紫=tử/tím/Yukari
戏=hí/hí kịch/kịch
席=tịch/bữa tiệc/ghế
访=thăm/tìm hiểu
噤=cấm
蝉=ve/thiền/con ve
弥=di
氛=phân
植=thực
姊=tỷ
臀=mông
瞳=đồng/đồng tử
稽=kê
谊=nghị
私=tư
壳=xác
龟=rùa/con rùa/quy
亳=Bặc
惭=tàm/tàm (thẹn)
羡=ao ước
织=dệt/chức/SHIKI/đan
逸=dật
屈=khuất
凹=lõm/ao
膨=bành
胀=trướng
箕=ki
霎=một thoáng
戾=lệ
蜘=tri/nhện
蛛=nhện
汇=chuyển/hợp thành/
庞=bàng
敦=thật thà
踩=giẫm/thải/giẫm lên/đạp
副=phó/thứ/bộ
鸦=quạ
鹏=bằng/Bằng
翅=cánh
症=chứng
药=thuốc/dược
克=khắc/gram
椭=thỏa
袂=tay áo/mệ
嘲=trào/giễu cợt
缕=sợi
诣=nghệ
跄=loạng choạng
踉=lương
箱=rương/hòm
搬=chuyển/đem/bàn/dọn sạch/mang/dời
奕=dịch
鏖=ao
拆=phá/hủy đi/sách
拈=nhặt
扳=vịn/ban/vặn/lật
吼=rống
氨=an
揍=đánh/tấu
恙=việc gì/bệnh nhẹ/bệnh
骚=tao
氏=thị
弋=dặc
呵=a
鹿=hươu
佑=phù hộ/hữu
炽=rực
偌=như vậy
竿=can
崭=tiệm
屠=đồ/giết/tàn sát
叔=thúc
畅=sướng
愉=du
洛=Lạc
郡=quận
捺=nại
兮=này
鸿=hồng
瞥=liếc/lườm/miết/liếc về
桥=cầu/kiều
塘=đường/hồ
拱=ủi/cúi lưng/nhú
吁=ô/thở dài
郊=ngoại ô
岛=đảo
椰=dừa/gia
季=quý
汁=nước/nhựa
眺=ngắm/nhìn
娑=sa
甸=điện
漾=dạng
缤=tân
珊=san
瑚=hô
聪=thông/thính giác
跪=quỳ/quỵ
耍=đùa nghịch/đùa giỡn/đùa bỡn
茶=trà
辱=nhục
膳=thiện
桀=kiệt/khặc
殁=một
厌=ghét/chán ghét/yếm
朱=Chu/chu/đỏ thắm
萤=huỳnh
菜=đồ ăn/rau/món ăn/thái
刘=lưu
阖=hạp/đóng
匡=cứu/khuông
捧=nâng/phủng/thổi phồng
评=bình/bình luận
阁=các
樽=tôn
彰=rõ/chương
齿=răng
馒=man
绘=vẽ
徜=thảng
徉=dương
逍=tiêu
旨=chỉ
幼=ấu
誉=dự
昭=chiêu
买=mua/mãi/bán
赚=kiếm/lừa/kiếm lời/lợi nhuận
床=giường/sàng
堤=đê
频=tần/nhiều lần
棚=lều/rạp
帐=trướng
媳=tức
材=tài
碇=đĩnh
蹄=vó/đề/móng/chân
骑=cưỡi/kỵ
杆=cán/cái
嵯=tha
峨=nga
叠=chồng/xếp
翠=thúy/Midori
巍=nguy
缭=quấn
梯=bậc thang/thê/cái thang/trèo
冬=đông
澎=bành
湃=phái
峭=tiễu
滔=thao/đào/thao thao/mênh mông/đầy rẫy/cuồn cuộn
旷=bỏ/khoáng
逗=đùa/đậu/trêu chọc/buồn cười/đậu
庙=miếu
峡=hạp
崎=kỳ/khi
刖=ngoạt
岗=cương vị/tốp
锲=khiết
伯=bá
浊=trọc/đục/bẩn
滇=điền
嘻=ha ha/hi/ôi/hì hì/ha hả
蜿=uyển
蜓=đình
吠=sủa/phệ
绣=thêu
陌=mạch
宋=tống
暮=mộ/chiều
执=chấp
蹦=nhảy
嗤=xùy/xuy/cười/giễu cợt/cười khúc khích/Xùy~~/xì
州=châu
黛=lông mày
博=bác
革=cách
署=thự
霞=hà
牵=dắt/khiên
骜=ngao
驯=thuần
桌=bàn/trác
漠=mạc
吞=nuốt
演=diễn
俐=lợi
冤=oan/oán
贝=bối
怔=giật mình/sợ/sợ run
眷=quyến
抚=phủ/an ủi
羞=xấu hổ/thẹn thùng/nhục
婿=tế/con rể
秤=cái cân/cân
萌=manh/moe/nảy sinh (manh)
恢=khôi
奖=thưởng/tưởng/khen
励=lệ
撮=túm/dúm
秦=tần
斩=trảm/chém
焉=chỗ này/chỗ nào/yên
赢=thắng/doanh
遮=che/chận
坊=phường
尿=nước tiểu/đi tiểu
咙=lung
啄=mổ
妨=trở ngại/phương
褪=cởi
倪=nghê
壶=ấm/hồ/hũ
韩=Hàn/hàn
贸=mậu
撇=phiết
觅=tìm/kiếm/tìm kiếm
喘=thở/thở gấp
樱=anh
懑=muộn
税=thuế
盆=bồn
栽=cắm/trồng
嘘=xuỵt/hư
撕=xé/tê/nhắc/kéo
哭=khóc/khốc
泪=nước mắt
酩=mính
酊=đính
揣=thăm dò/ước lượng/sủy/đo
摩=ma
阀=phiệt
骄=kiêu
咯=lạc/rồi/roài
棘=cức
捂=che/ô/bưng bít
跺=đập mạnh/giẫm
羁=bó
糜=cháo
瞻=xem
募=quyên/mộ
娶=cưới/lấy/thú/lấy
鸽=bồ câu/chim bồ câu
杲=cảo
苗=mầm/miêu
柄=chuôi/thanh
翟=địch/Trạch (họ)
炉=lô/lò/bếp
磊=lỗi/chồng chất
踞=ngồi/cứ
拓=thác/mở đất
舶=thuyền đi biển
岖=khu
储=trữ
泉=suối/tuyền/Izumi
泡=ngâm/cua/phao/bọt/pha/ngâm nước
辅=phụ
擞=tẩu
捍=hãn
鞭=roi/cây roi/tiên
跑=chạy/bào
鹭=lộ
柩=quan tài
葬=táng/chôn cất/mai táng
僵=cương
帽=mũ/cái mũ
倩=thiến/xinh đẹp
颧=quyền
褶=điệp
锦=gấm
黝=đen thui
郁=úc
咎=tội trạng
戚=thích
悻=hãnh
讥=cơ/mỉa mai
惋=thương tiếc
嘉=gia
咧=liệt/rồi/nhếch
嗡=ông/vù vù/vù
伐=phạt/chặt
灌=rót
坪=bãi/bình/bình địa
峥=tranh
嵘=vanh
檐=mái hiên nhà
苟=cẩu/cẩu thả
匠=tượng
钝=cùn/độn
霍=hoắc/bỗng
舂=giã
尔=ngươi/thôi
驳=bác/bác (bỏ)
娜=na
倔=bướng bỉnh
傅=phó
省=bớt/tỉnh/tiết kiệm
摘=hái/trích
刃=lưỡi đao/nhận
靖=tĩnh
臭=thối
沛=bái
廊=hành lang
荫=ấm/bóng râm
茂=mậu/tốt
勃=đột nhiên
株=gốc/gốc cây
槐=hòe
伞=dù/cái dù/tán/ô
诗=thơ/thi
蓝=lam/Ran
屹=ngật
髻=búi tóc
睥=liếc/bễ
睨=nghễ
笋=măng
兢=căng
锻=rèn
盅=chung
骰=xúc xắc/con xúc xắc
缅=xa
恳=khẩn
嬴=doanh/thắng/Doanh
盎=áng
诌=sưu
鲁=lỗ
孺=trẻ con/nhụ
喃=lẩm bẩm
唬=hù/hù dọa/doạ
鬓=tóc mai
霜=sương
衰=suy
匀=vân/đều đặn
匈=hung
虐=ngược/hành hạ
弑=thí
篡=soán
朽=hủ
业=nghiệp/nghề
漏=để lọt/lỗ hổng/rò/lậu
踱=bước đi thong thả
魏=ngụy/Ngụy
协=hiệp
摊=bày/quán/than/vuốt/chia đều
谬=sai
渠=mương/kênh mương
贩=phiến/buôn bán
耻=hổ thẹn
铣=tiển
蒙=được/che/lừa/mê mẩn/đoán mò/mông/ngu dốt/phủ
嫖=chơi gái/chơi/phiêu/chơi trai
贱=tiện
稚=trẻ con/trĩ
媒=môi/mai
腐=mục nát/hủ
柏=bách
铜=đồng
宛=uyển
眨=nháy/trát/nháy mắt
仁=nhân
屡=nhiều lần
侦=trinh thám
簿=sổ ghi chép
册=sách
唾=nhổ/thóa
纭=vân
匿=nặc
聘=mời/sính
鹤=hạc
唳=lệ/Lê-eeee-eezz~!
邀=mời/yêu cầu/yêu
嬉=đùa/chơi
吱=kít
吵=ầm ĩ/nhao nhao/sảo/ồn ào
泳=lặn
鲸=kình
绸=lụa
缎=gấm
羽=vũ
篮=rổ/cái giỏ/giỏ
歇=nghỉ
审=thẩm
铿=khanh/leng keng/lạch cạch/loảng xoảng
汪=uông/gâu
浃=tiếp
湘=Tương
刎=vẫn
售=bán
浴=tắm
咦=a/ồ/di
努=nỗ
巅=đỉnh
窜=vọt/tháo chạy/lủi
漱=thấu
寓=ngụ
淋=xối
漓=li
梧=ngô
搞=làm/kiếm/trị/cảo/làm cho
铅=chì
咋=thế nào/động/người/sao
伽=già
阙=khuyết
悄=lặng lẽ
晋=tấn/tiến lên/Tấn
窠=khoa
臼=cữu
庖=bào
羚=linh
腕=cổ tay/oản
吾=ngô/ta
宠=sủng/cưng chiều
葫=hồ lô
芦=lô
钜=cự
款=khoản/kiểu
锭=thỏi/đĩnh
狐=hồ/cáo
狸=ly/báo
猪=heo/lợn/trư
戈=qua/thương/mâu
垮=đổ/suy sụp/sụp đổ
毗=tì
剪=cắt/kéo/cắt bỏ
烫=bỏng/nóng/sấy/hâm/bị phỏng
镂=lũ/điêu khắc
砖=gạch/cục gạch
媲=bễ
妾=thiếp
梳=chải/chải đầu/sơ
肴=đồ ăn
厨=trù
筵=tiệc lễ
醇=thuần
琥=hổ
珀=phách
曼=man/mạn
碗=bát/chén/oản
碟=đĩa/cái đĩa/điệp
陕=nhanh/thiểm
盏=ngọn/chén nhỏ/ngọn đèn
釉=men/men (gốm, sứ)
粟=túc/túc (hạt kê)
盂=vu
蹩=biệt
愫=tố
筷=đũa
酥=xốp giòn/bánh
疙=ngật
恣=tứ
轨=quỹ
脂=son/mỡ
芙=phù
蓉=dung
穆=mục
鬲=cách
零=số không/0/không/linh/lẻ/không
叨=lẩm bẩm/nhận
操=thao/sử dụng
粥=cháo
脾=tỳ
渝=du/Du - Tứ Xuyên
迈=bước/mại
眶=vành mắt
嫂=tẩu
喽=đi/rồi
梗=ngạnh
沾=dính
蹬=đạp/đặng
厮=tư
赠=tặng
科=khoa
涵=hàm
班=ban/lớp
狱=ngục
颂=tụng
偕=giai/cùng
痒=ngứa/nhột/dương/ốm
熬=chịu/nấu/ngao/rang khô
碌=lục
瞎=mù/mò mẫm
氓=manh
钩=câu/(móc) câu
舢=san
胪=lư
驴=con lừa/lừa
哨=trạm canh gác/còi
卡=thẻ/kẹt/tạp/phiếu
桨=mái chèo
悉=tất
陶=gốm/đào
医=y/chữa
稔=nhẫm
孙=tôn
澡=tắm
宴=yến/tiệc rượu
核=hạch
纶=luân
遵=tuân
豹=báo
涎=nước bọt/nước miếng
谄=siểm/nịnh
赛=thi đấu/thắng
签=ký/lá thăm
编=biên/bện
购=mua/cấu/mua sắm
鼠=chuột
馅=nhân bánh
胯=hông/khố/háng
棒=bổng/tốt/gậy/ca tụng/tuyệt
丢=ném/mất
谵=chiêm
贾=giả/cổ
轿=kiệu
项=hạng
社=xã
秩=trật
弊=tệ
挞=thát
吏=lại
污=ô
梭=toa/con thoi
绮=khinh
佣=dung
婪=lam
佯=dương/giả vờ
扒=đào/bới ra
撬=nạy ra/khiêu
橙=cam/quả cam/chanh/ghế
蒲=Bồ
玲=linh
谙=am
砌=xây/thế
搪=đường
憋=nghẹn/nín
剀=cai
颔=hạm/gật đầu
厂=nhà máy/hán/xưởng/cửa hàng
簧=lò xo
瘾=nghiện
晏=yến
棺=quan tài/hòm quan tài
妹=muội
谇=tối
迭=điệt
赊=nợ/xa
榄=lãm
镜=kính/gương/Kagami
垫=đệm/kê lót/lót
姗=san
睽=khuê
掏=móc/đào/lấy ra
啥=cái gì/gì/cái đó
啪=ba/BA~/đùng
默=mặc/lặng yên
徨=hoàng
拭=lau
哝=nông
氅=áo  khoác/áo cừu/áo khoác
拧=vặn/nhéo/vắt/ninh
犷=hung ác
巫=Vu/vu
膀=bàng
锟=côn
揩=lau
呀=nha/à/ạ
侣=lữ
辩=biện
幡=cờ/lá cờ/phiên
魁=khôi
竞=cạnh/lại còn
兆=điềm báo/triệu/điềm/triệu (*ngàn tỷ)/triệu (*mười triệu tỷ)/ngàn tỷ
踌=trù
躇=trừ
碓=đối
慷=khảng
傍=bàng/bên cạnh
惩=trừng phạt/trừng
簇=đám/bụi
杳=xa ngút ngàn dặm
憾=tiếc
萍=bình
阎=Diêm
伺=tứ
婷=đình
飕=sưu/vù/vèo
诵=tụng
杵=xử/đứng
逆=nghịch/trái ngược
窘=quẫn/(túng) quẫn
奢=xa xỉ
囚=tù
孽=nghiệt
斋=trai/chay
螳=đường
臣=thần
譬=thí
锅=nồi/oa
灶=lò
炫=huyễn
潭=đầm
寐=ngủ
剥=lột/bóc/tróc/bóc lột/bác
蝓=du
癸=quý
蹒=bàn
凿=đục
蚂=mã
烘=sấy khô/hồng
膈=cách
嫩=non
饿=đói/ngạ/đói bụng
眯=híp mắt
屎=phân/cứt/thỉ
腻=dính/ngán/chán
攘=cướp/bài trừ
絮=nhứ/sợi thô
唆=toa/xui khiến
冽=liệt
乒=binh
馔=soạn
疯=điên
疼=đau/thương yêu/đông
函=văn kiện/hàm
镖=tiêu
涨=trướng/phồng
盐=muối
箩=sọt/la
孑=kiết
矶=ki/mỏm đá/ki
逝=trôi qua
霪=dâm
叁=tam/ba
餐=bữa ăn/món ăn/xan/cơm/món (ăn)/món ăn
票=phiếu/vé/phiếu vé
逶=uy
尼=ni
庵=am
邑=ấp
邦=bang
裁=cắt/tài
牍=độc
狩=săn/thú
惠=huệ
页=trang
础=sở
嘀=đích/nói thầm/thầm thì/nghi ngờ/nghi hoặc
鄙=bỉ
辽=Liêu
湍=thoan
丞=thừa
哉=ư/quá thay
觑=dò xét/nhìn trộm
厥=quyết
勒=siết/lặc/cương/đè nén/ghìm cương
猝=bất ngờ
飨=hưởng
璧=bích
挪=chuyển
抄=chép/sao/vớ/xét
辙=triệt
捞=vớt/kiếm/lao/mò
刮=cạo/phá/quát
仟=thiên
患=hoạn/mắc
憎=tăng
肖=tiêu/giống như
沈=thẩm/trầm
恪=khác
洲=châu
绩=tích
镭=Radium
莞=hoàn
攫=quắp/chiếm
偃=ngã/dừng lại/ngã ngựa
屯=đồn
嗔=giận
嗦=lắm điều
牧=mục
杜=đỗ
煎=sắc/rán/pha/sắc thuốc
拘=câu
搅=quấy/khuấy
弁=biện
枉=uổng
迢=điều
薛=tiết
董=đổng
蛊=cổ/sâu độc
隘=ải
彭=bành
幕=màn
澜=lan
襄=tương
溢=tràn/tràn đầy/dật
蝗=hoàng
瞟=nghiêng mắt nhìn
圳=quyến
刑=hình
殃=ương/hại
弘=hoằng
蹲=ngồi xổm/ngồi chồm hổm/tồn
瞰=khám
惮=đan/sợ
肝=lá gan/can/gan
剖=mổ/phẫu
氤=nhân
氲=uân
镳=tiêu
霾=mai
嗣=tự
炀=dương
怂=sợ/kinh sợ/hèn/hãi
恿=dũng
砂=cát/sa
汤=canh/thang/súp
疮=đau nhức/loét
呓=nghệ
笠=nón lá
裕=dụ
淆=hào
歧=kỳ
睚=nhai
铲=xẻng/xúc/xẻng xúc
刊=san
赵=triệu/Triệu
逮=bắt/bắt bớ
霏=phi
兔=thỏ
沮=tự
绥=tuy
庇=che chở/tí
徘=bồi
徊=hồi
诧=sá/kinh ngạc
伊=y
睾=cao
呱=oa
剁=chặt/băm
萃=tụ tập/tụy
魇=yểm/nói mớ/bóng đè
枭=kiêu
臆=ức/ý nghĩ/ngực
链=liên/liệm/liệm dây xích
磁=từ
瘤=lựu
黎=lê
戳=đâm/trạc/dãy
骠=phiêu
炮=pháo
麾=huy
踝=mắt cá chân/mắt cá
霄=tiêu
晒=phơi/phơi nắng
熏=hun
喟=vị
噱=cược
躁=nóng nảy
墨=mực/mặc
厘=ly
拗=cố chấp/ảo/bẻ/khó lay chuyển/đè nén đi/cưỡng
鳅=thu
企=mong đợi
苛=hà khắc/hà
胴=thân mình
厄=ách
曝=bộc
粱=lương
磋=tha
垠=ngần
汲=cấp
勘=khám
疚=day dứt
揖=vái chào/ấp
驿=dịch/dịch trạm
沽=cô
衅=hấn
贺=chúc/hạ
铢=thù
羯=yết
俟=chờ
吕=Lữ
腴=mập/du
嫡=đích
呷=uống
叩=gõ/khấu
嫔=tần
翁=ông
躬=cung
伍=ngũ
棉=bông vải/bông
渍=nước đọng
淳=thuần
涅=niết
觊=mong muốn
觎=du
夭=thiên/yểu/天/yêu
瘟=ôn
疫=dịch
偿=thường/bồi thường
彦=ngạn
昆=côn
艮=cấn
猴=khỉ/hầu
尉=úy
丘=đồi
崛=vùng dậy/quật
囗=vi
柯=kha
箧=tráp/khiếp
彪=bưu
黥=kình
俦=trù
泣=khóc
涕=nước mắt
銎=khung
赳=củ
瞠=trợn/xanh
锤=chùy/nện/chuy
末=mạt/mọn/không/hết/cuối/mỏng/nhẹ/hẹp/chưa
脓=mủ/nùng: mủ
稠=nhiều
洵=tuân
洼=oa
囔=thì thầm
浜=banh
饥=đói/cơ
亘=triền miên
亟=cấp bách
孟=mạnh
驼=còng/lạc đà
庶=thứ
枢=trụ cột/khu
葱=hành/thông/hành tây
鳞=vảy/lân
栉=trất
辖=hạt
贡=cống
廉=liêm/Liêm
嘈=rầm rĩ/ồn ào
晔=diệp
癞=lại
蛤=cáp
蟆=mô
鹅=ngỗng/nga/ngan
澳=úc
啖=đạm/ăn
荏=nhẫm
掺=trộn lẫn/sảm
舴=trách
榻=giường/giường
淑=thục
嗫=chiếp
嚅=nhu
愎=phức
司=ti/tư/ty
隹=chuy
寝=ngủ
痊=hết bệnh
祈=cầu/kỳ/
淞=tùng
窒=tắc nghẽn
铩=sát
泠=linh
喙=mỏ
粑=ba
党=đảng
俾=tỷ
绷=kéo căng/băng bó/banh
忱=thầm
巳=tị
届=giới
姻=nhân
兰=lan
卤=kho/lỗ
莽=mãng
檀=đàn
螓=tần
姚=diêu
盗=cướp/trộm/đạo
余=dư/hơn
肋=sườn/(sườn) lôi thôi
婚=cưới/hôn
球=cầu/bóng
惰=biếng nhác
祷=đảo/cầu khẩn
籁=lại
蜒=diên
枷=gông/cái gông
伎=kỹ
忡=xung
磐=bàn
蹈=đạo
婀=a
庐=lư
殛=cức
豕=lợn/con heo
犄=cơ
债=nợ/khoản nợ/trái
寰=hoàn
龈=ngân
嗟=ta
滕=đằng
闳=hoành
讽=phúng
缸=vạc/vại
矗=súc
忝=thẹn
倥=không
嫦=thường
龋=củ
悴=tụy
肭=nạp
趾=chỉ
浚=tuấn/đào sâu
烤=nướng/khảo/sấy/quay/nướng/sấy
帛=lụa/tơ lụa
徙=tỷ
嗷=ngao/NGAO/gào
乓=bang/pằng
菏=hà
米=gạo/mét/mễ (m)/mễ/thước
炊=nấu/xuy
嗓=tiếng nói
闩=then cài
帷=duy
榴=lưu
雁=nhạn/ngỗng
姘=phanh
杭=hàng
唏=hí
腼=điến
腆=ưỡn
斐=phỉ
睦=hòa thuận
掘=đào/móc
鼾=hãn
蚕=tằm
懊=áo
恫=đỗng
蜜=mật
鹑=chim cút
兀=ngột
囿=câu nệ/hữu
莘=tân
驷=tứ
牺=hi
萧=tiêu
喏=ầy/dạ/ừ
哽=ngạnh
鸣=minh/hót
蹊=hề
辗=triển
阑=ngăn cản
逛=đi dạo/cuống
惆=trù
怅=trướng
柴=củi/sài
卿=khanh
坠=rơi
偻=lũ
骏=tuấn
谗=thèm/gièm pha
京=kinh
纲=cương
陡=đột ngột/xoay mình
赘=vô dụng
彝=Di/di
愀=thiểu
毋=vô
庸=dung
渲=tuyển
叵=phả
摒=bài trừ gạt bỏ
殡=tấn
婕=tiệp
纾=thư
尹=doãn
蛟=giao/thuồng luồng
凤=phượng
乔=kiều
斡=oát
峦=loan
校=trường học/hiệu/giáo
诋=để
诿=ủy
堰=yển
捐=quyên
邱=khâu
饷=lương/hướng
津=tân
沐=mộc
蒂=cuống/đế
暧=ái/mờ/tối
昧=giấu/muội
窑=lò/hầm lò/chỗ trú
奶=sữa/nãi
鞑=thát
妞=cô nàng/nàng/con gái/nữu
疆=cương
谕=dụ
骁=kiêu
骞=khiên
钢=thép/cương
罚=phạt
擎=giơ cao
诞=sinh/đản
莪=nga
忾=hi
宵=tiêu
蚤=bọ chét/tảo
虱=rận/sắt
谣=dao
允=đồng ý
吝=keo kiệt
瑰=côi/hồn/hồn
笙=sênh/sinh
逻=la
茉=mạt
敕=sắc
陀=đà
纥=hột
雍=ung/Ung
掖=dịch
髯=râu
羹=canh
邢=hình
馊=thiu
履=giày/lý
栖=dừng/tê
窦=đậu
忿=phẫn
罔=võng
倡=xướng
偎=tựa/ôi
泱=ương
阐=xiển
橹=mái chèo/lỗ/thuẫn
骥=ký
枥=lịch
爵=tước/cốc ba chân
吒=tra
哕=uyết
殆=đãi
喔=ờ
泯=mẫn
绾=quán
茧=kén/vết chai/kén
觐=cận
铭=minh/chữ khắc
咀=nhai
嚼=nhai
袅=niểu
瓣=cánh/múi/biện/cánh hoa
絷=trập
憨=khờ/đơn giản
抿=nhấp/chải/mân
蒸=chưng/xông
篁=hoàng
淬=tôi/ngâm
诙=khôi
孰=ai
臃=ung
肿=sưng
玑=cơ
棕=tông/nâu
冀=ký
姣=giảo/tướng mạo
踹=đạp/đoán/đuổi
旬=tuần
雩=vu
瘫=co quắp/than/tê liệt
痪=hoán
糖=đường/kẹo/đường kẹo
驮=cõng/đà
黜=truất
菩=bồ
萨=tát
炷=trụ
乞=xin
涧=khe
栗=lật
槌=chùy
诟=cấu
唰=bá/vù
柑=cam
稿=bản thảo
垦=khẩn
涸=cạn/hạc
鹃=quyên
荸=bột
蹶=quyết
遽=cự
袒=đản
嫣=yên
眈=đam
汝=nhữ/mày
孜=tư
彤=đồng
晤=ngộ
隼=chuẩn/chim cắt/lỗ/Chim Cắt
缔=đế
隅=góc
屉=thế
悭=khan
仕=sĩ
欧=âu
伉=kháng
俪=lệ
篷=bồng/cột buồm/mui thuyền
蔚=úy
朔=sóc
潼=đồng
渭=vị
烽=phong
瓮=vò/vò gốm/hủ
熄=tắt
唷=hừm
县=huyện/nếu là địa danh Nhật thì là tỉnh
诊=xem bệnh
锚=neo/cái neo/mỏ neo
缉=tập
娴=nhàn
昌=xương/hưng thịnh/hưng
骡=la/lừa
璋=chương
荐=tiến
愣=sững sờ/cứ thế/lỗ mãng
鷉=thể
菁=tinh
哦=a/nga/ah/nha
仑=luân
奂=hoán
纫=nhân
腋=nách
吴=ngô
涔=sầm
辄=triếp/thì
俨=nghiễm
灸=cứu
馋=thèm/tham
挎=đeo/khoá
诬=vu
蔑=miệt
泅=tù
盒=hộp
萎=héo
膏=cao
肓=hoang
盲=mù/đui mù
嫉=đố kị/tật
荟=oái
嶂=chướng
磅=bang/pound
礴=bạc
尧=Nghiêu
迤=dĩ
沃=ốc
泾=kính
刿=quế
灞=bá
澧=lễ
涝=úng lụt
纽=nữu
郭=quách/Quách
鲫=tức
枋=phương
缮=thiện
纨=hoàn
嚣=rầm rĩ/ồn ào
侗=đồng
翩=phiên
览=lãm
戥=đẳng
绢=lụa
脯=mứt
燥=khô/táo
撩=vẩy/trêu chọc
呕=ọe/nôn/mữa
娆=nhiêu
娥=nga
姬=cơ/hime
俞=du
胄=trụ
楫=tiếp
缬=hiệt
蹭=cọ/chà xát/đi từ từ/chùi/sượt
侮=khinh/khinh miệt
袄=áo
畔=bờ/bên
曙=thự
溟=minh
钒=phàm
匕=dao găm/chủy
枚=mai/miếng/viên
炬=bó đuốc
鹊=chim khách/thước
亨=hừ/hanh
罹=ly
妤=dư
矿=mỏ
孝=hiếu
谒=yết
膘=phiêu/mỡ
捻=vê
赧=thẹn đỏ mặt
朕=trẫm
铡=trát/trảm
赦=xá
磺=hoàng
燎=cháy/liệu
茗=minh/trà
阈=quắc
噪=táo/kêu
卉=hủy
纣=trụ
禀=bẩm
姨=di
麝=xạ
馥=phức
蜗=oa
癖=đam mê/thích
藕=ngó sen
虔=kiền
颖=dĩnh
豚=đồn
殒=vẫn
冻=đông lạnh/đông
茎=thân/hành
捡=nhặt/kiểm/kiếm
哪=cái kia/cái nào/đâu/na/chưa/kia/đó/chỗ nào/nào
拷=khảo
诅=rủa/trớ
贞=trinh
锈=gỉ/gỉ
禹=vũ
舅=cậu
啻=chỉ
撰=soạn
莱=lai
皑=ngai
绚=huyến
谏=gián
讣=phó
厕=xí/vệ sinh
颀=kỳ
滟=diễm
馏=lựu
殉=tuẫn
薪=củi/lương
凋=điêu
丸=hoàn
浆=tương
犀=tê
苔=rêu
丕=phi
炸=nổ/tạc/bùng nổ
琉=lưu
璃=ly
楹=doanh
橡=cao su
鹫=thứu
贿=hối
赂=lộ
猿=vượn
裳=váy/Thường
币=tệ/tiền
铸=đúc
兑=đổi/đoái/đoài
菲=phỉ
孕=mang thai/dựng/chửa
腊=tịch
镶=khảm/nạm
秽=uế
俸=bổng
菊=cúc
篱=ly
咏=vịnh
阕=khuyết
揪=nắm chặt/tóm/nhéo
涤=địch
卯=mão
瘀=ứ
滤=lọc
讳=húy/kiêng kị
诏=chiếu
邸=để/đệ
抡=vung mạnh/kén/chọn/xoay
忐=lo lắng
忑=lo lắng
遏=át
锗=Germanium
跷=khiêu
昵=mật
衙=nha
育=dục
鸭=vịt/áp
蚌=con trai/con trai(bạng)
懦=nọa
殴=ẩu
锨=hân/xẻng
嚎=gào/gào thét
缨=anh
秉=nắm/bỉnh
讫=cật
荼=đồ
攸=du
绎=dịch
蓖=tỳ
箐=tinh/thiến
筒=ống/đồng
跎=đà
俳=bài
沧=thương
桑=tang/cây dâu
裘=cầu/áo lông
瞿=cù
骼=cách
腩=nạm
姥=bà ngoại
槿=cẩn/cẩn (hoa dâm bụt)
圜=viên
凸=lồi
诲=hối
撷=hiệt/ngắt lấy
圭=khuê
臬=nghiệt
淹=chìm
罐=bình/lon
倨=ngạo mạn
椿=xuân
骸=xương cốt
忤=ngang ngược
皓=sáng/trắng bóc
侃=tán gẫu/khản
馑=cận
贬=biếm/giáng chức/cách chức
绺=túm
琬=uyển
摺=gấp/bẻ
钵=bát
恁=thế này
葵=quỳ/Aoi
飙=bão tố
濯=rửa/trạc
颐=di
褥=tấm đệm
掸=phủi
煽=phiến
粲=sán
恺=khải
谜=mê/câu đố
淄=truy
贰=nhị
颁=ban
谀=du
榷=các
柜=tủ
勋=huân/công lao
棱=lăng/đỏ quạch (tỏ ý chán ghét)/cạnh
痞=du côn
帖=thiếp
鸨=bảo
凰=hoàng
兹=tư
玛=mã
瑙=não
靡=mị
豌=oản
酉=dậu
嬷=ma
栩=hủ
裨=tì/bì
挠=cào/gãi/quấy nhiễu/cong
怡=di
刷=xoát/cà/xoạt
鸳=uyên
鸯=ương
逡=thuân
淘=đãi/vo/nghịch
汰=bỏ/thái
熠=dập
淮=Hoài/hoài
娱=ngu
巾=khăn
皂=tạo
傩=na
伥=trành
韶=thiều
篝=cái lồng
戌=tuất
禽=chim/cầm
啕=đào
颦=tần/nhăn mày
妆=trang
镑=bảng
溱=trăn
矜=căng
诨=ngộn
笺=tiên
迓=nhạ
晁=Triều/triều
翦=tiễn
驸=phụ
拌=trộn lẫn
裾=cư
萼=ngạc
扔=ném/nhưng/vứt
昴=mão/Subaru
巽=tốn
馁=nỗi
帚=cây chổi
憔=tiều
疡=dương
佗=đà
磬=khánh
黏=dính
赃=tang
褊=biển
瑞=thụy
亥=hợi
祟=túy/ma
蛭=đỉa/điệt
炒=xào/rang
酱=tương/-chan
牝=tẫn
姹=xá
蟋=tất
蟀=xuất
缀=xuyết
喑=âm
囫=hốt
囵=luân
枣=táo/tảo/cây táo
杷=ba
怦=phanh/thịch
恬=điềm/yên ổn
券=khoán
辕=viên
殚=đàn
菇=nấm
毡=chiên
剿=diệt/tiêu diệt
蹴=xúc
哺=mớm
雇=thuê/mướn
搠=sóc
螂=lang
棵=khỏa/cây/gốc cây
芬=phân
隗=ngỗi
帼=quắc
揶=gia
揄=du
霹=sấm sét
雳=lịch
硝=tiêu
硫=lưu huỳnh/lưu
砒=tỳ
墟=khư
婶=thẩm
俭=kiệm/cần kiệm
艾=ngải
摈=bấn
舔=liếm
狰=tranh
悚=sợ
枫=phong/cây phong
罡=cương
鳖=ba ba/rùa/con ba ba
戎=nhung
拯=chửng
廖=liêu
藤=dây leo/đằng
庚=canh
棠=đường
靶=bia/cái bia
湾=vịnh
墩=đôn
浙=Chiết
玺=tỉ/tỉ (ngọc tỉ)
妩=vũ
谚=ngạn
驹=câu
楞=lăng
咔=két
嚓=xoạt
嘟=bĩu/tít/bĩu môi/bíp
傀=khôi
儡=lỗi
颉=hiệt
佐=tá
鄂=ngạc
肾=thận
痰=đàm
舆=dư
鹬=duật
赝=nhạn
蔺=lận
戍=đóng giữ
昙=đàm/đám mây dày
衢=cù
菌=khuẩn
谶=sấm
哎=ai
漉=lộc
搓=xoa/chà xát
哆=run
呸=phi
闸=áp/hạp
笈=tráp/cấp
煤=than đá
葙=tương
琳=lâm
琅=lang
钳=kìm
您=ngài/nâm/người
蠃=lỏa
涣=hoán
嗒=cạch
坤=khôn
涫=loan
槽=rãnh/cái rãnh
黠=tinh ranh/hiệt
羿=nghệ
荥=huỳnh
嗜=thích/thị
缆=lãm
熙=hi/rộn ràng
嵬=ngôi
忏=sám
瞄=ngắm/miểu
扪=môn
谭=đàm
埸=dịch
颢=hạo/run
菱=lăng
怛=đát
叼=điêu/tha/ngậm/ngậm trong mồm
墓=mộ
蛰=ngủ đông/ẩn nấp
濒=tần
蜮=vực
鹘=cốt
遨=ngao
鹄=hộc
翌=dực
浦=phổ
茈=sài
赈=cứu tế/giúp
罟=cổ
咫=chỉ
荤=ăn mặn
栅=rào/hàng rào
怵=sợ hãi/sợ
晖=huy
琢=mài/dũa
岐=kỳ
氐=để
剜=khoét
杈=chạc/xoa
沌=độn
阜=phụ
剃=cạo
俄=nga
轫=nhận
朦=mông
辘=lộc
侪=sài
幄=ác
雏=chim non
篓=cái sọt
濡=nhu
姜=gừng/khương
乙=Ất/B
蛆=giòi/thư
耘=vân
唠=lảm nhảm/lao
寅=dần
睢=tuy
辎=truy
坂=phản
陲=thùy
湮=yên/nhân
屣=tỷ
邯=hàm
郸=đan
禾=mạ/lúa
渑=thằng
猫=mèo/miêu
韬=thao
曜=diệu/ánh sáng
肪=phương
饲=tự
铨=thuyên
诼=trác
蒋=tưởng/đem
锡=tích/thiếc
耆=kỳ
谑=hước
邋=lạp
撄=anh
麈=chủ
诩=hủ
仞=trượng
嫱=tường
檩=đòn tay
苫=thiêm
猬=vị
眦=khóe mắt
褛=lũ
琐=tỏa
嗯=ân/ừ/ừm/ân/dạ
牡=mẫu
芍=thược
扉=phi
倬=trác
悼=điệu
耶=a/cũng/ư
冕=miện
樯=tường
仄=trắc
燮=tiếp
缡=ly
幔=màn/mạn
绌=truất
哓=hiêu
瑟=sắt
雌=thư/con mái/cái
缱=khiển
绻=quyển
啐=xì/phun
怼=đỗi/oán/đánh/đập/chọc
屐=kịch
闼=thát
缰=cương
玫=hồng/đẹp
漳=chương
麦=mạch
垄=lũng
贲=bí
稂=lang
犊=nghé/độc
榔=lang
荀=Tuân/tuần
睬=không hỏi
踽=củ
鲲=côn
祀=tự
奚=hề
褚=chử/Chử
疋=sơ
沱=đà
廛=triền
淤=ứ/ứ đọng
筲=sao
赎=chuộc
拽=túm/chảnh/túm
锱=tri
铊=tha
炖=hầm/hầm cách thủy/đôn/cách thủy
渤=Bột Hải
稻=cây lúa
蠕=nhuyễn
榆=du
璞=phác
搔=gãi
涿=trác
浏=lưu
跻=tễ
隽=tuyển
镪=cưỡng
娟=quyên/đẹp đẽ/đẹp
膺=ưng
啧=sách
瓢=bầu/hồ lô
谴=khiển
韭=hẹ/cửu
桦=hoa
栎=lịch
佞=nịnh
贷=vay
棹=trạo
蜡=sáp/đèn cầy
翕=hấp
佻=điệu
褐=hạt
胶=nhựa cây/mủ cao su/giao/giao (chất dính)
亵=khinh nhờn/dâm loạn/tiết
讦=kiết
锝=đắc
饨=đồn
舨=bản
娼=kỹ nữ
镒=dật
皙=tích
擢=trạc
桔=kết
怃=vũ
湛=trạm
滂=bàng
钥=chìa/chìa khóa/thược
蓟=kế
葺=tập
洮=thao
狙=thư
旭=húc
捋=vuốt/gỡ
鞍=yên
绶=thụ
轲=kha
祗=chi
臧=tang
钹=chũm chọe/cái nón úp
鸷=chí
皴=thuân
憩=khế
冈=cương
酋=tù
髹=hưu
柘=chá
佬=lão
炳=bính
贻=di
栓=chốt/cái chốt
阉=thiến/yêm/hoạn
谧=mật
榛=trăn
蓊=ống
甭=khỏi phải/khỏi
钡=bối
锎=khai
镅=Americium
暾=thôn
镏=lưu
剐=róc thịt/quả
茵=đệm/đệm
毯=thảm/tấm thảm
蒿=hao/cây ngải
靺=mạt
鞨=hạt
粼=lân
衽=nhẫm
钯=ba
獐=hoẵng
鬃=tông
跤=giao
隶=lệ
貂=chồn/điêu
芭=ba
瓷=sứ
礅=đôn
炔=khuyết
骆=lạc
骷=khô
髅=lâu
弗=không
镰=liêm
鲤=lý/cá chép
砺=lệ
遐=xa
娓=vỉ
擂=lôi
砚=nghiễn/nghiên mực
剽=phiếu
瞅=nhìn
拴=buộc
镫=đăng
葡=bồ
萄=đào
辫=biện
涟=liên/sóng gợn
漪=gợn
哟=nha/ơ
竣=tuấn
诳=lừa gạt/cuống/nói dối/lừa dối
汀=đinh/bãi bồi
麓=lộc
娃=bé con/em bé/oa/trẻ con
垛=đống/gò
咖=cà/già
嗽=thấu
瘁=tụy
撅=vểnh lên
沓=xấp/xấp (liên tục)
恤=lo lắng/tuất/thương xót/T-shirt
靳=cận
婊=biểu
嗥=gào/grraaào
盔=nón trụ
苇=vi
羔=cừu con
绊=vấp
舜=thuấn
卢=lư
嘬=mút/toát
陨=vẫn/rơi
哇=oa
汨=mịch
篙=cao
樟=cây nhãn
鲢=liên
姝=thù
镯=vòng tay
吆=yêu/hét
獠=liêu
版=bản/hãy
讹=lừa bịp/ngoa/hạch
袤=mậu
踊=dũng
酪=lạc
穹=khung
翎=linh
铠=khải
粘=dính
稼=trồng trọt
溉=khái
叭=bá
胞=bào
札=trát
馈=quỹ/trấn
莎=toa
呖=kíu/lịch
胧=lung
顷=khoảnh
厩=cứu
孪=loan
荜=tất
茄=cà
芜=vu
瑶=dao/ngọc
肮=khảng
咤=trá
瑜=du
刽=quái
鸠=cưu
凳=băng ghế/đắng/ghế
暝=minh
芋=dụ
茹=như
泓=hoằng/dòng
诠=thuyên
偈=kệ
芥=giới
簪=trâm/Kanzashi
蝎=bọ cạp/hạt
糙=cẩu thả/tháo
栊=long
攒=tích lũy/tích góp
趴=nằm sấp/nằm úp sấp
檬=mông
霁=tễ/nguôi
钤=kiềm
箅=ty
旒=lưu
萁=ki
苌=trường
丐=cái
儆=cảnh
褴=rách tả tơi
胫=hĩnh
烹=nấu
秒=giây/miểu
娅=á
疽=thư
羸=luy
淅=tích
沥=lịch
圉=ngữ
囤=độn
窟=quật/hang
挢=kiệu
蛲=nhiêu
柢=để
痈=ung
遢=tháp
劂=quyết
赣=Cán
懿=ý
豺=sài
诃=ha
桐=đồng
紊=rối
铙=nao
烃=hĩnh
彗=tuệ
岘=hiện
螟=minh
汽=hơi/khí
釜=nồi đồng
潦=lạo
卦=quẻ
坯=phôi
炕=giường/kháng/khô ráo/nướng/sấy/hé ra/mở ra
龛=bàn thờ
釆=biện
课=khóa
孵=ấp trứng/ấp
牟=mưu
垢=cấu
蘧=cừ
畴=trù/dự định
牒=điệp
昃=trắc
槁=khô héo
珈=già
斛=hộc
黍=thử
拊=phụ
桠=nha
泞=nính
亚=á/kém
逄=bàng
糢=mô
藻=tảo
蕙=huệ
港=cảng
彿=phất
惬=thiếp
亿=ức/trăm triệu
瘌=lạt
孳=tư
菅=gian
猖=xương
钿=điền
弭=nhị
怆=sảng
趸=độn
蛙=ếch/oa
廿=hai mươi
筐=giỏ
蜷=cuộn tròn/quyền
祚=tộ
霭=ai/sương
觔=cân
删=xóa/xóa
茁=truất
纛=đạo
睑=kiểm
挲=vuốt/sa
峪=dụ
砥=chỉ
淇=kỳ
壕=hào
虾=tôm/hà
堞=điệp
糠=khang
枇=tỳ
沆=hàng
冢=mộ
渎=khinh
汴=biện
搐=súc
妈=mẹ/mụ
骊=ly
彀=cấu
迄=đến/bèn
啬=sắc
谲=quyệt
骧=cất cao
仝=đồng
陂=pha
窸=tất
窣=tốt
钗=trâm/sai/thoa cài tóc/trâm (cài tóc)
邙=mang
旌=tinh
瓒=toản
窿=lung
恽=uẩn
徇=tuẫn
绫=lăng
祉=chỉ/Chỉ
崽=con/tể
堑=hố/hào
蒺=tật
藜=lê
膂=lữ
阮=nguyễn
熔=dung/nấu chảy
蚋=nhuế
碑=bia
莅=lỵ
蛀=đục
瘠=tích
爸=cha/ba
祺=kỳ/Kỳ
媛=viện
雯=văn
闽=mân
尢=uông
纺=tơ lụa
烊=dương
逅=cấu
勺=muôi/chước/muỗng
琦=kỳ
挛=luyên
蜻=tinh
桧=cối
鲈=lư
痹=tý
蚶=ham
蝌=khoa
舀=múc/cầm
瘪=xẹp/quắt
爻=hào
迨=đãi
妯=trục
臾=du
夔=quỳ
租=thuê/tô/cho thuê/mướn
屿=tự
坷=khả
蔡=thái
锯=cưa
芝=chi
柠=nắm
摹=mô
痢=lỵ
嘹=liệu
玷=điếm/làm bẩn
扈=hỗ
侩=quái
赁=nhẫm
糯=nhu
癫=điên
隍=hoàng
瞌=khạp
楔=tiết
瑀=vũ
裱=phiếu
慵=thung/biếng nhác
婥=sước
鞠=cúc
缯=tăng
绅=thân
琵=tỳ
琶=bà
笛=địch
鞚=khống
蝇=ruồi/dăng
铤=đĩnh
戊=Mậu/mậu
琊=gia
詹=chiêm
邵=Thiệu
羌=khương
抒=trữ
曦=hi
沁=thấm
坞=ổ
绯=phi
酗=hú
碉=điêu
鮰=nguy
蹂=chà đạp
躏=lận
阪=dốc núi
嵩=tung
霖=lâm
饯=tiễn
筛=si
龚=cung
刭=hĩnh
柙=cũi/hiệp
斌=bân
汾=phần
陟=trắc
艨=mông
艟=đồng
舸=khả
渚=chử
甬=dũng
坝=đập/bá
搀=nâng
淝=phì
琛=sâm
谔=ngạc
鳌=ngao
磕=đập/dập đầu
莠=xấu
袁=viên
漕=tào
潘=phan
萋=thê
樵=tiều
啷=lang
奄=yểm
磴=đặng
篆=triện
祁=kỳ/Kỳ
绒=nhung
悽=thê
脣=thần
藐=miểu
姪=điệt
杉=sam
檥=nghĩ
蝈=quắc
牯=cổ
榨=ép
氧=dưỡng/oxi
璀=thôi
轾=chí
咱=ta
翳=ế
刍=sô
摰=chí
邂=giải
蛩=cung
悱=phỉ
舛=suyễn
罄=khánh
禺=ngu
泷=lang
粪=phân/cứt/phẩn
蜕=thuế
郝=hách
晟=thịnh
炯=long lanh
橱=thụ
隧=hang ngầm
钙=canxi
抟=đoàn
箔=bạc
惴=chúy
鹗=ngạc
肫=truân
劻=khuông
牴=để
匮=quỹ
诫=giới
狄=địch
縻=mi
褫=sỉ
叟=tẩu
箝=kiềm
桢=trinh/Trinh
牖=dũ
熨=ủi
壼=khổn
馐=tu
侬=nông/anh
粽=tống
貉=con chồn
鎌=liêm
槟=tân
岑=sầm
荞=kiều
逑=cầu
舖=phô
犒=khao
魑=Si
悖=bội/ngược lại
睿=duệ
洹=hoàn
拮=kiết
祯=trinh/Trinh
滨=tân
蜃=thận/thận (*con trai)
谪=trích
箇=cá
薇=vi
幞=phốc
帔=bí
裥=cán
忸=nữu
暑=nóng
砧=châm
襦=nhu
沖=trùng/vọt
绛=giáng/đỏ thẫm
辇=liễn/xe kéo
陛=bệ
搦=nạch
燄=diễm
躅=trục
昇=thăng
恆=hằng
獃=ngai
採=thải
粤=Quảng Đông/Việt(quảng đông)
勣=tích
蕉=tiêu
喋=điệp
脍=quái
蠡=lãi
榕=dung
荑=đề
徕=lai
飒=táp
岌=ngập
靥=má lúm đồng tiền/lúm đồng tiền
锾=hoàn
宥=hựu
祇=kỳ
荧=huỳnh
淖=náo
桡=nạo
啜=xuyết/uống
劾=hặc
檄=hịch
栋=tòa/tòa nhà/đống/nóc
诘=cật
楮=chử
穑=sắc
奼=xá
狻=toan
磷=lân
顼=húc
鳝=thiện/lươn
錾=tạm
苣=rau diếp
藩=phiên
栀=chi
驽=nô
褒=bao
跛=cà thọt
懋=mậu
蟑=chương
姒=tự
蹼=màng
翮=cách
盹=chợp mắt/ngủ gật
誊=đằng
俎=trở
畋=điền
诤=tránh
聱=ngao
猥=hèn
蓓=bội
崴=uy
鳗=man
僩=giản
盥=quán
浣=hoán
煦=húc/húc
绂=phất
谌=kham
谯=tiêu/tiếu
俑=tượng/tượng (chôn chung với người chết)
阗=điền
胼=biền
俺=ta/yêm/ta đây/ore
瘢=ban
芩=cầm
觯=chí
渥=ướt át
棣=lệ
稷=tắc
苋=hiện
嘤=anh
咛=ninh
秾=nùng
檠=kềnh/kình
诂=cổ
缁=truy
楠=nam
婠=loan
夯=kháng
胳=ca
跶=đáp
檑=lôi
珣=tuần
洺=minh
嘎=dát/Ự...c
邴=bỉnh
泵=bơm/cô/tuyền
钊=chiêu
烯=ankin
铀=Uranium/Urani
铐=còng tay
琱=điêu
脎=thỏa
烷=hoàn
孓=củng
捅=đâm/chọc/thống/thọt
轀=ôn
醣=đường
坭=nê
祆=hiên
哒=đát/đi
啃=gặm/khẳng
怄=âu
枱=đài
惷=xuẩn
朐=cù
揹=bội
鎏=lưu
籎=ngữ
唧=tức
崟=dần
嫘=luy
艿=nãi
锶=tư
锔=cư
儅=đang
詻=ách
泗=tứ
佈=bố
愍=mẫn
樑=lương
掮=kiên
苻=phù
慓=phiếu
逖=địch
庾=dữu
倖=may
蟠=bàn
岷=dân
盪=đãng
瞇=mị
瘴=chướng
璨=xán
糅=hỗn tạp
埃=ai/cát bụi/bụi
淀=điến/lắng đọng
拄=trụ
煮=nấu/chử/đun/luộc
霓=nghê
厦=hạ
飓=cụ
扥=thác
铛=keng/đang
魈=tiêu
蟒=mãng
啾=thu/chụt
齑=tê
蟹=cua/giải
聂=Nhiếp/Niếp
獗=quyết
阌=văn
挝=qua
赜=trách
蠓=mông
碛=thích
藓=tiển
勰=hiệp
蚍=tỳ
艽=giao
茨=tỳ
缋=hội
涞=lai
鸾=loan
琼=quỳnh
岫=tụ
麒=kỳ
麟=lân
蚱=con ve
蜢=châu chấu/mãnh
蜈=ngô
蚣=công
鲨=cá mập/sa
婵=thiền
鳄=ngạc/ngạc(cá sấu)
苹=bình
鍪=mâu
胚=phôi
吮=mút
坳=thung lũng
蔼=ái
翡=phỉ
讴=âu
眇=mù
辑=tập
掐=bóp/véo/kháp/bấm
痔=trĩ
讪=ngượng/ngượng ngập
镀=mạ/độ
鸱=si
馓=tản
蠹=mọt/con mọt
鹕=hồ
椤=la
硗=khao
饽=bánh ngọt điểm tâm
岬=giáp
疹=chẩn
町=đinh
溧=lật
碳=than/cacbon
庋=kỹ
饣=thực
哿=cả
卬=ngang
咻=hưu/XÍU...UU!/xèo
醍=thể
醐=hồ
缪=mâu
亩=mẫu
鲠=ngạnh
厣=áp
宕=đãng
缛=nhục
蘑=ma/nấm
蹉=tha
虢=quắc/Quắc
蕹=ung
埂=canh
缌=ti
荩=tẫn
粕=phách
痘=đậu
墅=thự
剎=sát
徭=dao
倜=thích
刨=đào/(đào) bào
呦=u/ôi
涓=suối/chọn
椒=tiêu/ớt
楷=giai
痣=nốt ruồi
樊=phiền
雉=trĩ
吶=nột
宦=hoạn
瘩=đáp
蝟=vị
嚏=hắt xì/hắt hơi/đế
跚=san
咨=tư
啤=bia
礡=bạc
茸=nhung
掇=xuyết
汕=sán
儋=đam
狎=suồng sã/cặp kè/hiệp
呿=khư
鐶=hoàn
犁=cày/lê
嗨=này/hải/high
荳=đậu
醆=trản
嶙=lân
峋=tuân
熳=mạn
浬=lý
冗=nhũng
蹋=đạp
泌=bí
吨=tấn/đốn
掂=ước lượng
渣=cặn bã/tra/mẩu vụn/mảnh vụn
晾=phơi/gạt/bỏ
拎=xách
噎=nghẹn/ế
翰=hàn
慥=tháo
敭=dương
慴=triệp
瑴=giác
圾=ngập
浥=ấp
牦=ly
浡=nổi lên
潢=hoàng
灳=linh
湩=chúng
潴=trư
桴=phù
桮=bôi
楥=huyên
楳=kỳ
敺=khu
楂=tra
畨=phiên
汩=cốt
愠=hờn/giận
猷=du
垃=rác
啡=phê
噘=quyết/cong
靓=tịnh
痉=kinh
壬=nhâm
钞=tiền giấy/sao
甥=sinh/cháu trai
欷=hi
熹=hi
皈=quy
喁=ngung
雎=sư
颚=hàm
猱=nhu
掴=tát
掼=quăng/quán
倭=Uy
蔬=sơ/rau
昉=phưởng
黩=độc
锼=sưu
趹=quyết
栘=di
埠=phụ
鬣=liệp
仃=đình
垓=cai
雹=bạc
璩=cừ
詈=lỵ
邓=đặng
癯=cù
谩=mạn
锹=cái xẻng/thiêu
醺=say/say rượu
簌=tốc
圯=di
颏=hài
芽=mầm/mầm mỏ
姆=mẫu/mu
傥=thảng
辔=bí
侔=mâu
蓑=thoa
轶=dật
踬=chí
殓=liễm
镔=tấn
秆=thân/cán
湓=bồn
荻=địch
絃=huyền
闇=ám
舫=phảng/thuyền
篦=bề
遶=nhiễu
溼=ẩm ướt
哳=triết
擘=phách/ngón cái
獾=chồn
魉=lượng
媾=cấu
觳=hộc
欤=dư
埒=liệt
鼐=nãi
殄=điễn
衾=chăn/khâm
畸=cơ/ki
衮=cổn
鄱=bà
蚩=xi
悌=đễ/kính
恸=thảm thiết
缵=toản
萝=la
澶=thiền
脔=luyến
鹦=anh
骟=phiến
郫=bì
荇=hạnh
笫=chỉ
卺=cẩn
笳=già
绦=thao
娉=phinh
芸=vân
氖=nãi
玮=vĩ
兖=duyện
靼=đát
撵=đuổi/niện/đuổi đi
楣=mi
缲=sào
辚=lân
扃=quynh
逵=quỳ
豉=chao/thị
堠=hậu
埕=trình
赀=ti
肛=giang/chống/hậu môn
鲷=điêu
鑫=Hâm
帧=tấm/tránh
醮=tiếu
缃=tương
鲔=vị
胭=son
榉=cử
腱=kiện
佃=điền
筠=quân
柚=dữu
裎=trình
甄=chân
苜=mục
鳢=lễ
晷=quỹ
裣=liêm
饺=sủi cảo
鲍=bảo
帏=vi
稹=chẩn
溆=tự
氯=lục
僭=tiếm
谝=biển
敖=ngao
趄=nghiêng
奘=trang
逋=bỏ trốn
枰=bình
薏=ý
胱=quang
蒉=quỹ
辍=ngừng/xuyết/thôi/nghỉ
绉=trứu
琨=côn
琪=kỳ
璐=lộ
佰=bách
髭=tỳ
腺=tuyến
搿=cách
埔=bộ
阒=khuých
慊=khiểm
崤=hào
嫫=mô
壹=nhất
恚=khuể
蜚=phỉ
崧=tung
泫=huyền
汶=vấn/Vấn
捶=nện/chủy/đấm/nện
鸥=âu/hải âu
盍=hạp
狃=nữu
捩=liệt
缦=man
瘸=què/cà nhắc
雒=lạc
芰=kỵ
嵋=mi
枸=cẩu
觏=cấu
谍=điệp
濠=hào
薜=bệ
罘=chúng
瀛=doanh
洎=kịp
榇=sấn
庑=vũ
殂=chết
禳=nhương
缣=kiêm
讼=tụng
宄=quĩ
麂=kỷ
舳=trục
碾=ép/nghiền
舻=lô
矾=phèn
夙=túc
濂=liêm
皲=quân
橘=quýt/quất
厝=thố
煜=dục
裒=bầu
酲=trình
燠=úc
玟=mân
跖=chích
讷=nột
嗳=ai
钠=Natri
畿=kỳ
钰=ngọc
宸=thần
擐=hoàn
桁=hành
痍=di
卅=tạp
秣=mạt
猕=mi
襁=cưỡng
褓=bảo
芫=nguyên
琮=tông
鳏=góa/quan/góa vợ
龇=thử
袜=vớ
猩=tinh
戡=kham
琏=liễn
镌=tuyên
砣=đà
闰=nhuận
泮=phán
赭=giả
逦=lệ
滓=cặn
胤=dận
皖=Hoàn
竽=vu
稞=khoa
岚=lam
坩=kham
磔=trách
骈=biền
琰=diễm
滁=trừ
壑=khe
獬=giải
糈=tư
畦=huề
囱=song
铍=phi
锒=lang
蝼=lâu
湎=miện
鹳=quán
鬟=hoàn
鸬=lô
嗑=gặm
鏊=ngao
芮=nhuế
伫=đứng im lặng hồi lâu
迪=địch
镛=dung
溏=đường
鲎=hấu
陴=bì
呶=nao
耦=ngẫu
苞=bao
哙=khoái
铉=huyễn
笆=ba
擗=bịch
佥=thiêm
隈=ôi
滹=hô
浒=hử
揆=quỹ
笞=quất/si
筌=thuyên
氮=nitơ/nitrogen
阡=thiên
觞=thương/chén
淼=miểu
邹=nhăn/trâu
沅=nguyên
毽=kiến
岱=đại
砦=trại
杓=tiêu
戛=kiết
庳=bí
孥=nô
缄=giam
捭=bãi
枨=tranh
荠=tề
廨=giải
焙=bồi
苯=bổn
饬=sức
蓿=túc
鳎=tháp
艋=mãnh
鸩=trấm/chậm
豢=nuôi
娄=lâu
莴=oa
踼=thang
拏=nã
饫=ứ
餍=yếm
娲=oa
煅=nung
踮=điểm/nhón chân
谤=báng
芹=cần
阊=xương
瑛=anh
跣=tiển
澌=ti
蹇=kiển
蟾=thiềm
奁=liêm
觥=quang
闱=vi
笏=hốt
杠=đòn khiêng/gạch
褡=đáp
玳=đại
瑁=mạo
迕=ngỗ
胥=tư
颡=tảng
趑=tư
矧=thẩn
亶=đản
槎=tra
钺=việt
裔=duệ
珰=đang
弼=bật
暨=kỵ
缟=cảo
诽=phỉ
椠=tạm
呎=thước
捥=oản
畯=tuấn
敂=khấu
楸=thu
畮=mẫu
湲=viên
瑯=lang
睆=hoản
瑲=thương
牂=tang
桫=sa
汐=tịch/Tịch
祢=nễ/họ Nễ
獭=rái cá
楬=kiệt
焠=thối
楦=tuyên
剏=sáng
橤=nhị
汧=khiên
匊=cúc
灩=diễm
湫=tưu/thấp trũng hồ nước
獯=huân
桰=quát
祲=tẩm
楯=thuẫn
楡=du
敎=giáo
楢=do
畧=lược
潍=duy
桷=giác
扢=cột
畱=lưu
畬=dư
祫=hợp
畆=mẫu
畤=chỉ
瑉=mân
扵=ư
湏=tu
慆=thao
畣=đáp
慤=khác
牣=nhận
牮=tiến
慂=dũng
灬=hỏa
捵=điến
捴=tổng
樠=man
橥=trư
漵=tự
汆=thộn
浭=canh
畺=cương
漶=hoán
汭=nhuế
畊=canh
潆=oanh
莆=phủ
蘸=chấm/trám
徬=bạng
谆=truân
噫=y
憝=đỗi
斫=chước
鬈=quyền
摽=phiếu
幛=chướng
榫=chuẩn
饕=tham ăn/thao
餮=thiết
卞=biện
尻=khào
蓰=tỷ
痨=lao
佟=đông
戕=tường
孀=sương
佼=giảo
毵=tam
邝=quảng
忒=quá
锏=giản
贮=trữ
愆=khiên
臊=thẹn/tao
煨=nướng/nướng (lò nóng)
挹=ấp
橛=cọc/quyết
芯=tâm
狯=quái
伧=sinh
耙=bá
鹪=tiêu
揲=thiệt
橐=bễ thổi lửa
矍=quắc
铄=thước
骱=giới
茜=thiến/Tây/Akane
躐=liệp
疟=ngược
镊=nhiếp
怿=dịch
疸=đản
煊=huyên
阄=cưu/cái thăm
戆=tráng
凫=phù
蝮=phúc/rắn hổ mang
薯=khoai
搽=bôi
墉=dung
琯=quản
戼=mão
挼=noa
朮=truật
攮=nãng
铗=kiệp
崃=lai
菸=ư
蘼=mi
蠛=miệt
弈=dịch
缒=trúy
偬=tổng
佶=cát
鹉=vũ
咂=chép miệng
娈=luyến
噙=chứa
酡=đà
搡=đẩy/táng
鸢=diên
璎=anh
鲵=nghê
诮=tiếu
攥=nắm
兕=tê giác
匍=bồ
匐=bò xổm
蔻=khấu
龌=ác
龊=bẩn thỉu
蚨=phù
狲=tôn
蚪=đẩu
瀣=dới
梆=bang/mõ
猊=sư tử
奎=khuê
潋=liễm
柿=thị
撂=đặt xuống
烨=diệp
箴=châm
羲=hi
撺=thoán
阋=huých
佘=xa/xà
妪=ẩu
椁=quách
讧=hồng
猢=hồ
艹=thảo
酆=phong
侨=kiều
疝=sán
汛=tấn
癌=ung thư
鱿=vưu
踟=trì
蹰=trù
唢=tỏa
踅=tuyệt
遛=lưu/dắt
洱=nhị
堇=cận
嬗=thiện
囡=niếp
秧=ương
洊=tiến
稗=bại
剞=kỷ
骃=nhân
颛=chuyên
喾=khốc
劭=thiệu
缙=tấn
蟜=kiểu
踰=du
叡=duệ
蓺=nghệ
貔=tỳ
貅=hưu
魃=bạt
菽=thục
榖=cốc
妫=quy
阚=hám
髀=bễ
诐=bí
筴=sách
崆=không
峒=động
笄=kê
郦=ly
猃=hiểm
狁=duẫn
玁=hiểm
蓍=thi
筭=toán
寤=ngụ
豸=trĩ
蜉=phù
隰=thấp
僖=hi
旄=mao
徼=kiếu
邛=cung
肇=triệu
蜺=nghê
舄=tích
絜=kiết
濮=bộc
鲋=phụ
嶷=nghi
龆=điều
龀=sấn
訾=tí
邰=thai/Thai
嫄=nguyên
娀=tung
藿=hoắc
旸=dương
氄=nhũng
旻=mân
嵎=ngu
毳=thuế
讙=hoan
鲧=Cổn
嚚=ngân
烝=chưng
匽=yển
熛=tiêu
禋=nhân
眚=sảnh
怙=hỗ
邕=ung
顗=nghĩ
壅=ủng
蔟=thốc
蕤=nhuy
秬=cự
龠=dược
妣=tỷ
谟=mô
徂=tồ
纁=huân
鴈=nhạn
贽=chí
鹜=vụ
繇=diêu
耄=mạo
劓=nhị
剕=phí
槚=giả
驩=hoan
梼=đào
杌=ngột
浔=tầm
沂=nghi
鄄=quyên
漯=tháp
瞽=cổ
窳=dũ
絺=hi
廪=lẫm
扞=cản
惇=đôn
盬=cổ
麤=thô
隤=đồi
尨=mang
扺=chỉ
皋=cao
倕=thùy
籛=tiên
莳=thì
冑=trụ
匏=bào
廋=lục soát/ẩn náu
苡=dĩ
胙=tạc
爰=viên
曛=huân
坼=sách
亹=vỉ
橇=khiêu
蕝=toát
擿=trích
覃=đàm
碣=kiệt
翊=dực
彘=trệ
邺=nghiệp
虖=hô
楛=hộ
镞=thốc
酹=lỗi
沇=duyện
篚=phỉ
畎=quyến
莒=cử
厎=chỉ
埴=thực
峄=dịch
蠙=tân
邳=bi
苴=tư
蚬=hiện
薮=tẩu
洳=như
旐=triệu
苎=trữ
杶=suân
栝=quát
砮=nỗ
匦=quỹ
泸=lô
嶓=Bá Trùng
浈=trinh
瞢=măng
瀍=triền
垆=lư
纻=trữ
泆=dật
璆=cầu
沔=miện
湔=tiên
镠=lưu
罽=kế
玕=can
邠=bân
鄠=hộ
枹=phu
鳃=mang
濩=hoạch
圄=ngữ
颍=dĩnh
甑=nồi đất
岣=cẩu/câu
嵝=lũ/Lũ
澨=phệ
醴=lễ
鄯=thiện
潞=lộ
渟=đình
汜=tỷ
秸=cành cây
刈=ngải
穗=tuệ
乂=nghệ
浍=quái
肱=quăng/cánh tay
嬖=bế
宪=hiến
脞=thỏa
蓼=liệu
郾=yển
僇=lục
帑=nô
鉏=sừ
浞=trác
豷=ế
缗=xâu
杼=trữ
髡=khôn
奡=ngạo
缑=câu
殽=hào
郏=giáp
圹=khoáng
洫=hức
胝=chi
阏=át
诰=cáo
媵=thiếp
侁=sân
濞=tị
柰=nại
赉=lãi
旆=bái
泂=huýnh
虺=hủy
搤=ách
呴=ha
孚=phu
肜=dung
醢=hải
羑=dũ
滏=phũ
邘=vu
曷=hạt
刳=khô
髦=mao
辂=lộ
圮=tổn thương
忻=hân/hãn
斄=ly
寘=trí
腓=phì
豳=bân
隃=du
绀=cám
盩=chu
鬻=dục
谮=trấm
瓠=hồ
觚=cô
镐=hạo/xà beng
縢=đằng
瘳=sưu
鵰=điêu
纑=lư
燔=phần
鞅=ưởng
馘=quắc
铎=đạc
奭=thích
佚=dật/ẩn
烜=huyên
苙=lập
邶=bội
菑=truy
麋=nai
劬=cù
歆=hâm
鄏=nhục
璠=phan
祓=phất
阨=ách
闵=mẫn
戢=tập
櫜=cao
圻=kỳ
膑=tẫn
眊=mạo
锊=vén
繄=ê
娣=đệ
鄣=chướng
瞍=tẩu
盻=hễ
骖=tham/ngựa kéo
鄗=hạo
雠=thù
粢=tư
椟=độc
鼋=ngoan/ba ba
蚖=ngoan
蜴=dịch
燧=toại
祊=banh
繻=nhu
聃=đam
阆=lãng
鞶=bàn
愬=tố
珪=khuê
鬯=sưởng
弒=thí
膰=phiền
鈇=phu
郢=dĩnh
媿=quý
獘=tệ
郜=cốc
诎=truất
芈=mị
皁=tạo
郯=đàm
骅=hoa
騄=lục
騧=qua
骝=lưu
娠=thần
羝=đê
鄜=phu
竫=tĩnh
郿=mi
媦=vị
傒=hề
羖=cổ
穰=nhương
绖=điệt
饩=hí
猗=y
皤=bà
罃=oanh
薨=hoăng
籒=trứu
栾=loan
棫=vực
歃=sáp
荔=lệ
痤=tọa
黼=phủ
黻=phất
黔=kiềm
眛=muội
轵=chỉ
悝=khôi
鄢=yên
龁=hột
郓=vận
鞮=đê
郗=si
菟=thố
斿=du
齮=nghĩ
麃=tiêu
鹖=hạt
蕲=kỳ
媟=tiết
埽=tảo
佽=thứ
橑=liêu
酺=bô
鐻=cự
砀=nãng
柞=tạc
绨=đề
邾=chu
墠=thiện
迩=nhĩ
樛=cù
僊=tiên
掾=duyện
淛=chiết
眴=thuấn
盱=hu
眙=dị
窎=điếu
畀=tí
雝=ung
虮=kỷ
赍=tê
椹=châm
莝=tỏa
鲰=tưu
卮=chi
玦=quyết
瞋=sân
跽=kỵ
餧=ủy
崱=trắc
郴=sâm
莨=lang
窅=yểu
癃=lung
髑=độc
騑=phi
枞=tung
濊=uế
洨=hào
骓=chuy
绐=đãi
翥=chứ
埶=nghệ
媪=ảo
贳=thế
酤=cô
黡=yểm
嵕=tông
赆=tẫn
耨=nậu
餔=quả khô tẩm đường
筮=thệ
鼙=bề
嵇=kê
繣=hoạch
轘=hoàn
亍=xúc
峣=nghiêu
巿=phất
枳=chỉ
跂=kỳ
蒯=khoái
饟=hướng
篲=tuệ
瓴=linh
踘=cúc
豨=hi
甀=trụy
鲙=quái
缶=phữu
僿=tái
悃=khổn
姁=hủ
酖=đam
瘖=âm
珥=nhị
啑=xiệp
嬃=tu
惛=hôn
蝯=viên
襢=đản
掊=bồi
渫=tiết
葅=thư
櫱=nghiệt
芟=sam
跕=thiếp
蹀=điệp
酇=toản
醵=cự
阼=tộ
嗛=hàm
邬=ô/ổ
轺=diêu
谰=lan
轹=lịch
诖=quái
筰=tạc
缇=đề
屦=lũ
缾=bình
禧=hi
糤=tản
禫=đạm
瘗=ế
酎=trữu
殇=thương/chết non
遒=tù
诔=lụy
郅=chất
鼢=phẫn
搢=tấn
娌=lý
嬛=huyên
澹=đạm
邈=mạc
堀=quật
碁=kỳ
鼒=tỷ
塾=thục
笾=biên
缢=treo cổ
瑄=tuyên
箜=không
篌=hầu
茀=phất
瓯=âu
甓=bích
譔=soạn
捃=quấn
摭=trích
揜=yểm
隳=huy
镝=đích
绲=cổn
箓=lục
蔕=đế
禘=đế
诪=trù
襞=bích
箦=trách
鲛=giao
轼=thức
轭=ách
沬=muội
尟=tiển
虿=sái
蹻=kiểu
鄀=nhược
濆=phần
哜=tễ
侑=hựu
帱=trù
臑=nao
柷=chúc
噭=khiếu
肄=dị
祎=y
踧=địch
搥=chùy
欹=y
芼=mạo
簠=phủ
簋=quỹ
裼=tích
苾=bật
佾=dật
葆=bảo
稣=tô
侏=chu
筩=đồng
鎗=sinh
疢=sấn
殳=thù
螫=nọc độc
婺=vụ
轸=chẩn
痿=liệt/nuy
秭=tỷ
陬=tưu
紬=trừu
琁=tuyền
衿=khâm
舝=hạt
闿=khải
荚=giáp
貊=mạch
觜=miệng/tuy
觿=huề
溷=hỗn
枵=hiêu
孛=bột
埏=duyên
蓏=lỏa
跰=nghiễn
辏=thấu
谖=huyên
蔷=tường
谘=ti
籽=tử/hạt/hạt giống
櫍=chất
锸=tráp
欃=sàm
柎=phu
耎=nhuyễn
爨=thoán
椷=giam
蘤=hoa
躄=tích
伛=ủ
囷=khuân
遘=cấu
昳=điệt
旃=chiên
骀=đài
荦=lạc
堙=nhân
雊=cẩu
觋=hích
隩=áo
虙=mật
耒=lỗi
臛=hoắc
鲽=điệp
荅=đáp
鹣=kiêm
蚓=dẫn
驺=sô
犍=kiền
冱=hộ
醪=lao
滈=hao
弢=thao
骍=tuynh
芾=phất
儭=sấn
鸸=nhi
枌=phần
晬=tối
轝=dư
醊=chuyết
灊=tiềm
酾=si
跬=khuể
鞧=thu
壖=nhuyên
茭=giao
溲=sửu
筱=tiêu
旰=cán
搴=khiên
茇=bạt
绋=phất
厔=chất
湟=hoàng
粜=thiếu
傧=tấn
踶=đệ
赡=thiệm
毂=cốc
筦=quản
屩=cược
屝=phỉ
籴=địch
昕=hân
僦=tựu
庠=tường
阍=hôn
殪=ế
偪=bức
焘=đảo
瑗=viện
麇=quân
剸=chuyển
郧=vân
檇=tuy
澒=hống
磻=Bàn Khê
伋=cấp
棼=phần
桎=chất
梏=cùm
甗=nghiễn
驵=tảng
鲂=phường
鸮=hào
揃=tiễn
惸=quỳnh
肸=hật
糗=khứu/bựa vãi
狝=tiển
曩=nẵng
裯=chù
钸=tấm kim loại
鹆=dục
郈=hậu
坌=bộn
錔=thạp
秫=thuật
洙=thù
龂=ngân
誾=ngân
扆=ỷ
涘=sĩ
醳=dịch
衵=nật
苕=điều
綦=kỳ
碏=thước
衎=khản
焱=diễm
聩=hội
緌=nhuy
斁=dịch
洟=di
腯=đột
郛=phu
鹢=nghịch
魋=đồi
辐=phúc
钏=xuyến
袪=khư
縠=hộc
鯈=du
遯=độn
芃=bồng
郇=tuân
玈=lô
卣=dữu
胹=nhi
蹯=phiền
麑=nghê
嗾=thốc
獒=ngao
锜=kỹ
黮=thảm
尪=uông
蒌=lâu
褎=tụ
樗=xư
锉=mài/tỏa
浿=phối
黾=mãnh
疥=giới
鼫=thạch
菼=thảm
蠋=trục
歙=hấp
鄦=hứa
洧=vị
蓐=nhục
毓=dục
崞=quách
藳=cảo
笥=tứ
葭=gia
纮=hoành
斲=trác
榱=suy
梠=lữ
芘=tỷ
鲑=khuê
鷇=cấu
蕞=tối
蛏=sinh
荨=tầm
璜=hoàng
勖=úc
峤=kiệu
覸=gián
棐=phỉ
赇=cầu
荃=thuyên
昱=dục
剡=diệm
罅=há
骐=kỳ
靷=dẫn
圩=vu
睪=dịch
郰=châu
饘=chiên
餬=hồ
绁=tiết
缫=sào
魍=Võng
僬=tiêu
怍=tạc
硁=khanh
耰=ưu
耜=tỷ
皦=kiểu
彖=thoán
恂=tuân/Tuân
茕=quỳnh
掎=kỷ
罾=tăng
俛=phủ
铦=tiêm
禊=hễ
跸=tất
觖=quyết
坻=trì
疠=lệ
閺=văn
邡=phương
矰=tăng
踔=trác
宓=mật
幪=mông
胾=chí
彧=úc
罍=lôi
犴=ngạn
艴=phật
埤=bì
筜=đương
梲=chuyết
媢=mạo
禔=đề/Đề
誖=bội
谡=tắc
滫=tưu
蕨=quyết
箪=đan
鵩=phục
坫=điếm
缧=luy
戄=quặc
濑=lại
菹=trư
胠=khư
洸=quang
咈=phất
壸=khổn
挐=noa
撝=huy
埭=đại
葑=phong
榼=khạp
喭=ngạn
缊=ôn
圬=ô
墁=mạn
軶=ách
虍=hô
宀=miên
蒧=điểm
袷=giáp
鳣=chiên
讱=nhẫn
砻=xay lúa
欬=khái
塍=thăng
嶝=đặng
遄=thuyên
愒=khế
褰=khiên
弇=yểm
赙=phụ
鞴=bị
幰=hiển
涪=phù
讵=cự
杅=vu
摅=sư
蜎=quyên
蠉=huyên
枘=nhuế
龃=trở
龉=ngữ
輠=quả
裋=thụ
緅=tưu
簦=đăng
槔=cao
簏=lộc
趯=địch
脰=đậu
剉=tỏa
篪=trì
慁=hỗn
絁=thi
簟=điệm
谠=đảng
襜=xiêm
鍱=diệp
俶=thục
斮=trác
襚=tùy
悁=quyên
駃=khoái
騠=đề
軿=bình
髌=bận
骭=cán
閦=súc
眄=miện
皭=tước
臋=đồn
醨=ly
瑾=cẩn
蠖=oách
刓=ngoan
睇=liếc/thê
牾=ngộ
嫠=ly
晗=hàm
阘=tháp
遰=đệ
偭=mạn
羀=lữu
纆=mặc
輺=truy
脘=quản
肈=triệu
寠=cũ
疒=nạch
粝=lệ
剟=xuyết
揕=chấm
锷=ngạc
矐=hoắc
鼍=đà
瑱=thiến
蠲=quyên
谫=tiễn
铏=hình
囹=linh
泜=trì
孱=mềm yếu
轞=hạm
箯=tiên
唼=xiệp
罫=quải
钲=chinh
罂=anh
萆=tỳ
飧=sôn
箄=bài
褕=du
諠=huyên
蹢=trịch
偾=phẫn
桉=án
薤=giới
晞=hi
颙=ngung
歈=du
踣=té ngã
瞶=quý
胔=tí
阰=tỳ
俜=binh
翣=sáp
谳=nghiện
抔=bồi
阃=khổn
牏=du
糇=hầu
裰=chuyết
窬=du
敉=mị
芄=hoàn
瑒=sướng
跗=phụ
镵=sàm
趺=phu
瞚=thuấn
潸=san
繵=triền
腠=thấu
醯=dấm/ê
愦=hội
瘅=đản
脬=phao
瘕=hà
嗌=ách
蛴=tề
螬=tào
砭=biêm
釭=công
憍=kiêu
幨=xiêm
呫=chiếp
痱=phi
侘=sá
鐎=tiêu
铫=diêu
糒=bí
悛=thuân
抶=sất
寖=tẩm
纰=lỗi/lầm
糱=nghiệt
逴=trác
虡=cự
頞=át
菔=bặc
硐=đồng
蒟=củ
窭=cũ
酢=tạc
椓=trạc
锓=tẩm
裈=côn
罝=ta
擩=nhũ
崒=tốt
垩=ác
蔗=giá/mía
蒹=kiêm
菰=cô
蘗=bách
樝=tra
鹓=uyên
豻=ngan
墡=thiện
芎=khung
藭=cùng
蘘=nhương
藨=biễu
莸=du
蜥=thằn lằn/rắn mối
藂=tùng
柽=sinh
浰=lợi
鸧=thương
枻=duệ
礧=lôi
糁=tảm
鷩=tế
纚=sỉ
陼=chử
澥=hải
訇=oanh/hoanh
灏=hạo
鳍=vây cá
鹔=túc
冩=tả
沚=chỉ
蘩=phiền
磈=ủy
荪=tôn
芧=trữ
蠁=hưởng
菉=lục
偓=ác
佺=thuyên
斒=ban
臿=tráp
悫=khác
栌=lô
骫=ủy
蔘=sâm
虒=ti
蜼=vị
蜩=điêu
杪=diểu
镢=quắc
蠼=quặc
鼯=ngô
曺=tào
敻=quýnh
鹥=ê
轇=giao
沤=ngâm ủ
嫽=liêu
姱=khoa
祜=hỗ
瑑=triện
澍=chú
逯=lục
璅=tỏa
阤=đà
靸=táp
臞=cù
朅=khiết
仡=ngật
儗=nghĩ
躩=khước
雰=phân
綷=túy
苁=thung
礨=lỗi
陜=xiểm
葳=uy
泝=tố
恧=nục
麀=ưu
熿=hoàng
蕑=gian
诇=huýnh
燋=tiêu
彡=sam
廌=trĩ
忮=kỹ
鞫=cúc
茌=trì
菀=uyển
泑=ửu
鞬=kiện
忉=đao
阇=đồ
軥=cù
疣=vưu
芗=hương
寔=thực
趍=xu
訑=di
蚰=du
阝=phụ
侫=nịnh
臝=lỏa
翾=huyên
呰=tử
揳=tiết
萩=thu
鮆=tễ
踆=thuân
窾=khoản
痟=tiêu
嘒=uế
謏=tiểu
黹=chỉ
旡=ký
诒=di
偲=ti
睎=hi
槃=bàn
檗=cây hoàng bá
瞀=mậu
匚=phương
厍=xá
瘥=ta
醅=phôi
恝=kiết
樨=tê
筇=cung
溥=phổ
狷=quyến
珙=củng
綮=khể
珞=lạc
嗄=sá
蚯=khâu
扦=thiên
璪=tảo
箎=trì
岢=khả
椀=oản
琀=hàm
鞓=thinh
潄=sấu
艏=thủ
傕=giác
勳=huân
鑑=giám
釬=hạn
衄=nục
妗=cấm
扂=điếm
炰=bào
菴=am
珩=hành
慾=dục/muốn/ham
賸=thứng
耋=điệt
笱=cú
砑=nhạ
羶=thiên
覜=thiếu
醱=bát
昜=dương
珂=kha
蜊=lỵ
勍=kình
杻=nữu
釐=ly
輮=nhụ
桄=quáng
萸=du
藷=thự
猁=lỵ
桲=dụng cụ đập lúa
祧=thiêu
衒=huyễn
籥=thược
敁=điêm
噶=cát
婬=dâm
勗=úc
夤=di
鎚=chùy
巘=nghiễn
窔=yểu
淩=lăng
趼=nghiễn
茼=đồng
蚝=hào
崋=hoa
濬=tuấn
囮=ngoa
蚳=chỉ
郤=khích
眢=oan
苺=môi
埰=thải
瘐=dũ
斨=thương
衭=phu
泔=cam
堍=miễn
枑=hộ
蜇=đốt/triết
沭=thuật
瑭=đường
酕=mao
冔=hu
砉=hoạch
暱=nật
阯=chỉ
帢=kháp
慼=thích
痺=tí
恉=chỉ
昫=hu
芨=cập
踡=quyền
啣=hàm
涽=hôn
勦=tiễu
忳=đồn
寀=thái
枅=phanh
癣=tiển
蘅=hành
揎=tuyên
珐=pháp
锌=kẽm
鲇=niêm
絍=nhâm
梃=đĩnh
镣=xích chân
凇=tùng
湄=mi
沪=hỗ
淦=cam
苒=nhiễm
韪=vĩ
莼=thuần
诹=trâu/tưu
癗=lũy
樾=việt
饔=ung
滦=loan
鹾=ta
汞=thủy ngân
羼=sạn
幺=yêu
乩=kê
锞=quả
聒=quát
墀=trì
粳=canh
酽=nghiệm
饧=đường
苓=linh
芪=kỳ
菖=xương
蓁=trăn
黉=huỳnh
茆=lữu
酴=đồ
葩=ba/hoa
抠=móc/gảy/keo kiệt
铰=giảo
霰=tản
筅=tiển
绡=tiêu
榧=phỉ
疔=đinh
鲟=tầm
暹=xiêm
唪=phủng
嘁=hứ
腌=ướp/yêm
跹=tiên
菡=hạm
茯=phục
骘=chất
薷=nhu
溽=nhục
靛=chàm/điện
瘰=lỗi
螯=ngao
舡=hang
篾=miệt
馗=quỳ
鲞=tưởng
鸹=quát
豇=giang
跏=già
仵=ngỗ
箬=nhược
鹌=am
橄=cảm
垤=điệt
鳇=hoàng
猞=xá
绔=khố
祛=khử/trừ bỏ
黧=lê
鲦=điều
埘=thì
瓤=nhương
恹=yêm
觌=địch
圊=thanh
嫒=ái
萱=huyên
燹=tiển
醑=tữ
觇=siêm
窀=truân
穸=tịch
颟=man
顸=han
轳=lô
狺=ngân
钚=Plutonium/bất
鹧=chá
鸪=cô
韫=uẩn
蕖=cừ
趱=toản
茑=điểu
囟=tín
骢=thông
溘=khạp
夬=quái
嘏=hỗ
呗=thôi/quá
裆=háng/đang/đũng quần
痂=vảy
腚=mông/đít
铝=nhôm
饪=nhẫm
疴=a
萏=đạm
渌=lục
扌=thủ
筚=tất
篥=lật
氵=thủy
鄹=châu
蟪=huệ
蛄=cô
辋=võng
莓=dâu
崦=yêm
啭=chuyển
帻=trách
鹂=Ly/hoàng anh
藁=cảo
蝥=mâu
茱=thù
啁=trù
鹚=từ
碱=tẩy rửa
茺=sung
焖=hầm/muộn
屙=a
竦=tủng
髁=khỏa
畚=bổn
髫=thiều
菠=cải bó xôi
馕=hướng
鼗=đào
娩=vãn
醭=váng
莩=phu
镘=man
捌=bát
靣=diện
両=lạng
丣=dậu
丯=phong
丱=quán
丶=,
丿=phiệt
乀=phật
乆=cửu
桕=cữu
蔹=liêm
鲗=tặc
亅=quyết
亜=á
亠=đầu
亯=hanh
亸=đả
亻=nhân
仉=chưởng
仌=băng
値=trị
傚=hiệu
眞=chân
伃=dư
伕=phu
伱=ngươi
伻=bình
佉=khư
佋=thiệu
佔=chiếm
佴=nhị
併=gồm/đều
侌=âm
衞=vệ
侚=tuẫn
侷=cục
俅=cầu
祐=hữu/Hữu
証=chứng
俫=lai
俵=biểu
倂=tính
倅=thối
倈=lai
倢=tiệp
倣=phỏng
倮=khỏa
偁=xưng
偋=bình
偢=thu
偸=thâu
偹=bị
傎=điên
傔=khiểm
註=chú
傞=ta
傣=thái
傺=sế
僃=bị
僌=tái
働=động
僎=soạn
僝=sạn
僽=sậu
僞=ngụy
僣=thiết
僱=mướn
僶=mẫn
僾=ái
儁=tuấn
儌=kiêu
儍=sọa
儎=tái
儛=vũ
儤=bạo
儩=tứ
儱=lung
儳=sàm
儸=la
兇=hung
兎=thố
兪=du
産=sản
冁=xiên
冂=quynh
冄=nhiễm
冓=cấu
冖=mịch
冦=khấu
冫=băng
凂=mỗi
凈=tịnh
凊=sảnh
凓=lật
凔=sương
凘=tư
凙=đạc
凟=độc
凴=bằng
凵=khảm
凷=khối
凾=hàm
刂=đao
刄=lạng
刅=sang
刦=kiếp
刧=kiếp
刬=sản
刱=sáng
刲=khuê
刴=đóa
刵=nhĩ
刼=kiếp
刾=thích
剗=sản
剚=chí
剰=thừa
剷=sản
剺=ly
劄=tráp
劎=kiếm
劘=mi
崙=lôn
効=hiệu
勷=nhương
劼=cật
豀=hề
勅=sắc
勑=lai
勚=duệ
勠=lục
勩=duệ
勲=huân
勹=bao
匃=cái
紮=ôm/kẹp/cột
匜=di
匟=kháng
匳=liêm
匵=độc
匸=hệ
卄=nhập
卌=tấp
卍=vạn
卐=vạn
卩=tiết
卭=ngang
卲=thiệu
卹=tuất
卼=ngột
臲=niết
卽=tức
厓=nhai
厖=mang
厠=xí
厤=lịch
厪=cận
厫=ngao
厯=lịch
厰=xưởng
厶=khư
厺=khứ
叅=xam
叆=ái/mờ mịt
叇=đãi
筓=kê
叚=giả
蹟=tích
叻=lặc
吪=ngoa
吽=hồng
吿=cáo
呉=ngô
呌=khiếu
呝=ách
呪=chú
咍=hai
咥=hí
咲=tiếu
咷=đào
哔=tất
哢=lộng/kêu
唁=nghiễn
唈=ấp
唕=tạo
唘=khải
唵=úm
唸=niệm
啓=khải
啗=đạm
啚=bỉ
喈=dê
痧=sa
喎=oa
喒=tàm
喓=yêu
喞=tức
喤=hoàng
閙=náo
喨=lượng
喫=khiết
嗁=đề
嗃=hạc
嗏=chà
嗢=ốt
嗸=ngao
嘅=khái
嘐=hao
嘑=hô
嘓=quắc
嘷=hào
噀=tốn
噂=tổn
噉=đạm
噍=tiếu
噏=hấp
噐=khí
嚆=hao
嚐=thường
嚥=nuốt
嚬=tần
嚱=hi
嚲=đả
囓=khiết
囘=hồi
囝=kiển
囬=hồi
圅=hàm
圌=thùy
圏=vòng
籙=lục
圝=loan
圞=loan
埝=niệm
坵=khâu
坺=bạt
坿=phụ
幂=mịch
垅=lũng
垲=khải
垻=bá
埄=bổng
埙=huân
埚=qua
埜=dã
埧=cụ
埳=khảm
埵=đất cứng
堃=khôn
堦=giai
堶=đà
塚=trủng
塟=táng
塡=điền
塲=tràng
塼=chuyên
塿=lũ
墍=ký
墐=cận
増=tăng
墦=phiền
墻=tường
墼=kích
蟢=hỉ
壈=lẫm
壎=huân
壔=đảo
壜=đàm
壠=lũng
壻=tế
夀=thọ
夂=tri
夆=phùng
夊=tuy
甦=tô
夣=mộng
砲=pháo
夲=bổn
鬬=đấu
妁=chước
妊=nhẫm
妬=đố
妳=ngươi/nàng
媮=thâu
託=thác
讬=thác
姙=nhâm
姞=cật
姤=cấu
姦=gian
姮=hằng
姸=nghiên
娬=vũ
婣=nhân
嫋=niệu
嫏=lang
嫚=mạn
嫜=chương
嫺=nhàn
嬀=quy
嬍=mỹ
嬝=niệu
嬭=nãi
嬲=điểu
嬾=lãn
嬿=yến
孃=nương
孒=quyết
孶=tư
孻=nai
孼=nghiệt
宂=nhũng
瓿=bẫu/vò/bình
宼=khấu
寃=oan
螿=tương
寯=tuấn
寳=bảo
尀=phả
尅=khắc
尒=nhĩ
尙=thượng
尫=uông
尲=giam
彊=cường
屌=điểu
屛=bình
屧=tiệp
屭=hí
屮=triệt
屺=dĩ
屼=ngộ
岧=thiều
嶢=nghiêu
岵=hỗ
岿=vị
峝=đỗng
峩=nga
峯=phong
崑=côn
崚=lăng
嶒=tằng
嵫=tư
嵆=kê
嵏=tông
嵒=nham
嶍=tập
嶮=hiểm
嶰=giải
巇=hi
巉=sàm
巓=điên
巖=nham
巛=xuyên
巵=chi
帀=táp
帓=mạt
帙=trật
帨=thuế
帲=bình
帵=oan
釦=khẩu
幙=mạc
幧=thiêu
幮=trù
幷=tịnh
庀=phỉ
廕=ấm
庥=hưu
庬=mang
廀=sưu
廏=cứu
廐=cứu
廑=cần
廒=ngao
廱=ung
廴=dẫn
廻=hồi
廼=nãi
廾=củng
弆=khí
弌=nhất
弍=nhị
弎=tam
弔=điếu
弤=để
弮=khuyên
硷=dảm
弸=bằng
弻=bật
彄=khu
彍=khoắc
彐=ký
彑=kệ
彞=di
彠=hoạch
彫=điêu
彯=phiêu
彳=xích
徧=biến
徯=hề
徳=đức
徴=trưng
忄=tâm
忩=thông
忭=biện
忴=linh
忼=khảng
怱=thông
怳=hoảng
恇=khuông
恊=hiệp
恔=hiệu
恟=hung
恠=quái
恡=lận
悒=ấp
悞=ngộ
悤=thông
悪=ác
悰=tông
悾=không
惄=nịch
惎=kỵ
惓=quyền
惔=đàm
惢=nhị
惥=dũng
惪=đức
愊=phức
愔=âm
愳=cụ
愼=thận
愽=bác
慄=lật
慇=ân
懃=cần
慙=tàm
慸=sại
憃=xuẩn
憇=khế
憖=ngận
憗=ngận
憙=hí
憸=tiêm
懥=chí
懽=hoàn
戅=tráng
戋=tiên
戞=kiết
戤=ngái
戬=tiển
戱=hí
戹=ách
戽=hố
扠=tra
扱=tráp
抃=biến
抆=vấn
抝=ảo
拑=kiềm
拕=tha
拶=tạt
挅=đỏa
挦=triêm
挱=sa
挵=phan
捓=da
捼=noa
捽=tốt
掞=thiểm
掫=tưu
掯=khẳng
掽=bánh
揅=nghiên
鞄=bạc
揑=niết
揔=tổng
揗=tuần
揘=hoành
揞=yêm
揠=yết
揢=khách
揫=thu
揷=sáp
揸=tra
揿=khấm
搆=cấu
搉=xác
搊=xâu
搒=bãng
搕=khạp
搘=chi
搧=thiên
搨=tháp
搰=hột
搲=oa
搵=uấn
搾=trá
摏=thung
摛=si
摠=tổng
摴=sư
撃=kích
撏=triêm
撙=tỗn
撡=thao
撦=xả
擕=huề
擡=nâng/đài
陞=thăng
擣=đảo
擥=lãm
擧=cử
擪=áp
擫=áp
擭=hoạch
攅=toàn
攈=quấn
攟=quấn
攩=đảng
攲=khi
攴=phộc
攷=khảo
敪=xuyết
敔=ngữ
斆=hiệu
駮=bác
觫=tốc
斝=giả
斠=dác
斵=trác
斾=bái
旂=kỳ
旉=phu
旓=sao
旛=phan
旜=chiên
旝=quái
旟=dư
旣=ký
旤=họa
旹=thì
旾=xuân
昀=quân/vân
昚=thận
昬=hôn
昶=sưởng
昺=bính
昽=lông
晜=côn
晡=giờ Thân
晳=tích
晻=yểm
暋=mẫn
暍=cảm nắng
暎=ánh
暐=vĩ
暭=hạo
暵=hán
曀=ê
曁=kỵ
曈=đồng
曌=chiếu
曏=hướng
曚=mông
曨=lông
曵=duệ
朏=phỉ
朒=nục
朓=thiểu
朞=ki
朶=đóa
杇=ô
陧=niết
杕=đệ
杗=mang
杙=dặc
榈=lư
枏=nam
枲=tỷ
枴=quải
橼=duyên
柁=đả
柈=bàn
柒=thất
柝=thác
柟=nam
柨=thị
柮=đốt
柹=thị
栞=san
栟=kiên
栢=bách
栨=thứ
栱=củng
栲=khảo
栳=lão
栴=chiên
桹=lang
桬=sa
桿=que
梐=bệ
梱=khổn
棃=lê
棊=kỳ
棨=khể
棬=khuyên
椇=củ
椉=thừa
椐=cư
椗=đính
椳=ôi
椶=tông
椸=di
椾=tiên
楘=mộc
楙=mậu
榅=ốt
榑=phù
榘=củ
榤=kiệt
榦=cán
榲=ốt
榾=cốt
槀=cảo
槅=cách
槊=sóc/giáo
槑=mai
槓=cống
槥=tuệ
槩=khái
槭=túc
槱=dửu
槲=sồi
槹=cao
槼=quy
樲=nhị
樷=tùng
橅=mô
橊=lưu
橕=xanh
橦=đồng
橧=tăng
檎=cầm
檝=tiếp
檟=giả
檮=đào
檿=yểm
櫂=trạo
櫉=trù
櫫=trư
櫺=linh
欂=đấu cùng
欛=bá
欝=uất
欵=khoản
欸=ai
欻=hốt
欿=khảm
歔=hư
歕=phun
歗=khiếu
歛=liễm
歠=xuyết
歬=tiền
歰=sáp
歱=chủng
歴=lịch
歾=một
殀=yểu
殍=biễu
殢=thế
殣=cận
殭=cương
殱=tiêm
殻=xác
毈=đoạn
毖=bí
毘=bì
毧=nhung
毬=cầu
毷=máo
氉=táo
毹=du
氂=ly
氍=cù
氟=phất
氢=hydro
蠜=phàn
氷=băng
氾=giàn giụa
汊=xá
汍=hoàn
汎=phiếm
汚=ô
蓠=ly
沴=lệ
泐=lặc
泒=cô
泖=mão
泚=thử
泺=lạc
洑=phục
洚=giáng
洴=bình
洿=ô
浼=mỗi
涊=niễn
涖=lỵ
淟=điến
淽=nhị
渖=thẩm
渮=ca
渼=mỹ
湅=luyện
湌=xan
湑=tư
湜=thực
湣=mẫn
湽=truy
溴=xú
滃=ổng
滙=hối
滛=dâm
漈=tế
漊=lâu
漑=cái
漘=thần
漙=đoàn
漥=oa
潟=tích
澁=sáp
澂=trừng
澑=lựu
澣=cán
澦=dự
澼=phích
瀡=tủy
瀦=trư
瀹=thược
瀼=nhương
灉=ung
灧=liễm
灨=cám
炁=khí
炜=vĩ
炤=chiếu
炧=đả
炱=đài
蘝=liêm
鰂=tặc
烖=tai
烩=xào/quái/chưng
焜=hỗn
焮=hân
煆=hạ
煇=huy
煏=phức
煑=chử
煕=hi
煖=noãn
煠=sáp
煲=nấu/nồi
煼=sao
熇=hốc
熯=hãn
熲=quýnh
燐=lân
燖=tầm
燬=hủy
燻=huân
燿=diệu
爇=nhiệt
爓=diễm
爗=diệp
爚=dược
爝=tước
爫=trảo
爮=bào
爲=vì/vi
爿=tường
牀=sàng
牁=ca
牋=tiên
牐=sáp
牓=bảng
牕=song
牚=xanh
蒡=bảng
牠=nó
蛎=lệ
牸=tự
牼=khanh
犂=lê
犇=bôn
犎=phong
犭=khuyển
狉=phi
狌=tính
狒=phí
狓=phi
狖=dứu
狥=tuẫn
狨=nhung
狴=bệ
猂=hãn
猘=chế
猧=oa
猺=dao
獀=sưu
獉=trăn
獍=kính
獞=đồng
獧=quyến
玅=diệu
璫=đang
玖=cửu
玞=phu
珏=giác
玱=thương
珉=mân
珧=diêu
珮=bội
珲=hồn
珷=vũ
琇=tú
琖=trản
琚=cư
琤=tranh
琲=bội
琹=cầm
瑇=đại
瑽=xung
璈=ngao
璢=lưu
璵=dư
璿=tuyền
瓀=nhuyên
瓈=lê
瓖=tương
瓞=điệt
瓻=hi
甁=bình
甃=trứu
甆=từ
甇=anh
甍=manh
甎=chuyên
甒=vũ
甖=anh
甡=sân
甪=lục
甯=nịnh
畂=điền
畛=chẩn
畞=mẫu
畹=uyển
畽=thoản
疄=lân
疎=sơ
疐=chí
疓=đinh
疖=tiết
疘=giang
疬=lịch
疭=túng
疰=chú
疱=pháo
疳=cam
疿=phi
痀=câu
瘘=lũ
瘻=lũ
痁=thiêm
痃=hiền
痄=chá
痌=thông
痎=giai
痏=vị
痗=mội
痠=toan
痡=phô
痲=ma
痳=lâm
痼=cố
痾=a
瘃=chúc
瘈=khế
瘉=dũ
瘊=hầu
瘏=đồ
瘛=xiết
瘲=túng
瘝=quan
瘭=tiếu
瘯=thốc
癧=lịch
瘵=ốm
瘼=mạc
瘿=anh
癅=lựu
癎=giản
癒=dũ/khỏi ốm/lành bệnh
癙=thử
癜=điến
癶=bát
皐=cao
皜=hạo
皞=hạo
皡=hạo
皻=cha
皼=cổ
盃=cúp
盇=hạp
盌=oản
盦=am
眎=thị
眡=thị
眱=di
眵=si
眽=mạch
睂=mi
睅=hạn
睊=quyến
睍=hiển
睒=thiểm
睖=lăng
睟=túy
睺=hầu
瞆=quý
瞖=ế
瞷=gián
瞾=chiếu
矉=tần
矑=lô
矙=khám
矞=duật
矟=sáo
矦=hầu
矬=tọa
矱=hoạch
矻=khốt
矼=cang
矽=tịch
砆=phu
砗=xa
磲=cừ
砝=kiếp
砷=thân
硇=nao
硎=hình
硏=nghiên
硙=ngại
硜=khanh
硼=bằng
碔=vũ
碘=i-ốt
碞=nham
碡=độc
碪=châm
碯=não
磉=tảng
磑=ngại
磗=chuyên
磠=lỗ
礆=dảm
礌=lôi
礜=dự
礞=mông
礟=pháo
礮=pháo
礽=nhưng/Nhưng
礿=dược
祔=phụ
祕=bí
祘=toán
祼=quán
禕=y
禖=môi
禡=mã
禩=tự/Tự
禴=dược
禸=nhựu
秊=niên
秔=canh
秕=bỉ
秖=kỳ
稃=phù
稊=đề
稌=đồ
稜=oai hùng
稭=giai
稺=trĩ
稾=cảo
穄=tế
穅=khang
穇=sam
穈=môn
穉=trĩ
穠=nùng
穤=nhu
穨=đồi
穵=ấp
穽=tỉnh
窆=biếm
窊=oa
窓=song
窞=đạm
窨=ấm
窰=diêu
窵=điếu
窻=song
竈=táo
竚=trữ
竝=tịnh
竢=sĩ
竪=thụ
竸=cạnh
竾=trì
笇=toán
笊=tráo
笕=kiển
笪=đát
笵=phạm
筞=sách
筢=ba
筤=lang
筥=cử
筯=trợ
筳=đình
筸=cao
筼=vân
箆=bề
箑=tiệp
箒=Houki/trửu
箚=tráp
箠=chủy
箨=thác
箲=tiển
篔=vân
簹=đương
篛=nhược
篠=tiểu
篨=trừ
篴=địch
篼=đâu
簉=sứu
簑=thoa
簒=soán
簖=đoán
簨=tuẩn
簮=trâm
簴=cự
籀=trứu
籐=đằng
籑=soạn
籕=trứu
籖=thiêm
籧=cừ
籯=doanh
籰=dược
籼=tiên
粃=chủy
粇=canh
粞=tê
粧=trang
粰=phu
粺=bại
糉=tống
糐=đoàn
糵=nghiệt
糸=mịch
糺=củ
紃=xuyên
紘=hoành
紝=nhâm
紥=trát
紵=trữ
紾=chẩn
絅=quýnh
絏=tiết
絖=khoáng
絚=căng
絝=khố
絪=nhân
絫=lũy
絰=điệt
綅=tiên
綉=tú
綌=khích
綍=phất
綫=tuyến
綯=đào
綳=banh
綵=thải
縩=sái
緉=lưỡng
緎=vực
総=tổng
緐=phồn
緜=miên
緤=tiết
緥=bảo
緪=căng
縕=ôn
縚=thao
縧=thao
縰=sỉ
縿=sam
繐=huệ
繖=tản
繙=phiên
繮=cương
纇=lỗi
纎=tiêm
纒=triền
纕=tương
纩=khoáng
纴=nhâm
绠=cảnh
绤=khích
绹=đào
缏=biền
缳=hoán
罇=tôn
罈=đàn
罋=úng
罎=đàm
罒=võng
罳=ty
罛=cô
罣=quái
罥=quyến
罦=phù
罨=yểm
罭=vực
罱=lãm
罿=đồng
羃=mạc
羇=ki
羐=dũ
羓=ba
羜=trữ
羢=nhung
羣=quần
羵=phần
翃=hoành
翛=tiêu
翫=ngoạn
翬=huy
翶=cao
翺=cao
翽=hối
翿=đạo
耇=cẩu
耈=cẩu
耊=điệt
耑=chuyên
耔=tỷ
耞=gia
耡=sừ
耼=đam
聡=thông
聫=liên
聴=thính
聿=duật/họ
肊=ức
肎=khẳng
肐=cách
肧=phôi
肬=vưu
胏=chỉ
荽=tuy
胰=di
脃=thúy
脗=vẫn
脝=hanh
脡=đĩnh
脤=thận
脧=tuyên
脩=tu
腁=biền
腷=phức
腽=ột
膆=tố
膋=liêu
膓=tràng
膞=thuần
膴=hô
膵=tụy
臄=cược
臈=lạp
臕=phiêu
臙=yên
臜=châm
臡=nê
臢=châm
臯=cao
舁=dư
舃=tích
舘=quán
舚=thiêm
舠=đao
舣=nghĩ
舩=thuyền
舲=linh
艁=tạo
艄=sao
艗=dật
艣=lỗ
艶=diễm
芑=khỉ
芡=khiếm
芣=phù
苢=dĩ
苈=lịch
苐=đệ
苖=địch
苶=niết
苽=cô
茘=lệ
茝=chỉ
茴=hồi
荄=cai
荈=suyễn
荙=đạt
荛=nhiêu
莙=quân
莛=đình
菪=đãng
莶=hiêm
莾=mãng
菓=quả
菘=tùng
薐=lăng
菤=quyển
葹=thi
菫=cận
菾=điềm
薢=giải
萐=tiệp
萑=hoàn
萲=huyên
萹=phiên
葖=đột
葘=truy
葚=thậm
藟=lũy
葯=ước
葶=đình
葸=tỷ
蒇=siển
蒐=sưu
蒓=thuần
蒨=thiến
蒱=bồ
蒴=sóc
蔾=lê
蒻=nhược
蓂=minh
蓆=tịch
蓇=cốt
蓣=dự
蓧=điệu
蓱=bình
蓴=thuần
蓷=thôi
蔂=luy
蔆=lăng
蔌=tốc
蔴=ma
蕈=khuẩn
蕋=nhị
薹=đài
蕡=phần
蕰=ôn
蕻=hống
薀=ôn
薅=kéo/hao
薓=sâm
薘=đạt
薙=thế
薝=đảm
薧=hảo
薴=trữ
薶=mai
薸=phiêu
薻=tảo
藊=biển
藼=huyên
藾=lại
蘀=thác
蘂=nhị
蘐=huyên
蘖=nghiệt
虀=tê
虆=luy
虓=hao
虯=cầu
蟥=đỉa
蚑=kỳ
蚘=hồi
蚜=nha
蚦=nhiêm
蚧=giới
蚺=trăn
蚿=huyền
蛉=linh
蛑=mâu
蛕=hồi
蛘=dạng
蛞=khoát
蜣=khương
蛱=kiệp
蛳=si
蛸=sao
蛹=kén
蛼=xa
蝣=du
蜋=lang
蜍=thừ
蜑=đản
蠊=liêm
蜞=kỳ
蜨=điệp
蜰=phì
蜹=nhuế
蜾=quả
蝀=đông
蝃=đế
蝆=dạng
蝘=yển
蝡=nhuyễn
蝤=tù
蝨=sắt
蝱=manh
蝻=nam
蝾=vinh
螈=nguyên
螉=ông
螋=sưu
螗=đường
螘=nghĩ
螙=đố
螡=văn
螣=đằng
螮=đế
螵=phiêu
螽=chung
蟁=văn
蟊=mâu
蟏=tiêu
蟕=chủy
蠵=huề
蟛=bành
蟫=đàm
蟮=thiện
蟺=thiện
蠍=hiết
蠘=tiệt
蠧=đố
蠨=tiêu
蠭=phong
蠺=tàm
衁=hoang
衂=nục
衆=chúng
衇=mạch
衋=hực
衕=đồng
衖=hạng
衚=hồ
衩=xái
衺=tà
袆=huy
袌=bão
袗=chẩn
袟=dật
袠=trật
袯=tơi nón
襫=thích
袴=khố
袵=nhẫm
袺=kết
袽=như
袿=khuê
裀=nhân
裛=ấp
裠=quần
褌=côn
褏=tụ
褘=huy
褙=bối
褞=ôn
褦=nại
褧=quýnh
褱=hoài
褵=ly
襃=bao
襆=bộc
襇=cán
襌=đan
襍=tập
襏=bát
襛=nùng
襭=hiệt
襮=biểu lộ
襴=lan
襶=đái
襻=phán
襼=nghệ
襾=á
覈=hạch
覉=ki
覊=ki
覔=mịch
覥=điễn
覧=lãm
覩=đổ
覰=thứ
覶=la
覻=thứ
覼=la
觍=điễn
觝=để
觱=tất
觵=quang
訏=hu
訒=nhẫn
訩=hung
詖=bí
詗=huýnh
詧=sát
詾=hung
説=nói/thuyết
諝=tư
諟=thị
諡=thụy
諩=phổ
謆=phiến
謇=kiển
謋=hoạch
謌=ca
謡=dao
謦=khánh
謯=trớ
謷=ngao
謻=di
謼=hô
譁=hoa
譅=sáp
譆=hi
譈=đỗi
譊=nao
譍=ưng
譛=trấm
譟=táo
譱=thiện
譸=trù
譾=tiễn
讁=trích
讅=thẩm
讋=triệp
讌=yên
讟=độc
讻=hung
诜=sân
谂=thẩm
谞=tư
谿=khê
豋=đăng
豒=trật
豗=hôi
豝=ba
貃=mạch
貆=hoan
貍=ly
貛=hoan
貟=viên
貤=dị
貭=chất
賍=tang
賙=chu
賛=tán
賝=sâm
賨=tung
賮=tẫn
賵=phúng
贉=đảm
贋=nhạn
贑=cống
贒=hiền
贔=bí
贜=tang
贠=viên
贶=huống
赅=cai
赑=bí
赒=chu
赓=canh
赗=phúng
赩=hách
赪=xanh
赬=xanh
赯=đường
趂=sấn
趦=tư
趵=bác
趿=mang
跁=bả
跅=thác
跞=lịch
跦=trù
跧=thuyên
跫=cung
跲=cấp
跴=thải
跼=cục
踁=hĩnh
蹡=thương
踖=tích
踥=thiếp
踦=khi
踯=trịch
踳=suyễn
蹁=biên
蹍=giẫm
蹎=điên
蹏=đề
蹐=tích
蹜=súc
蹝=sỉ
蹞=khuế
蹵=xúc
躃=tích
躔=triền
躗=vệ
躞=tiệp
躧=sỉ
躭=đam
躰=thể
躱=đóa
躳=cung
軏=nguyệt
軨=linh
輀=nhi
輈=chu
輓=vãn
輗=nghê
輘=lăng
輙=triếp
輧=bình
輭=nhuyễn
輶=du
輹=phúc
轕=cát
轊=duệ
轖=sắc
轗=khảm
辀=chu
辁=thuyên
辠=tội
辡=biện
辢=lạt
辤=từ
辥=tiết
辵=sước
辶=sước
迆=dĩ
迍=truân
迒=hàng
迺=nãi
迻=di
逈=huýnh
逬=bính
逭=hoán
遅=trì
遉=trình
遌=ngạc
遝=đạp
遡=tố
遴=lân
遹=duật
邅=chiên
邉=biên
邨=thôn
邲=bật
郃=hợp
郉=hình
郞=lang
鄊=hương
鄕=hương
鄘=dung
鄞=ngân
酦=bát
酧=thù
酮=đồng
酯=chỉ
醾=mi
釄=mi
酵=diếu
醁=lục
醄=đào
醕=thuần
醝=ta
醰=đàm
醲=nùng
醻=trù
醼=yến
醽=linh
釂=tiếu
鈈=bất
鈎=câu
鉄=thiết
鉅=cự
鉋=bào
鋙=ngữ
鉢=bát
鉥=thuật
鉶=hình
銛=tiêm
銲=hãn
鋀=đậu
鋈=ốc
鋩=mang
鋭=duệ
錞=thuần
錡=kỹ
鍊=luyện
鍚=dương
鍫=thiêu
鍳=giám
鍼=châm
鍿=truy
鎋=hạt
鎛=bác
鎞=bề
鎡=tư
鎭=trấn
鎲=đảng
鏁=tỏa
鏐=lưu
鐂=lưu
鐍=quyết
鐏=tỗn
鐧=giản
鑕=chất
鑛=khoáng
鑞=lạp
鑢=lự
鑤=bào
鑪=lô
鑱=sàm
鑴=huề
鑵=quán
钁=quắc
钾=kali/giáp (Ka)
铂=bạch kim
铇=bào
铓=mang
铳=súng
铴=thảng
铻=ngữ
锑=đễ
锧=chất
锴=khải
镁=Magiê
镃=tư
镈=chiêng
镋=đảng/đinh ba
镍=niken
镕=dung
镗=thang
镟=tuyền
镦=đối
镮=hoàn
镴=lạp
閈=hãn
閟=bí
閧=hống
闉=nhân
闍=đồ
闑=niết
闒=tháp
闓=khải
闘=đấu
闚=khuy
闠=hội
闤=hoàn
闬=hãn
阓=hội
阛=hoàn
阬=khanh
阸=ách
阽=diêm
陔=cai
陻=nhân
陿=hiệp
隁=yển
隂=ẩm
隄=đê
隖=ổ
隠=ẩn
隲=chất
隷=lệ
雘=hoạch
雟=huề
雱=bàng
霂=mộc
霅=tráp
霈=bái
霑=thấm/nhiễm
霙=anh
霛=linh
霡=mạch
霢=mạch
霤=lựu
霱=duật
霶=bàng
靁=lôi
靆=đãi
靉=ái
靝=thiên
靧=hối
靮=đích
靿=áo
鞀=đào
鞔=man
鞯=tiên
鞲=câu
鞳=tháp
鞵=hài
鞸=tất
鞹=khuếch
鞺=thang
鞾=ngoa
韈=vạt
韍=phất
韔=sướng
韘=thiếp
韛=bị
韝=câu
韠=tất
韡=vĩ
韤=vạt
韨=phất
韮=phỉ
頖=phán
頫=phủ
頮=hối
頴=dĩnh
顇=tụy
顋=tai
顒=ngung
顚=điên
顣=túc
顦=tiều
顬=nhu
颃=hàng
颎=quýnh
颒=hối
颕=dĩnh
颞=nhiếp
颥=nhu
颭=triển
颸=ti
颻=diêu
飅=lưu
飂=liêu
飃=phiêu
飏=dương
飐=triển
飔=ti
飖=diêu
飜=phiên
飠=thực
飣=đính
飥=thác
飮=ẩm
飱=san
餂=thiểm
餈=tư
餕=tuấn
餖=đậu
餗=tốc
餙=sức
餚=hào
餠=bánh
餱=hầu
餲=ế
餵=cho ăn
餺=bác
餻=cao
餽=quỹ
饁=diệp
饇=ốc
饊=tản
饎=sí
饐=ý
饝=ma
饢=nang
饤=đính
饦=thác
饾=đậu
馂=tuấn
馌=diệp
馎=bánh bột
馡=phỉ
馹=nhật
駈=khu
駉=quynh
駡=mạ
駬=nhĩ
駰=nhân
駸=xâm
騂=tuynh
騃=ngãi
騈=biền
騌=tông
驎=lân
騐=nghiệm
騣=tông
驌=túc
驦=sương
驑=lưu
驖=thiết
驘=loa
驝=thác
驲=nhật
骎=xâm
骔=tông
骦=sương
骳=bí
骽=thối
骾=ngạnh
髙=cao
髟=tiêu
髠=khôn
髢=thế
髣=phảng
髴=phất
髤=hưu
髥=nhiêm
髧=đãm
髩=tấn
髼=bồng
髽=qua
鬁=lỵ
鬎=thích
鬄=thế
鬙=man
鬉=tông
鬋=tiên
鬌=đỏa
鬐=kỳ
鬒=chẩn
鬘=man
鬝=gian
鬪=đấu
鬫=hám
鬴=phũ
鬵=tẩm
魊=vực
魕=kỳ
魨=đồn
鮀=đà
鮎=niêm
鮓=trả
鮝=tưởng
鮠=ngôi
鮿=triếp
鯗=tưởng
鯚=quý
鯠=lai
鯶=hỗn
鯿=biên
鰋=yển
鰐=ngạc
鰕=hà
鰜=kiêm
鰵=mẫn
鱅=dong
鱓=thiện
鱠=quái
鱣=chiên
鱨=thường
鱮=tự
鱵=châm
鱻=tiên
鲀=đồn
鲊=trả
鲚=tễ
鲡=ly
鲥=thì
鲭=chinh
鲮=lăng
鲳=xương
鲶=niêm
鲿=thường
鳆=phục
鳊=biên
鳐=diêu
鳒=kiêm
鳓=lặc
鳔=phiêu
鳕=tuyết
鳘=mẫn
鳙=dung
鳜=quyết
鳟=tỗn
鳬=phù
鳲=thi
鳸=hỗ
鴂=quyết
鴒=linh
鴞=hào
鴽=như
鶹=lưu
鵙=quyết
鵶=nha
鵷=uyên
鵻=giai
鵾=côn
鶃=nghịch
鶊=canh
鶒=xích
鶡=hạt
鶬=thương
鶺=tích
鷀=từ
鷁=nghịch
鷃=yến
鷄=kê
鷖=ê
鷞=sương
鷟=trạc
鷫=túc
鷴=nhàn
鷽=hạc
鷾=ý
鸂=khê
鸇=chiên
鸋=ninh
鸎=oanh
鸑=nhạc
鸜=cù
鸤=thi
鹒=canh
鸶=tư
鸰=linh
鸲=cù
鸴=hạc
鸵=đà
鸺=hưu
鹠=lưu
鹁=bồ câu nhà
鹇=nhàn
鹈=đề
鹍=côn
鹡=tích
鹩=liêu
鹯=chiên
鹻=dảm
麄=thô
麅=bào
麌=ngu
麕=quân
麞=chương
麪=miển
麫=miến
麯=khúc
麰=mâu
麴=khúc
麸=phu
黐=ly
黓=dặc
黟=y
黤=yểm
黦=uất
黰=chẩn
黶=yểm
鼂=trào
鼃=oa
鼈=miết
鼏=mịch
鼥=bạt
鼦=điêu
鼧=đà
鼪=sinh
鼬=chồn sóc/Itachi
鼮=đình
鼷=hề
齁=hầu
齅=khứu
齆=úng
齇=tra
齈=nông
齌=tễ
齎=tê
齕=hột
齗=ngân
齘=giới
齚=trách
齩=giảo
龝=thu
龡=xúy
龢=hòa
譭=hủy
珅=thân
頽=đồi
揾=uấn
礻=thị
屟=tiệp
璺=vấn
圢=đinh
閗=đấu
冣=tối
爟=quán
镚=băng
亊=sự
腲=uỷ
淠=tụy
鰆=xuân
袎=áo
兙=thập
関=quan
爥=chúc
龎=bàng
饍=thiện
墫=tôn
円=viên/yên
耲=hoài
铋=bí
寜=ninh
翄=sí
茓=huyệt
讐=thù
唗=đâu
钛=thái
痖=á
钂=đảng
棰=trùy
鼖=phần
鎷=mã
鑹=thoản
軆=thể
庁=sảnh
嘠=dát
侜=chu
酶=môi
冹=phu
醿=my
锽=hoàng
貈=mạch
禓=thương
躜=toàn
貘=heo vòi
貎=nghê
諆=khi
簆=khấu
铪=ha/cáp
翙=kiều
庼=khoảnh
鄫=tằng
靪=đinh
鼔=cổ
豶=phần
丗=thế
椴=đoạn
鼚=xương
絻=miễn
冇=mão
赟=uân
僴=giản
缐=tuyến
銒=bính
墖=tháp
頟=ngạch
騤=quỳ
铔=a
鲩=cán
麐=lân
齼=sở
溓=liễm
莚=diên
翤=sí
屄=bi/âm hộ/lồn
腇=nỗi
屃=hý
稬=nhu
脒=mễ
恌=khiêu
恓=tây
塃=hoang
塙=xác
塽=sảng
胗=truân
胨=đống
骻=khóa
傈=lật
庤=chí
鷰=yến
僄=phiêu
閛=phanh
锠=xương
黈=thẩu
缞=thôi
稨=biển
呧=để
膻=mùi/thiên
吥=bất
兛=thiên
崌=cư
婼=xúc
寉=hạc
剠=kình
鲐=thai
卋=thế
絙=căng
娯=ngu
髐=hiêu
咊=hòa
蓨=điệu
勔=miễn
鬑=liêm
峱=nạo
笯=nô
轱=cô
璁=thông
媭=tu
瑷=ái
猨=viên
獚=hoàng
菂=đích
蠪=long
玍=ca
怓=nao
寁=toản
咑=đát
羠=di
嶌=đảo
吢=khấm
嫿=họa
崁=khám
咅=phôi
艪=lỗ
濎=đỉnh
劚=chủ
墈=khám
鶂=nghịch
噷=hâm
厀=tất
咡=nhị
僲=tiên
昝=tảm
笭=linh
鼄=chu
豭=gia
鄇=hậu
昪=biện
骙=quỳ
垵=am
橚=thu
厛=sảnh
棂=linh
呑=thôn
絸=kiển
鹴=sương
鲏=bì
岋=ngập
趔=liệt
剣=kiếm
鯆=phô
嵷=tung
聧=khuê
艒=mục
峫=da
攗=quấn
琎=tấn
掰=tách ra
蒕=uân
肰=nhiên
黀=tưu
縗=thôi
鬛=liệp
隣=lân
朆=phân
峿=ngô
氡=đông
剨=lưu
醎=hàm
氙=tiên
剹=lục
稑=lục
礹=nham
鑥=lỗ
荘=trang
匰=đơn
撖=hàn
鼌=trào
葓=hồng
潨=tùng
孬=nhút nhát
仫=mu
氪=khắc
倯=tùng
葊=am
鬇=tranh
蟟=liêu
兊=đoài
叧=lánh
嚜=muội
噣=trác
倷=nãi
劖=thiền
劋=giảo
偺=cha
剱=kiếm
侭=tận
嚛=hộ
霣=vẫn
庿=miếu
悕=hy
俍=lương
襱=lũng
耝=thư
佹=quỷ
妐=chung
戺=sĩ
冐=mạo
鏭=tất
蹓=lựu
鹸=kiềm
瘚=quyết
圕=đồ
旪=hiệp
吋=tấc
鮻=toa
魛=đao
癈=phết
劒=kiếm
盋=chén bát
鑔=sát
匼=hạp
詅=linh
攵=phác
砳=lặc
厳=nghiêm
藚=tục
鼅=tri
螨=mãn
钖=dương
脶=loa
剙=sang
墑=thương
傛=dung
薖=oa
佅=mại
儓=đài
凖=chuẩn
嗝=nấc
淴=hốt
羴=thiên
滺=du
鲒=cát
隮=tê
諐=khiên
籢=liêm
瞙=mạc
剅=lâu
勽=câu
糂=tảm
勼=cưu
嗞=chi
勌=quyện
黇=chiêm
剒=thố
崪=tụy
駞=đà
蹿=nhảy lên
膍=tỳ
蒭=sô
綂=thống
轙=nghĩ
瀁=dưỡng
礩=chí
怹=than
玓=đích
蝄=võng
炝=sang
蹚=lội/thang
焊=hàn/hạn
枒=nha
蛐=con dế
焯=trác
啰=lải nhải
僈=mạn
咭=cười
妺=muội
晢=triết
砢=kha
薾=nhĩ
铱=y
闶=khang
硪=ngã
螅=tức
焐=ngộ
啵=ba
崮=cố
芏=đỗ
俣=vũ
嘣=băng
氩=á
鶱=hiên
邗=hàn
笤=điều
龅=bao
苷=đại
鉼=bính
潲=sảo
嘧=mật
庹=thỏa
蚵=hà
痫=giản
呲=thử
猡=lợn
裉=khẳng
谥=thụy
镧=lan
碲=đế
矸=canh
儇=uyên
呒=mô
浠=hy
孢=bào
僳=túc
硌=cấn
镆=mạc
坜=lịch
敨=thầu
慬=cận
匉=phanh
啈=hanh
浯=ngô
瑮=lật
潙=vi
瑨=tấn
硅=silic
歯=xỉ
瑳=tha
氠=tiên
扡=thiên
敩=hiệu
獴=mông
獢=kiêu
慭=ngận
湉=điềm
汳=biện
敫=kiểu
戭=diễn
慦=ngận
獁=mã
眭=khôi
畇=vận
漰=bằng
捁=giảo
晩=vãn
楩=tiện
咩=be/be be
忪=chung
啮=gặm/gặm
滢=oánh
茬=gốc rạ/mảnh vụn (gốc)
貙=sơ
螾=dẫn
毨=tiển
儵=thúc
淢=vực
箘=duẩn
硖=giáp
沣=phong
岍=khiên
泲=tể
曶=hốt
礶=quán
鬷=tông
菆=tưu
笮=trách
漦=ly
翚=huy
毐=ải
鳦=yến
潏=quyết
湼=niết
騕=yểu
褭=niểu
邽=khuê
郄=khích
郕=thành
郐=cối
陉=hình
鼟=thăng
詟=triệp
舋=hấn
羰=thang
嶲=tây
薆=ái
铵=an
仨=ba
棓=bang
袚=bát
铬=crôm
餟=chuyết
牿=cố
臌=cổ
辊=cổn
捄=cứu
噔=đăng/thịch
耷=đạp
枓=đấu
磾=đê
釱=đệ
嚭=dĩ
圛=dịch
帟=diệc
铞=điếu
耵=đinh
逌=do
殰=độc
鋊=dụ
坱=dưỡng
蝝=duyên
囏=gian
鬜=gian
唊=giáp
唶=giới
駻=hãn
绗=hàng
缿=hạng
秏=hạo
韅=hiển
铧=hoa
懁=hoài
圂=hoạn
偟=hoàng
嚄=hoát
胲=hợi
焄=hôn
憓=huệ
酅=hy
侉=khoa
蝰=khuê
掔=kiên
禨=ky
蔇=ký
埼=kỳ
郲=lai
盭=lệ
瓅=lịch
皪=lịch
钌=liễu
璙=liệu
漻=liêu/liệu
尥=liệu
酃=linh
嵂=luật
茏=lung
巃=lung
辌=lương
熘=lựu
唛=mạ
幎=mạc
甿=manh
虻=manh
鄚=mạo
馍=bánh bao không nhân
枬=nam
咢=ngạc
腭=ngạc
苅=ngải
耏=nhi
蕠=như
堧=nhuyên
聍=ninh
嫈=oanh
畈=phán
袢=phán
羒=phần
蚡=phẫn
岪=phất
沨=phong
鍑=phúc
摓=phùng
钫=phương
猓=quả
絓=quái
廥=quái
瓘=quán
垝=quỷ
睠=quyến
婘=quyền
璚=quỳnh
濇=sắc
铯=sắc
毚=sàm
瀺=sàm
姺=sâm
碜=sầm
箾=sao
胵=si
跮=sí
鄋=sưu
艚=tào
潗=tập
桚=tạt
巂=tây
貣=thắc
肽=thái
惝=thảng
郪=thê
掭=thiệm
钎=thiên
怗=thiếp
钍=thổ
涒=thôn
鬏=thu
鏦=thung
孅=tiêm
蹮=tiên
滗=tiết
猋=tiêu
灂=tiếu
拃=tra
碴=cặn bã/tra/gây sự
奓=trá
紩=trật
咮=trụ
孖=tư
蝍=tức
廧=tường
咺=tuyên
頾=tỳ
辒=uân
妘=vân
沕=vật
薳=vĩ
栄=vinh
迋=vương
埆=xác
啴=xiển
歜=xúc
斶=xúc
猲=yết
祅=yêu
獦=cát
鞞=bỉ
斸=trọc
慞=chương
滉=hoảng
掜=nghễ
鬖=tam
彔=lục
諕=hách
鉆=kiềm
啀=nhai
喍=sài
慱=đoàn
躘=long
繂=luật
檃=ổn
揌=tai
跱=trĩ
禠=ti
縳=truyện
夌=lăng
楄=biên
焂=thúc
紏=củ
祴=cai
捘=tuấn
狚=đán
唅=hám
屴=lực
蔪=tiêm
渻=tỉnh
戯=hí
晫=trác
剳=tráp
犟=cưỡng
咝=ti/ư
俉=ngộ
媱=dao
罏=lô
茍=cẩu
祂=Thần/hắn
噒=liên
瘨=điên
嬢=nương
穪=xưng
唭=cức
緑=lục
锕=a
锿=ai
砹=Astatine
媕=am
腤=am
鞌=an
鮟=an
隞=ngao
嶅=ngao
锛=bôn
琫=bổng
甏=bảnh
鲾=bức
佊=bỉ
吡=ti
沘=tỉ
舭=tỉ
珌=tất
湢=bức
皕=bức
髲=bị
奰=bị
煸=kích
惼=biển
碥=biển
苄=biện
艑=biển
飑=tiêu/đua
幖=tiêu
滮=bưu
瀌=phiêu
穮=phiêu
砵=Đồng Bát
鲌=cá thiểu
僰=Bặc
髆=vai
峬=xinh đẹp duyên dáng
庯=xinh đẹp
鵏=bổ
篰=bộ
礤=sát
噆=thảm
憯=thảm
黪=thảm
懆=tháo
箣=sách
噌=vụt
馇=tra
艖=sa
垞=tra
嵖=tra
猹=tra
檫=sát
蹅=tra
辿=siêm
鋋=thiền
镡=đốc kiếm
浐=sản
韂=xiếm
鋹=sưởng
玚=sướng
弨=siêu
怊=siêu
麨=siêu
耖=sao
伡=xa
唓=xa
奲=đả
抻=thân
趻=sẩm
踸=sẩm
宬=thành
铖=thành
翀=xung
犨=trừu
侴=sửu
殠=xú
滀=súc
諔=xúc
憷=sợ hãi
搋=trĩ
膗=soài
氚=xuyên
篅=thuyên
噇=trảng
堾=xuân
蝽=xuân
輴=thuân
娖=xúc
惙=tuyết
玼=tần
薋=từ
跐=di
熜=thông
憱=xúc
镩=thoản
獕=thôi
刌=thổn
鎝=đáp
垯=đáp
炟=đát
溚=tháp
繨=đáp
呔=này/oanh
汏=đại
轪=đại
甙=đại
黱=đại
褝=đan
黕=đảm
疍=đản
甔=đam
蟷=đang
垱=đáng
氘=đao
鱽=đao
嘚=đắc
頔=địch
骶=đế
俤=đệ
墬=địa
嗲=ỏn ẻn/điệu
攧=điên
汈=điêu
蛁=điêu
惵=điệt
嵽=điệt
艓=điệp
玎=đinh
啶=định
铥=đu
岽=đông
鸫=đông
垌=lan/động
蔸=đâu
阧=đẩu
钭=thẩu
酘=đậu
厾=đốc
塅=đoạn
碫=đoạn
撴=đôn
蹾=giằng mạnh
驐=đôn
砘=đôn
敚=đoạt
哚=đoá/ pặc/pặc
饳=đốt
娿=a
涐=nga
锇=nga
苊=ách
奀=ân
摁=nhấn
洏=nhi
铒=nhĩ
垡=phạt
灋=pháp
颿=phàm
鷭=phiên
嬔=phiêm
蚄=phương
鲱=phi
胐=phỉ
镄=phí
玢=phân
棻=phân
豮=phần
坋=phận
鲼=phẫn
瀵=phẫn
砜=phong
甮=phụng
呋=phu
刜=phất
栿=phục
砩=phất
箙=phục
鮄=phất
蝜=phụ
旮=ca/mọi ngóc ngách
钆=ca
尜=giát
尕=ca
隑=cái
匄=cái
忓=can
酐=can
漧=can
笴=cảm
擀=lau kỹ/giã/cán
鳡=cảm
冮=giang
掆=giang
堽=canh
筻=cánh
锆=zirconium
暠=cảo
圪=khất
袼=cách
茖=các
塥=cách
滆=cách
镉=Cadmium Cd
虼=khát
哏=ngân
茛=cấn
縆=hằng
堩=hằng
塨=cung
唝=cống
軱=cô
钴=cỗ
馉=cốt
濲=cốc
堌=cố
鲴=cố
胍=qua
劀=qua
緺=oa
痯=quản
輨=quản
鳤=quản
毌=quán
咣=cạch
珖=quang
鬶=quy
瓌=khôi
氿=cửu
姽=quỹ
炅=cảnh
筀=quế
磙=quả lăn
呙=oa
啯=quắc
腘=quắc
漍=quốc
馃=quả
氦=heli
嗐=hại
浛=hàm
焓=hàm
垾=hàn
淏=hạo
暤=hao
澔=hạo
饸=hợp
盉=hoà
訸=hoà
佫=hạc
翯=hạc
鸻=hằng
吰=hồng
竑=hồng
荭=hồng
鈜=hồng
鉷=hồng
魟=hồng
骺=hậu
犼=hống/Hống
垕=hậu
鲘=hậu
烀=luộc
轷=hô
唿=hô
幠=hô
煳=hồ
嘝=hộc
鳠=hộ
婳=họa
澴=hoàn
瓛=hiến
艎=hoàng
癀=hoàng
餭=hoàng
皩=hoàng
榥=hoảng
皝=hoàng
咴=hí
僡=huệ
潓=huệ
嚖=huệ
惽=hôn
棔=hôn
耠=hoát
锪=hốt
劐=hoạch
攉=hoắc
騞=hoạch
钬=hoả
漷=quách
嚯=hoắc/ồ
敧=khi
觭=ki
忣=cấp
垍=ký
穊=ký
襀=tích
檵=kỷ
鰶=kê
镓=gia
靬=kiền
搛=kiêm
瑊=giam
鲣=kiên
櫼=tiêm
枧=kiển
暕=giản
瀽=kiển
楗=kiện
諓=tiễn
踺=kiện
茳=giang
螀=tương
鳉=tương
礓=cương
耩=giảng
膙=cưỡng
弶=cương
糨=cưỡng
峧=giao
珓=giao
滘=khiếu
嘦=chiếu
漖=giáo
藠=hiểu
湝=giai
疌=tiệp
蜐=kiếp
玠=giới
褯=giải
紟=kim
浕=tận
巠=kinh
猄=kình
麖=kinh
鼱=tinh
汫=tỉnh
弪=kính
倞=kình
婧=tịnh/nhu
冏=sáng
浻=quýnh
煚=cảnh
泃=cù
挶=cục
梮=cục
腒=cư
跔=câu
焗=hấp
湨=cừ
粔=cự
犋=cụ
澽=cự
帣=quyển
锩=quyển
桊=quyên
砄=quyết
鴃=quyết
焌=tuấn
佧=kha
胩=ca
蒈=khải
莰=khảm
顑=khảm
槺=khang
鱇=khang
钪=cang
骒=khoả
芤=khâu
眍=khu
筘=khấu
圐=khố
髋=xương hông
洭=khuông
鵟=cuồng
夼=khoảng
喹=khuê
戣=khôi
櫆=khôi
醌=côn
筈=quát
鞟=khoát
旯=xó
砬=lạp/đá
揦=lạt
蝲=lạt
鯻=lạt
鞡=lạp
梾=lai
铼=lai
鶆=lai
唻=lai
襕=lan
籣=lan
漤=lãm
硠=lang
鎯=lang
悢=lượng
烺=lãng
埌=lãng
崀=lương
蒗=lang
崂=lao
铹=lao
铑=lão
耢=lạo
嫪=lạc
仂=lặc
玏=lặc
簕=lặc
饹=hợp
欙=luy
儽=lỗi
颣=loại
嘞=lặc
塄=lăng
堎=lăng
喱=li
鵹=li
锂=lithium/lí
梿=liên
裢=hầu bao
磏=liêm
臁=liêm
鰊=liễm
椋=lương
墚=lương
唡=lưỡng
裲=lưỡng
蹽=liêu
憭=liêu
簝=liêu
髎=liêu
鱲=liệp
啉=lâm
潾=lân
璘=lân
瞵=lân
皊=linh
祾=lăng
呤=lánh/đinh
飗=lưu
罶=liễu
磟=lưu
鹨=lưu
眬=lung
溇=lâu
耧=máy gieo hạt
撸=lột/tuốt/cách chức/triệt/vén
镥=lỗ
睩=lục
蕗=lộ
氇=lỗ
稆=lữ
埨=luân
摞=chồng/chồng chất
呣=mô
杩=mã
祃=mã
荬=mại
劢=mại
杧=mang
牻=mang
硭=mang
漭=mãng
髳=mâu
峁=mão/Mão
铆=mão
猸=mi
鹛=mi
钔=môn
勐=mãnh
锰=mangan
醚=ê-te
沵=nhĩ
丏=miễn
愐=miến
喵=meo/meo ô/meo meo/Meow/miêu
鹋=miêu
乜=liếc
忞=mân
苠=mân
慜=mẫn
礳=ma
耱=ma
哞=mu/bò....ò.../tiếng bò rống/ò/Ùm...ụm bò....ò...tiếng bò rống
毪=mâu
娒=mai
坶=mẫu
钼=mục
镎=nã
乸=nả
萘=đồ
齉=nãng
夒=nao
巎=nao
垴=não
铌=ni
伲=ní
鉨=tỉ
脲=niệu
嵲=niệt
鬡=ninh
胬=nỗ
傉=nộc
钕=nữ
籹=nữ
锘=nặc
掱=vát
潖=bà
帊=bạc
棑=bài
簰=bài
哌=phái
蒎=phái
坢=bán
鋬=phạn
鳑=bàng
嗙=khoác lác/khoe khoang
耪=bảnh
髈=phảng
狍=bào
奅=pháo
毰=bồi
锫=bầu
抨=phanh
嘭=bành/thình thịch/oành
堋=bằng
鬅=bằng
椪=bàng
伾=phi
悂=phi
釽=tịch
鈚=phi
椑=ti
蜱=tỳ
鮍=bì
犏=thiên
嘌=nhanh chóng
氕=ách
嫳=phách
玭=tần
榀=phẩm
帡=bình
幈=bình
鲆=bình
钋=polonium
钷=phả
笸=phả
哱=hao
镤=mộc
潽=phô
氆=phổ
镨=phổ
桤=khởi
桼=tất
磎=khê
魌=kỳ
亓=kỳ
疧=kỳ
鲯=kỳ
碶=thế
磜=thế
葜=kháp
拤=tạp
髂=khá
鹐=kham
墘=kiền
肷=hàm
綪=khiếm
戗=thương
锖=thương
羟=thưởng
瓩=thiên
劁=tiêu
荍=kiều
硚=kiều
鞒=kiều
撽=khiếu
躈=khiếu
嵚=khâm
捦=cầm
嗪=tần
吣=tẩm
氰=tình
苘=khoảnh
藑=quỳnh
鹙=thu
訄=cừu
巯=khưu
銶=cầu
鼽=cừu
麹=đến nỗi
黢=xuất
鼩=cù
欋=cù
牷=toàn
鳈=tuyền
宭=quần
儴=nhương
瑢=dung
鞣=thuộc da
煣=nhu
铷=như
朊=nguyễn
潵=tán
毸=tai
瘙=tao
篸=trâm
赸=sán
熵=entropy
垧=thưởng
绱=thượng
畲=xa
輋=xa
滠=nhiếp
屾=sằn
燊=thân
駪=sằn
鲹=sâm
瞫=thẩm
胂=thân
眘=thận
瘆=hãi
湦=sinh
嵊=thặng
浉=sư
鲺=sắt
鰤=sư
辻=thập
炻=thạch
祏=thạch
昰=thị
栻=thức
铈=thị
鄃=huyện du
腧=thú
騻=sương
礵=sương
佀=tự
骕=túc
濉=tuy
穟=tuỵ
睃=thoa
羧=các-bô-xít cooh
溻=thạp
褟=thạp
嚃=đạp
酞=thai
倓=đàm
榃=đàm
锬=đàm
钽=đán
埮=đàm
赕=đạm
嘡=boong boong
鄌=đường
樘=đường
餹=đường
耥=thang
匋=đào
脦=thắc
铽=thác
蟘=đạc
遆=đề
鳀=đề
鶗=đề
畑=điền
畠=điền
脁=thiểu
萜=thiếp
桯=thỉnh
侹=đĩnh
珽=đĩnh
颋=đĩnh
嗵=oành
峂=đồng
烔=đồng
砼=đồng
鲖=đồng
朣=đồng
穜=chủng
斢=điều
疃=thoản
煺=thoái
氽=thỗn
侂=thác
侻=thoái
捝=thoát
陁=đà
坨=đống
萚=thác
塆=loan
忨=ngoạn
抏=ngoan
鳂=ôi
廆=hội
艉=vĩ
霨=uý
讏=vệ
鳁=ôn
炆=văn
鹟=ông
塕=ổng
肟=ốc
钨=vonfram/ô/
郚=ngô
鵐=vu
阢=ngột
扤=ngột
芴=vật
饻=thi
娭=ai
硒=tây
舾=tây
瘜=tức
觽=huề
郋=hề
鳛=tập
鱚=hỉ
隟=khích
虩=khích
忺=hiêm
酰=tiên
冼=tiển
崄=hiểm
晛=hiện
猇=hao
灺=tã
卨=tiết
塮=tạ
伈=tầm
炘=hân
箵=tinh
钘=hình
擤=lau
婞=hanh
魆=tối om om
盨=sử
垿=tự
晅=huyên
禤=huyên/Huyên
譞=huyên
暅=hằng
昡=huyền
碹=toàn
峃=học
栒=tuân
鄩=tầm
噚=tầm
伢=trẻ con
岈=nha
玡=nha
垭=khe núi
挜=á
猰=áp
蔫=ỉu xìu
扊=diễm
棪=diễm
縯=diễn
鼹=yển
觃=nghiện
垟=dương
垚=nghiêu
倻=da
铘=gia
嫛=ê
柂=đà
宧=di
扅=di
酏=di
簃=di
觺=nghi
钇=ất
晹=dương
嫕=ế
廙=dực
潩=dị
鹝=nghịch
燚=diệc
螠=ế
寱=nghệ
鮨=nghệ
癔=ý
镱=ý
虉=dị
洇=nhân
铟=nhân
歅=nhân
溵=ân
唫=ngậm
訚=ngân
吲=oành
讔=ẩn
茚=ấn
垽=ngận
鮣=ấn
媖=anh
煐=anh
锳=anh
溁=oanh
蓥=oanh
籝=doanh
嗈=ung
埇=dũng
鲬=dũng
鄾=ưu
莜=du
鲉=du
牗=dũ
蚴=ấu
玙=dư
狳=dư
嵛=du
艅=dư
髃=ngung
騟=du
偊=vũ
鄅=vũ
貐=du
堉=dục
淯=dục
滪=dự
薁=áo
燏=duật
鴥=duật
箢=uyên
塬=nguyên
羱=nguyên
垸=viện
衏=viện
彟=ược
抈=nguyệt
玥=nguyệt
籆=dược
熅=huân
沄=vân
涢=vân
鋆=vân
甾=tai
傤=tái
糌=ta
蹔=tạm
酂=tán
灒=tiễn
唣=tao
迮=trách
挓=tra
溠=trá
苲=trả
砟=cứng
鲝=trả
膪=troại
醡=trá
飦=chiên
搌=triển
黵=đảm
骣=sản
餦=trương
礃=chưởng
樀=đích
嗻=già
禛=chân/Chân
纼=dẫn
椥=tri
榰=chi
汦=chi
狾=chế
梽=chí
铚=trất
滍=trĩ
稙=trắc
膣=âm đạo
螲=chất
蚛=trọng
鸼=châu
喌=châu
伷=khúc
荮=bọc bằng cỏ
槠=chử
砫=trụ
詝=chủ
檛=qua
跩=duệ
膇=truy
錣=xuyết
衠=truân
埻=đôn
禚=chước
鲻=tri
虸=tử
啙=tử
腙=tông
朘=thuyên
岞=tạc
唑=tọa
沏=pha/ngâm vào nước
敇=sách
梹=tân
禇=chử
闫=diêm/Diêm
樤=đầu
菈=lạp
珝=hủ/hứa
洐=hành/diễn
咵=khoa trương
黒=hắc
嚒=sao
壆=huyệt
弾=đạn/弹
尛=nhỏ bé
龞=ba ba/鳖
诶=ài/ấy/ôi chao
袛=chi/đê
佷=chất
伝=vân
晧=hạo
玹=xuân
劵=khoán
琍=lợi
靑=giáp
喧=huyên/tiếng động lớn
豊=phong
禑=Từ
惀=luân
沢=trạch
竂=lều
犸=voi ma mút
褔=phúc
煓=sủy
桖=mộc huyết
嫰=nộn
囧=quýnh/quýnh :-( 囧
沷=tẩy rửa sạch sẽ
龘=đát
喰=xan/Ghoul
柲=bí