DD=DD/đệ đệ
JJ=JJ/JJ(tiểu đệ đệ)
K 歌=hát Karaoke/K ca**
MM=MM/muội muội
UP主=uploader/UP Master/UP chủ
丁千总=Đinh thiên tổng
七伯=Thất bá
七儿=Thất nhi
七叔=Thất thúc
七哥=Thất ca/thất ca
七妹=Thất muội
七姐=Thất tỷ
七姨=Thất di
七姨太=Thất di thái
七嫂=Thất tẩu
七少主=Thất thiếu chủ
七师叔=Thất sư thúc/thất sư thúc
七弟=Thất đệ/thất đệ
七爷=Thất gia
七老=Thất lão
七老怪=Thất lão quái
万叔=Vạn thúc
万哥=Vạn ca
万城主=Vạn thành chủ
万大哥=Vạn đại ca
万家=Vạn gia
万少主=Vạn thiếu chủ
万师叔=Vạn sư thúc
万师弟=Vạn sư đệ
万师祖=Vạn sư tổ
万总=Vạn tổng
万某=Vạn mỗ
万老=Vạn lão
万老鬼=Vạn lão quỷ
万邦=vạn bang/Wanbon/tất cả các quốc gia
三伯=Tam bá
三伯母=Tam bá mẫu
三伯父=Tam bá phụ
三儿=Tam nhi
三叔=Tam thúc/tam thúc
三妹=Tam muội/tam muội
三姑家=Tam cô gia
三姓家奴=gia nô ba họ/gia nô họ Ba
三姨=dì Ba/Tam di
三姨太=Tam di thái
三嫂=Tam tẩu
三家=ba nhà/Tam gia
三少主=Tam thiếu chủ
三师叔=Tam sư thúc/tam sư thúc
三师祖=Tam sư tổ/tam sư tổ
三弟=tam đệ/Tam đệ
三民主义=chủ nghĩa Tam Dân
三爷=Tam gia/tam gia
三第=Tam đệ
三老=Tam lão
三长垩老=Tam trưởng lão
上官兄弟=Thượng Quan huynh đệ
上官大哥=Thượng Quan đại ca
上官姐=Thượng Quan tỷ
上官帮主=Thượng Quan bang chủ
上官长老=Thượng Quan trưởng lão
上架=lên khung/lên giá/vào VIP/chưng bày/lên khung (vào VIP)
不儿=Bất nhi
不宁爷=không Trữ gia
专家级=chuyên gia cấp/cấp Expert-chuyên gia
世伯=Thế bá
丘家=Khâu gia
丘师伯=Khâu sư bá
东方老爷=Đông Phương lão gia
丞相家=Thừa tướng gia
严伯=Nghiêm bá
严儿=Nghiêm nhi
严先生=Nghiêm tiên sinh
严公子=Nghiêm công tử
严叔=Nghiêm thúc
严哥=Nghiêm ca
严城主=Nghiêm thành chủ
严大人=Nghiêm đại nhân
严姐=Nghiêm tỷ
严姨=Nghiêm di
严家=Nghiêm gia
严少主=Nghiêm thiếu chủ
严弟=Nghiêm đệ
严某=Nghiêm mỗ
严母=Nghiêm mẫu
严爷=Nghiêm gia
严老=Nghiêm lão
严老七=Nghiêm lão thất
严老六=Nghiêm lão lục
严老怪=Nghiêm lão quái
严老爷=Nghiêm lão gia
严老鬼=Nghiêm lão quỷ
严门主=Nghiêm môn chủ
中央空调=trung ương điều hòa/điều hòa không khí trung tâm/Nghĩa gốc là điều hòa tổng
丰儿=Phong nhi
丰哥=Phong ca
主君=chủ quân/Quận chúa
主坐=chủ toạ/Chủ mưu/chủ phạm. § Cũng nói là chủ nhi 主兒. ◇Thủy hử truyện 水滸傳: Từ Ninh thính bãi/tâm trung tưởng đạo: Kí hữu chủ tọa/tất bất ngại sự 徐寧聽罷/心中想道: 既有 主坐/必不礙事
主持人=người chủ trì/người chủ trì /DJ
丽姐=Lệ tỷ
久哥=Cửu ca
义儿=Nghĩa nhi
之主=chi chủ/đứng đầu/Chi Chủ
乐哥=Nhạc ca
乐姐=Nhạc tỷ
乐家=Nhạc gia
乐某=Nhạc mỗ
乔先生=Kiều tiên sinh
乔哥=Kiều ca
乔大哥=Kiều đại ca
乔家=Kiều gia
乔总=Kiều tổng
乔某=Kiều mỗ
乔老=Kiều lão
乔迁之喜=niềm vui thăng quan/Kiều Thiên vui mừng/Tân gia
九伯=Cửu bá
九儿=Cửu nhi
九叔=Cửu thúc
九哥=Cửu ca
九妹=cửu muội/Cửu muội
九姐=Cửu tỷ
九姨=Cửu di
九姨太=Cửu di thái
九嫂=Cửu tẩu
九家=chín nhà/Cửu gia/cửu gia
九少主=Cửu thiếu chủ
九师祖=Cửu sư tổ
九弟=Cửu đệ
九爷=cửu gia/Cửu gia
九老=Cửu lão
九老怪=Cửu lão quái
习字帖=sách tập viết/Sách chữ mẫu để tập viết
习家=Tập gia
乡巴佬=nhà quê/Hai lúa/hương ba lão
乾儿=Càn nhi
乾叔=Càn thúc
乾家=Càn gia
乾某=Càn mỗ
二伯=Nhị bá/nhị bá
二伯母=Nhị bá mẫu
二伯父=Nhị bá phụ
二儿=Nhị nhi
二叔=Nhị thúc/nhị thúc/chú hai
二叔叔=Nhị thúc thúc
二哥=nhị ca/Nhị ca
二妹=Nhị muội
二姐=Nhị tỷ/nhị tỷ
二姨=dì Hai/Nhị di
二姨太=Nhị di thái
二嫂=Nhị tẩu
二家=hai nhà/Nhị gia
二少主=Nhị thiếu chủ
二少爷=Nhị thiếu gia/nhị thiếu gia
二师伯=Nhị sư bá
二师叔=Nhị sư thúc
二师祖=Nhị sư tổ
二当家=Nhị đương gia
二猛哥=Nhị Mãnh ca
二老=Nhị lão
二老板=Nhị lão bản
二表妹=Nhị biểu muội
于叔=Vu thúc
于哥=Vu ca
于家=Vu gia
于某=tại nào đó/Vu mỗ
于爷=Vu gia
云叔=Vân thúc
云城主=Vân thành chủ
云妹=Vân muội
云姐=Vân tỷ
云家=Vân gia
云少主=Vân thiếu chủ
云师叔=Vân sư thúc
云师祖=Vân sư tổ
云总=Vân tổng
云老怪=Vân lão quái
云老爷=Vân lão gia
云老鬼=Vân lão quỷ
云门主=Vân môn chủ
五伯=Ngũ bá
五儿=Ngũ nhi
五叔=Ngũ thúc
五哥=ngũ ca/Ngũ ca
五妹=Ngũ muội
五姐=Ngũ tỷ
五姨=ngũ di/Ngũ di
五姨太=Ngũ di thái
五嫂=Ngũ tẩu
五子棋=cờ ca rô/cờ năm quân/cờ Liên Châu ( cờ Renju)
五家=năm nhà/Ngũ gia
五少主=Ngũ thiếu chủ
五师叔=Ngũ sư thúc
五师祖=Ngũ sư tổ
五弟=Ngũ đệ
五斗米道=Ngũ Đấu Mễ Đạo/Con đường của Thiên chủ
五某=Ngũ mỗ
五老=Ngũ lão
五老怪=Ngũ lão quái
交换机=tổng đài/Switch/tổng đài điện thoại
亦母=Diệc mẫu
亮儿=Lượng nhi/lửa đèn/đèn đuốc/ánh sáng
亮哥=Lượng ca
仇姐=Cừu tỷ
仇家=cừu gia/kẻ thù/địch thủ/Cừu gia
仇家的人=người của Cừu gia
今日事今日毕=hôm nay sự hôm nay làm/hôm nay chuyện hôm nay kết thúc/Việc hôm nay chớ để ngày mai
仓家=Thương gia
付家=Phó gia
付总=Phó tổng
付某=Phó mỗ
付阜弟=Phó phụ đệ
仙儿=Tiên nhi
仙妹=Tiên muội
仙家=Tiên gia/tiên gia
令狐兄弟=Lệnh Hồ huynh đệ
令狐公子=Lệnh Hồ công tử
令狐大哥=Lệnh Hồ đại ca
令狐老=Lệnh Hồ lão
仪儿=Nghi nhi
仪姐=Nghi tỷ
仲儿=Trọng nhi
任伯=Nhâm bá
任儿=Nhâm nhi
任副门主=Nhâm phó môn chủ
任千总=Nhâm Thiên tổng/Nhâm thiên tổng
任哥=Nhâm ca
任城主=đảm nhiệm thành chủ/Nhâm thành chủ
任大人=mặc cho đại nhân/Nhậm đại nhân
任大哥=Nhâm đại ca
任妹=Nhâm muội
任姐=Nhậm tỷ
任姨=Nhậm di
任嫂=Nhâm tẩu
任家=Nhâm gia/Nhậm gia
任家村=Nhâm gia thôn
任少主=Nhâm thiếu chủ
任师伯=Nhậm sư bá
任帮主=Nhâm bang chủ
任弟=Nhâm đệ
任总=Nhậm tổng
任总管=Nhâm tổng quản
任某=Nhậm mỗ
任母=Nhâm mẫu
任爷=Nhâm gia
任老=Nhậm lão/Nhâm lão
任老七=Nhâm lão thất
任老六=Nhâm lão lục
任老怪=Nhâm lão quái
任老鬼=Nhâm lão quỷ
任门主=Nhâm môn chủ
伊家=Y gia
伊总=Y tổng
伊贺家=Y Hạ gia
伍先生=Ngũ tiên sinh
伍家=Ngũ gia
伍某=Ngũ mỗ
伟哥=Vĩ ca/Viagra
伪县长=Ngụy chủ tịch huyện
伪城主=Ngụy thành chủ
伪家=Ngụy gia
伪少主=Ngụy thiếu chủ
伯家=Bá gia
伯爵=bá tước/Bá tước
伯爵府=phủ Bá tước/phủ bá tước
佐伯=Tá bá
佐儿=Tá nhi
佐叔=Tá thúc
佐哥=Tá ca
佐姐=Tá tỷ
佐家=Tá gia
佐少主=Tá thiếu chủ
佐爷=Tá gia
佐老=Tá lão
何儿=Hà nhi
何千总=Hà Thiên tổng/Hà thiên tổng
何哥=Hà ca
何城主=Hà thành chủ
何大爷=Hà đại gia
何妹=Hà muội
何姐=Hà tỷ
何姨=Hà di
何嫂=Hà tẩu
何家=Hà gia
何家村=Hà gia thôn
何少主=Hà thiếu chủ
何师祖=Hà sư tổ
何弟=Hà đệ
何总=Hà tổng
何某=Hà mỗ
何母=Hà mẫu
何爷=Hà gia
何老=Hà lão
何老七=Hà lão thất
何老八=Hà lão bát
何老六=Hà lão lục
何老怪=Hà lão quái
何老鬼=Hà lão quỷ
佘家=Xa gia
佘少主=Xà thiếu chủ
佘某=Xa mỗ
佘老怪=Xà lão quái
佘老鬼=Xà lão quỷ
佘门主=Xà môn chủ
余伯=Dư bá
余儿=Dư nhi
余副门主=Dư phó môn chủ
余叔=Dư thúc
余哥=Dư ca
余城主=Dư thành chủ
余姐=Dư tỷ
余姨=Dư di
余嫂=Dư tẩu
余家=Dư gia
余家村=Dư gia thôn
余少主=Dư thiếu chủ
余弟=Dư đệ
余总=Dư tổng
余母=Dư mẫu
余爷=Dư gia
余老=Dư lão
余老七=Dư lão thất
余老八=Dư lão bát
余老六=Dư lão lục
余老怪=Dư lão quái
余老鬼=Dư lão quỷ
佛主=Phật chủ/phật tổ
佛家=phật gia/Phật gia
佛爷=Phật gia/ông Phật/Phật Thích Ca Mâu Ni
佛老=Phật lão/Phật giáo và Đạo giáo/Phật và Lão Tử
佛门弟子=đệ tử Phật môn/đệ tử cửa Phật/Phật tử
你们宋家=Tống gia các ngươi
佳儿=Giai nhi
依依姐=Y Y tỷ
侠儿=Hiệp nhi
侯世家=Hầu thế gia
侯伯=Hầu bá
侯儿=Hầu nhi
侯千总=Hầu Thiên tổng/Hầu thiên tổng
侯叔=Hầu thúc
侯哥=Hầu ca
侯妹=Hầu muội
侯姐=Hầu tỷ
侯家=Hầu gia
侯家庄=Hầu gia trang
侯寨主=Hầu trại chủ
侯少主=Hầu thiếu chủ
侯师叔=Hầu sư thúc
侯弟=Hầu đệ
侯总=Hầu tổng
侯母=Hầu mẫu
侯爷=Hầu gia
侯老=Hầu lão
侯老怪=Hầu lão quái
侯老爷=Hầu lão gia
侯老鬼=Hầu lão quỷ
侯门主=Hầu môn chủ
俊儿=Tuấn nhi
保哥=Bảo ca
俞伯=Du bá
俞儿=Du nhi
俞叔=Du thúc
俞哥=Du ca
俞城主=Du thành chủ
俞姐=Du tỷ
俞姨=Du di
俞嫂=Du tẩu
俞家=Du gia
俞师叔=Du sư thúc
俞师祖=Du sư tổ
俞某=Du mỗ
俞母=Du mẫu
俞爷=Du gia
俞老=Du lão
俞老鬼=Du lão quỷ
候伯=Hậu bá
候儿=Hậu nhi
候叔=Hậu thúc
候哥=Hậu ca
候妹=Hậu muội
候姐=Hậu tỷ
候姨=Hậu di
候嫂=Hậu tẩu
候家=Hậu gia
候少主=Hậu thiếu chủ
候师叔=Hậu sư thúc
候弟=Hậu đệ
候总=Hậu tổng
候某=Hậu mỗ
候母=Hậu mẫu
候爷=Hầu gia/Hậu gia
候老=Hậu lão
候老怪=Hậu lão quái
倩姐=Thiến tỷ
倩姨=Thiến di
倪妹=Nghê muội
倪总=Nghê tổng
倪某=Nghê mỗ
健哥=Kiện ca
傅先生=Phó tiên sinh
傅城主=Phó thành chủ
傅大人=Phó đại nhân
傅家=Phó gia
傅家庄=Phó gia trang
傅师叔=Phó sư thúc
傅师祖=Phó sư tổ
傅某=Phó mỗ
傅爷=Phó gia
傅老怪=Phó lão quái
傅老鬼=Phó lão quỷ
傅门主=Phó môn chủ
傢伙=gia hoả/cái thứ/con/lão này/Gia hỏa/các đồ dùng trong nhà/anh chàng
储家=Trữ gia
儒哥=Nho ca
儿科=khoa Nhi/nhi khoa/khoa nhi
儿童医院=bệnh viện nhi/bệnh viện nhi đồng/Bệnh viện Nhi đồng/Bệnh viện nhi đồng
儿童片=phim thiếu nhi/Phim dành cho thiếu nhi
允儿=Doãn nhi/Yoona
元儿=Nguyên nhi
元家=Nguyên gia
元帅=nguyên soái/chủ soái/Nguyên soái
元某=Nguyên mỗ
元老会=nguyên lão hội/Nguyên Lão Hội
兆儿=Triệu nhi
光叔=Quang thúc
光哥=Quang ca
光头哥=Quang đầu ca/đầu trọc đại ca
克儿=Khắc nhi
入林家=nhập Lâm gia/vào Lâm gia
全国运动会=đại hội thể dục thể thao toàn quốc/Đại hội Thể thao Quốc gia/Đại hội thể dục thể thao toàn quốc
八伯=Bát bá
八儿=Bát nhi
八叔=Bát thúc
八哥=chim sáo/Bát ca
八妹=Bát muội
八姐=Bát tỷ
八姨=Bát di
八姨太=Bát di thái
八嫂=Bát tẩu
八家=tám nhà/Bát gia
八少主=Bát thiếu chủ
八师叔=Bát sư thúc
八师祖=Bát sư tổ
八弟=Bát đệ
八爷=bát gia/Bát gia
八老=Bát lão
八老怪=Bát lão quái
公亩=công mẫu/A
公子纠=công tử Củ
公子默=công tử Mặc
公孙老儿=Công Tôn lão nhi
公羊家=Công Dương gia
六儿=Lục nhi
六叔=Lục thúc
六哥=lục ca/Lục ca
六妹=Lục muội
六姐=Lục tỷ
六姨=Lục di
六姨太=Lục di thái
六嫂=Lục tẩu
六家=sáu nhà/Lục gia
六少主=Lục thiếu chủ
六弟=Lục đệ
六爷=Lục gia
六老=Lục lão
兰城主=Lan thành chủ
兰妹=Lan muội
兰姊=Lan tỷ
兰姐=Lan tỷ
兰嫂=Lan tẩu
兰师叔=Lan sư thúc
兰某=Lan mỗ
兰老鬼=Lan lão quỷ
兰门主=Lan môn chủ
关二爷=Quan nhị gia
关伯=Quan bá
关儿=Quan nhi
关千总=Quan Thiên tổng/Quan thiên tổng
关叔=Quan thúc
关哥=Quan ca
关妹=Quan muội
关姐=Quan tỷ
关姨=Quan di
关嫂=Quan tẩu
关家=Quan gia
关家庄=Quan gia trang
关少主=Quan thiếu chủ
关师叔=Quan sư thúc
关师祖=Quan sư tổ
关弟=Quan đệ
关总=chủ tịch Quan/Quan tổng
关母=Quan mẫu
关爷=Quan gia
关王爷=Quan vương gia
关老=Quan lão
关老七=Quan lão thất
关老怪=Quan lão quái
关老爷=Quan lão gia
关老鬼=Quan lão quỷ
兵哥=Binh ca
兽伯=Thú bá
内务府=phủ Nội Vụ/Bộ Hộ Hoàng gia
军儿=Quân nhi
军哥=Quân ca
农家=nông gia/nhà nông/gia đình nông dân/Nông Gia
冠希哥=Quán Hi ca
冤大头=oan đại đầu/coi tiền như rác/công tử Bạc Liêu/người tiêu tiền như nước
冥老=Minh lão
冯兄弟=Phùng huynh đệ
冯先生=Phùng tiên sinh
冯公子=Phùng công tử
冯城主=Phùng thành chủ
冯姐=Phùng tỷ
冯家村=Phùng gia thôn
冯少主=Phùng thiếu chủ
冯师叔=Phùng sư thúc
冯师弟=Phùng sư đệ
冯师祖=Phùng sư tổ
冯总=Phùng tổng
冯某=Phùng mỗ
冯老怪=Phùng lão quái
冯老鬼=Phùng lão quỷ
冯门主=Phùng môn chủ
冰儿你=Băng nhi ngươi
冰姐=Băng tỷ
冰少主=Băng thiếu chủ
冰玉=băng ngọc/Băng Ngọc/Tỉ dụ nhân phẩm cao khiết hoặc sự vật trong sạch.Nói tắt của băng thanh ngọc nhuận 冰清玉潤: gọi thay cha vợ và chàng rể.Tỉ dụ cha và con.Hình dung trơn sạch bóng láng. ◇Nguyên sử 元史: Nhan diện như băng ngọc/nhi thần như ác đan nhiên 顏面如冰玉/而脣如渥丹然
冰老怪=Băng lão quái
冰老鬼=Băng lão quỷ
冰门主=Băng môn chủ
况家=Huống gia
冷伯=Lãnh bá
冷儿=Lãnh nhi
冷叔=Lãnh thúc
冷哥=Lãnh ca
冷城主=Lãnh thành chủ
冷妹=Lãnh muội
冷姐=Lãnh tỷ
冷姨=Lãnh di
冷少主=Lãnh thiếu chủ
冷峰主=Lãnh phong chủ
冷师叔=Lãnh sư thúc
冷某=Lãnh mỗ
冷母=Lãnh mẫu
冷爷=Lãnh gia
冷老=Lãnh lão
冷老七=Lãnh lão thất
冷老怪=Lãnh lão quái
冷老鬼=Lãnh lão quỷ
凉东主=Lương đông chủ
凉家=Lương gia
凌儿=Lăng nhi
凌副门主=Lăng phó môn chủ
凌哥=Lăng ca
凌城主=Lăng thành chủ
凌姐姐=Lăng tỷ tỷ
凌小姐=Lăng tiểu thư
凌少主=Lăng thiếu chủ
凌师叔=Lăng sư thúc
凌师祖=Lăng sư tổ
凌总=Lăng tổng
凌爷=Lăng gia
凌老怪=Lăng lão quái
凌老鬼=Lăng lão quỷ
凌门主=Lăng môn chủ
凝姐=Ngưng tỷ
凡哥=Phàm ca
凡夫俗子=phàm phu tục tử/người thường/tín đồ Thiên chúa giáo La Mã không chịu tham gia các buổi lễ của giáo hội Anh như luật pháp quy định trước kia
凡弟=Phàm đệ
凤儿=Phượng Nhi/Phượng nhi
凤凰家=Phượng Hoàng gia
凤哥=Phượng ca
凤姊姊=Phượng tỷ tỷ
凤姐=Phượng tỷ/Phượng tả
凤姐姐=Phượng tỷ tỷ
凤少主=Phượng thiếu chủ
凤师叔=Phượng sư thúc
凤老=Phượng lão
凤老大=Phượng lão đại
凤老怪=Phượng lão quái
凤老爷=Phượng lão gia
凤老鬼=Phượng lão quỷ
凤门主=Phượng môn chủ
凯恩斯主义=chủ nghĩa Keynes
刑家=Hình gia
刑某=Hình mỗ
列宁主义=chủ nghĩa Lê-Nin
列某=Liệt mỗ
列老=Liệt lão
刘三爷=Lưu tam gia
刘乡长=Lưu chủ tịch xã
刘伯=Lưu bá
刘儿=Lưu nhi
刘兄弟=Lưu huynh đệ
刘先生=Lưu tiên sinh
刘公子=Lưu công tử
刘副门主=Lưu phó môn chủ
刘千总=Lưu Thiên tổng/Lưu thiên tổng
刘卿家=Lưu khanh gia
刘哥=Lưu ca
刘城主=Lưu thành chủ
刘大爷=Lưu đại gia
刘妹=Lưu muội
刘姐=Lưu tỷ
刘姥姥=Lưu mỗ mỗ/lưu mỗ mỗ
刘姨=Lưu di
刘嫂=Lưu tẩu
刘家=Lưu gia
刘家庄=Lưu gia trang
刘家村=Lưu gia thôn
刘家的人=người của Lưu gia
刘小姐=Lưu tiểu thư
刘少主=Lưu thiếu chủ
刘师弟=Lưu sư đệ
刘师祖=Lưu sư tổ
刘弟=Lưu đệ
刘总=Lưu tổng
刘母=Lưu mẫu
刘爷=Lưu gia
刘老七=Lưu lão thất
刘老八=Lưu lão bát
刘老太=Lưu lão thái
刘老怪=Lưu lão quái
刘老板=Lưu lão bản
刘老爷=Lưu lão gia
刘老爷子=Lưu lão gia tử
刘老鬼=Lưu lão quỷ
刘门主=Lưu môn chủ
刘阿姨=dì Lưu
剑伯=Kiếm bá
剑儿=Kiếm nhi
剑霸=kiếm bá/Kiếm Bá
副主=Phó chủ
副主编=phó chủ biên/Phó Tổng biên tập
副县长=phó huyện trưởng/Phó huyện trưởng/phó chủ tịch huyện
副总经理=phó tổng quản lý/Phó tổng kinh lý
副总裁=phó tổng giám đốc/Phó tổng tài
副董事长=Phó chủ tịch
副行长=Phó chủ tịch ngân hàng
副门主=phó môn chủ/Phó môn chủ
力家=Lực gia
加元=gia nguyên/đô la Canada
加加=gia gia/Gaga
加老=Gia lão/gia lão
劫家=Kiếp gia
劳哥=Lao ca
劳某=Lao mỗ
勇儿=Dũng nhi
勇哥=Dũng ca
勾九妹=Câu cửu muội
勾家=Câu gia
包伯=Bao bá
包儿=Bao nhi
包千总=Bao Thiên tổng/Bao thiên tổng
包叔=Bao thúc
包哥=Bao ca
包城主=Bao thành chủ
包妹=Bao muội
包姐=Bao tỷ
包姨=Bao di
包家=Bao gia
包师叔=Bao sư thúc
包弟=Bao đệ
包某=Bao mỗ
包母=Bao mẫu
包爷=Bao gia
包老=Bao lão
包长老=Bao trưởng lão
包门主=Bao môn chủ
匕哥=Chủy ca
北家=Bắc gia
北师叔=Bắc sư thúc
北老怪=Bắc lão quái
十一弟=Thập Nhất đệ
千家=Thiên gia
千总=Thiên tổng
千某=Thiên mỗ
华伯=Hoa bá
华儿=Hoa nhi
华叔=Hoa thúc
华哥=Hoa ca
华妹=Hoa muội
华姐=Hoa tỷ
华姨=Hoa di
华嫂=Hoa tẩu
华少主=Hoa thiếu chủ
华师祖=Hoa sư tổ
华强哥=Hoa Cường ca
华总=Hoa tổng
华母=Hoa mẫu
华老=Hoa lão
华老怪=Hoa lão quái
华老鬼=Hoa lão quỷ
华门主=Hoa môn chủ
卓伯=Trác bá
卓儿=Trác nhi
卓叔=Trác thúc
卓哥=Trác ca
卓城主=Trác thành chủ
卓妹=Trác muội
卓姐=Trác tỷ
卓姨=Trác di
卓嫂=Trác tẩu
卓少主=Trác thiếu chủ
卓师叔=Trác sư thúc
卓弟=Trác đệ
卓某=Trác mỗ
卓母=Trác mẫu
卓爷=Trác gia
卓老=Trác lão
卓老七=Trác lão thất
卓老怪=Trác lão quái
卓老鬼=Trác lão quỷ
卓门主=Trác môn chủ
单城主=Thiện thành chủ
单家=Đan gia/Thiện gia
单家庄=Đan gia trang/Thiện gia trang
单少主=Đan thiếu chủ/Thiện thiếu chủ
单师叔=Đan sư thúc/Thiện sư thúc
南儿=Nam nhi/Nam Nhi
南哥=Nam ca
南姐=Nam tỷ
南某=Nam mỗ
南老怪=Nam lão quái
博儿=Bác nhi
博施济众=phổ độ chúng sinh/Bosch Ji chúng/Thi ân rộng khắp/cứu giúp dân chúng. ◇Luận Ngữ 論語: Tử Cống viết: Như hữu bác thi ư dân nhi năng tế chúng/hà như? Khả vị nhân hồ? Tử viết: Hà sự ư nhân! Tất dã thánh hồ! 子貢曰: 如有博施於民而能濟眾/何如? 可謂仁乎? 子曰: 何事於仁/必也聖乎
占家=Chiêm gia
卢先生=Lô tiên sinh/Lư tiên sinh
卢卡申科=Lukashenko/Aleksandr Grigoryevich Lukachenko, tổng thống Belarus từ năm 1994
卢叔=Lô thúc
卢哥=Lô ca
卢城主=Lư thành chủ
卢姨=Lô di
卢家=Lư gia/Lô gia/nhà họ Lư
卢小姐=Lư tiểu thư
卢少主=Lư thiếu chủ
卢师叔=Lư sư thúc
卢某=Lô mỗ/Lư mỗ
卢老=Lô lão
卢老怪=Lư lão quái
卢老鬼=Lư lão quỷ
卢门主=Lư môn chủ
卫伯=Vệ bá
卫儿=Vệ nhi
卫千总=Vệ Thiên tổng/Vệ thiên tổng
卫叔=Vệ thúc
卫哥=Vệ ca
卫大哥=Vệ đại ca
卫妹=Vệ muội
卫姐=Vệ tỷ
卫姨=Vệ di
卫嫂=Vệ tẩu
卫家=Vệ gia
卫少主=Vệ thiếu chủ
卫师弟=Vệ sư đệ
卫弟=Vệ đệ
卫总=Vệ tổng
卫某=Vệ mỗ
卫母=Vệ mẫu
卫爷=Vệ gia
卫老=Vệ lão
卫老三=Vệ lão tam
卫老鬼=Vệ lão quỷ
卫门主=Vệ môn chủ
卷老=Quyển lão
卿儿=Khanh nhi
卿妹=Khanh muội
厉伯=Lệ bá
厉儿=Lệ nhi
厉先生=Lệ tiên sinh
厉叔=Lệ thúc
厉哥=Lệ ca
厉城主=Lệ thành chủ
厉妹=Lệ muội
厉姐=Lệ tỷ
厉姨=Lệ di
厉家=Lệ gia
厉少主=Lệ thiếu chủ
厉弟=Lệ đệ
厉总=Lệ tổng
厉母=Lệ mẫu
厉爷=Lệ gia
厉老=Lệ lão
厉老怪=Lệ lão quái
厉老鬼=Lệ lão quỷ
厉门主=Lệ môn chủ
原家=Nguyên gia
厢儿=Sương nhi
县老爷=Huyện lão gia
县长=huyện trưởng/Huyện trưởng/chủ tịch huyện
参任家=tham Nhâm gia
发哥=Phát ca
古副门主=Cổ phó môn chủ
古哥=Cổ ca
古姐=Cổ tỷ
古家=Cổ gia
古少主=Cổ thiếu chủ
古师叔=Cổ sư thúc
古师祖=Cổ sư tổ
古某=Cổ mỗ
古老=cổ lão/cổ xưa/Cổ lão/từ xưa/cổ kính/cũ xưa
古门主=Cổ môn chủ
可儿=Khả nhi
史伯=Sử bá
史儿=Sử nhi
史叔=Sử thúc
史哥=Sử ca
史城主=Sử thành chủ
史大人=Sử đại nhân
史大哥=Sử đại ca
史妹妹=Sử muội muội
史姐=Sử tỷ
史家=Sử gia
史家村=Sử gia thôn
史师叔=Sử sư thúc
史帮主=Sử bang chủ
史弟=Sử đệ
史某=Sử mỗ
史母=Sử mẫu
史爷=Sử gia
史老三=Sử lão tam
史老六=Sử lão lục
史老大=Sử lão đại
史老怪=Sử lão quái
史老鬼=Sử lão quỷ
史莱姆=Slime/sử lai mỗ
史门主=Sử môn chủ
叶伯=Diệp bá
叶儿=Diệp nhi
叶副门主=Diệp phó môn chủ
叶叔=Diệp thúc
叶妹=Diệp muội
叶姐=Diệp tỷ
叶姨=Diệp di
叶嫂=Diệp tẩu
叶家=Diệp gia
叶家的人=Diệp gia người/người của Diệp gia
叶小爷=Diệp tiểu gia
叶少主=Diệp thiếu chủ
叶师祖=Diệp sư tổ
叶弟=Diệp đệ
叶总=Diệp tổng
叶母=Diệp mẫu
叶爷=Diệp gia
叶老七=DIệp lão thất
叶老六=DIệp lão lục
叶老怪=Diệp lão quái
叶老汉=Diệp lão hán
叶老鬼=Diệp lão quỷ
叶门主=Diệp môn chủ
司南伯=Tư Nam bá tước
司徒叔=Tư Đồ thúc
司徒大哥=Tư Đồ đại ca
司徒姐=Tư Đồ tỷ
司徒家=Tư Đồ gia
司徒帮主=Tư Đồ bang chủ
司徒老=Tư Đồ lão
司徒老儿=Tư Đồ lão nhi
司空家=Tư Không gia
吉光片羽=mảnh da Cát Quang/di sản văn hoá quý giá/quý giá
吉哥=Cát ca
名儿=Danh nhi
向某=Hướng mỗ
向母=Hướng mẫu
吕伯=Lữ bá
吕儿=Lữ nhi
吕先生=Lữ tiên sinh
吕副门主=Lữ phó môn chủ
吕千总=Lữ Thiên tổng/Lữ thiên tổng
吕叔=Lữ thúc
吕城主=Lữ thành chủ
吕大人=Lữ đại nhân
吕姐=Lữ tỷ
吕姨=Lữ di
吕嫂=Lữ tẩu
吕小妹=Lữ tiểu muội
吕少主=Lữ thiếu chủ
吕师叔=Lữ sư thúc
吕师弟=Lữ sư đệ
吕师爷=Lữ sư gia
吕师祖=Lữ sư tổ
吕弟=Lữ đệ
吕母=Lữ mẫu
吕爷=Lữ gia
吕老怪=Lữ lão quái
吕老鬼=Lữ lão quỷ
吕门主=Lữ môn chủ
君哥=Quân ca
君弟=Quân đệ
君某=Quân mỗ
君门主=Quân môn chủ
启儿=Khải nhi
吴伯=Ngô bá
吴儿=Ngô nhi
吴副门主=Ngô phó môn chủ
吴千总=Ngô Thiên tổng/Ngô thiên tổng
吴叔=Ngô thúc
吴哥=Ngô ca
吴城主=Ngô thành chủ
吴妹=Ngô muội
吴姐=Ngô tỷ
吴姐姐=Ngô tỷ tỷ
吴姨=Ngô di
吴嫂=Ngô tẩu
吴家=Ngô gia
吴家庄=Ngô gia trang
吴小姐=Ngô tiểu thư
吴少主=Ngô thiếu chủ
吴师叔=Ngô sư thúc
吴师弟=Ngô sư đệ/Ngô  sư đệ
吴师祖=Ngô sư tổ
吴弟=Ngô đệ
吴总=Ngô tổng
吴母=Ngô mẫu
吴老=Ngô lão
吴老七=Ngô lão thất
吴老八=Ngô lão bát
吴老六=Ngô lão lục
吴老大=Ngô lão đại
吴老将军=Ngô lão tướng quân
吴老怪=Ngô lão quái
吴老板=Ngô lão bản
吴老爷子=Ngô lão gia tử
吴老鬼=Ngô lão quỷ
吴长老=Ngô trưởng lão
吴门主=Ngô môn chủ
吾家=nhà ta/Ngô Gia/Ngô gia
周伯=Chu bá
周儿=Chu nhi
周先生=Chu tiên sinh
周千总=Chu Thiên tổng/Chu thiên tổng
周叔=Chu thúc
周哥=Chu ca
周城主=Chu thành chủ
周妹=Chu muội
周姐=Chu tỷ
周姐姐=Chu tỷ tỷ
周姨=Chu di
周姨娘=Chu di nương
周嫂=Chu tẩu
周嫂子=Chu tẩu tử
周家=Chu gia
周家庄=Chu gia trang
周家村=Chu gia thôn
周家的人=người của Chu gia
周少主=Chu thiếu chủ
周师伯=Chu sư bá
周师叔=Chu sư thúc
周师祖=Chu sư tổ
周弟=Chu đệ
周总=Chu tổng
周母=Chu mẫu
周相爷=Chu tướng gia
周老七=Chu lão thất
周老八=Chu lão bát
周老六=Chu lão lục
周老怪=Chu lão quái
周老爷=Chu lão gia
周老爷子=Chu lão gia tử
周老鬼=Chu lão quỷ
周门主=Chu môn chủ
呼某=Hô mỗ
呼老摩=Hô lão ma
和婉儿=và Uyển nhi
和家=Hòa gia
和平儿=và Bình nhi
和平哥=và Bình ca
和文家=và Văn gia
唐千总=Đường Thiên tổng/Đường thiên tổng
商家=thương gia/Thương gia/nhà buôn
商少主=Thương thiếu chủ
商师叔=Thương sư thúc
商某=Thương mỗ
商老=Thương lão
商老太=Thương lão thái
喇叭=loa/kèn đồng/còi/Lạt bá/cái loa
嗝儿=Cách nhi
嘉哥=Gia ca
四伯=Tứ bá
四儿=Tứ nhi
四叔=Tứ thúc/tứ thúc
四哥=tứ ca/Tứ ca
四妹=Tứ muội/tứ muội
四姐=Tứ tỷ/tứ tỷ
四姨=Tứ di/dì Tư
四姨太=Tứ di thái
四嫂=Tứ tẩu
四家=bốn nhà/Tứ gia/tứ gia
四少主=Tứ thiếu chủ
四师叔=tứ sư thúc/Tứ sư thúc
四师祖=Tứ sư tổ
四弟=Tứ đệ/tứ đệ
四某=Tứ mỗ
四海之内皆兄弟=tứ hải giai huynh đệ/trong bốn biển đều là huynh đệ/Anh em bốn biển một nhà
四爷=Tứ gia/tứ gia
四皇儿=Tứ hoàng nhi
四老=Tứ lão
四老怪=Tứ lão quái
回千总=bẩm Thiên tổng
固师祖=Cố sư tổ
国哥=Quốc ca
国家杜马=Duma Quốc gia
圆伯=Viên bá
圆儿=Viên nhi
圆叔=Viên thúc
圆哥=Viên ca
圆妹=Viên muội
圆姐=Viên tỷ
圆姨=Viên di
圆家=Viên gia
圆母=Viên mẫu
圆爷=Viên gia
圆老=Viên lão
土家=Thổ Gia/Thổ gia
土老怪=Thổ lão quái
圣主=Thánh Chủ/thánh chủ/minh chủ/Thánh chủ
圣歌=thánh ca/Thánh Ca/Thánh ca
圣母=thánh mẫu/đức mẹ Ma-ri-a/đức mẹ/Thánh mẫu/Thánh Mẫu
圣母婊=thánh mẫu đĩ/Đức Mẹ/chó cái thần thánh
坚叔=Kiên thúc
坤道=khôn đạo/Cách ăn ở của người đàn bà. Khôn đạo: Đạo quẻ Khôn, Phụ nữ theo về Khôn đạo, do câu Khôn vi mẫu, cũng như đàn ông theo về Kiền đạo, do câu Kiền vi phu. » Này con gái thuộc về Khôn đạo. Khôn đức nhu nết gái dịu dàng «
城儿=Thành nhi
域主=Vực Chủ/vực chủ
基哥=Cơ ca
基干民兵=dân quân chủ lực/dân quân Kigan
塔爷=Tháp gia
墨姐=Mặc tỷ
墨少主=Mặc thiếu chủ
墨师叔=Mặc sư thúc
墨师祖=Mặc sư tổ
墨总=Mặc tổng
墨某=Mặc mỗ
墨老=Mặc lão
墨老怪=Mặc lão quái
墨老鬼=Mặc lão quỷ
墨门主=Mặc môn chủ
壁儿=Bích nhi
士家=Sĩ gia
备儿=Bị nhi
复儿=Phục nhi
夏伯=Hạ bá
夏儿=Hạ nhi
夏公子=Hạ công tử
夏千总=Hạ thiên tổng
夏叔=Hạ thúc
夏哥=Hạ ca
夏城主=Hạ thành chủ
夏妹=Hạ muội
夏姐=Hạ tỷ
夏姨=Hạ di
夏威夷果=quả mắc-ca/trái cây Hawaii/Macadamia
夏嫂=Hạ tẩu
夏家=Hạ gia
夏家人=người Hạ gia/người nhà họ Hạ
夏家的人=người của Hạ gia
夏少主=Hạ thiếu chủ
夏师叔=Hạ sư thúc
夏师祖=Hạ sư tổ
夏弟=Hạ đệ
夏总=Hạ tổng
夏某=Hạ mỗ
夏母=Hạ mẫu
夏爷=Hạ gia
夏老=Hạ lão
夏老七=Hạ lão thất
夏老八=Hạ lão bát
夏老六=Hạ lão lục
夏老怪=Hạ lão quái
夏老鬼=Hạ lão quỷ
夏门主=Hạ môn chủ
夏阿姨=Hạ a di
外姑=ngoại cô/Mẹ vợ. Như Nhạc mẫu.
夜妹=Dạ muội
夜姐=Dạ tỷ
夜总=Dạ tổng
夜某=Dạ mỗ
大堂哥=đại đường ca/anh Đại Sảng
大宝哥=Đại Bảo ca
大方=hào phóng/chuyên gia/học giả/chuyên môn/thành thạo/lành nghề/trong nghề/chè Đại Phương/trà Đại Phương/rộng rãi/phóng khoáng/độ lượng/nghĩa hiệp/tự nhiên/thanh thản/đứng đắn/trang nhã/nhã/nền nã/hào phóng
大老粗=đại lão thô/già nua/Người kém văn hoá/không có văn hoá
大觉=đại giác/Đại Giác/Giác ngộ triệt để. ◇Trang Tử 莊子: Thả hữu đại giác/nhi hậu tri thử kì đại mộng dã 且有大覺/而後知此其大夢也
大风歌=Đại Phong ca
天主=Thiên chủ/Chúa Trời
天儿=Thiên nhi
天副门主=Thiên phó môn chủ
天叔=Thiên thúc
天哥=Thiên ca
天妹=Thiên muội
天姐=Thiên tỷ
天家=Thiên gia
天少主=Thiên thiếu chủ
天弟=Thiên đệ
天恒城主=Thiên Hằng thành chủ
天某=Thiên mỗ
天歌=Thiên ca
天母=Thiên mẫu/Thiên Mẫu
天爷=Thiên gia
天老=Thiên lão
天老儿=người bị bệnh bạch tạng/người bạch tạng/Thiên lão nhi
天老怪=Thiên lão quái
天老爷=ông trời/trời/Thiên lão gia
天老鬼=Thiên lão quỷ
天若有情天亦老="Thiên nhược hữu tình Thiên diệc lão"
太叔家=Thái Thúc gia
头儿=đầu nhi/Lão đại/thủ lĩnh
夷人=di nhân/người Di
奇儿=Kỳ nhi
奇叔=Kỳ thúc
奇爷=Kỳ gia
奉家=Phụng gia
如雨伯=như Vũ bá
妃儿=Phi nhi
妍姐=Nghiên tỷ
妖主=Yêu Chủ/yêu chủ
妙家=Diệu gia
妮姐=Ny tỷ
委蛇=Uy di/ung dung tự đắc
姚伯=Diêu bá
姚儿=Diêu nhi
姚先生=Diêu tiên sinh
姚叔=Diêu thúc
姚哥=Diêu ca
姚城主=Diêu thành chủ
姚妹=Diêu muội
姚姐=Diêu tỷ
姚姨=Diêu di
姚嫂=Diêu tẩu
姚家=Diêu gia
姚寨主=Diêu trại chủ
姚少主=Diêu thiếu chủ
姚师叔=Diêu sư thúc
姚某=Diêu mỗ
姚母=Diêu mẫu
姚爷=Diêu gia
姚老=Diêu lão
姚老八=Diêu lão bát
姚老六=Diêu lão lục
姚老怪=Diêu lão quái
姚老板=Diêu lão bản
姚老鬼=Diêu lão quỷ
姚门主=Diêu môn chủ
姜伯=Khương bá
姜儿=Khương nhi
姜副门主=Khương phó môn chủ
姜千总=Khương thiên tổng
姜叔=Khương thúc
姜哥=Khương ca
姜城主=Khương thành chủ
姜大人=Khương đại nhân
姜妹=Khương muội
姜姐=Khương tỷ
姜姨=Khương di
姜嫂=Khương tẩu
姜家的人=người của Khương gia
姜少主=Khương thiếu chủ
姜师叔=Khương sư thúc
姜师祖=Khương sư tổ
姜弟=Khương đệ
姜总=Khương tổng
姜某=Khương mỗ
姜母=Khương mẫu
姜爷=Khương gia
姜老六=Khương lão lục
姜老怪=Khương lão quái
姜老鬼=Khương lão quỷ
姜门主=Khương môn chủ
姨太太=di thái thái/vợ bé/vợ lẽ/Di thái thái
姬伯=Cừu bá
姬叔=Cừu thúc
姬哥=Cừu ca
姬城主=Cơ thành chủ
姬大哥=Cơ đại ca
姬妹=Cừu muội
姬姐=Cừu tỷ
姬姨=Cừu di
姬家的人=người Cơ gia
姬少主=Cơ thiếu chủ
姬师叔=Cơ sư thúc
姬师弟=Cơ sư đệ
姬师祖=Cơ sư tổ
姬某=Cơ mỗ/Cừu mỗ
姬母=Cơ mẫu
姬爷=Cừu gia
姬老=Cơ lão/Cừu lão
姬老七=Cơ lão thất
姬老三=Cơ lão tam
姬老八=Cơ lão bát
姬老怪=Cơ lão quái
姬老鬼=Cơ lão quỷ
姬门主=Cơ môn chủ
威哥=Uy ca
娃儿=oa nhi/Oa Nhi
娄家=Lâu gia
娜儿=Na nhi
娜姐=Na tỷ
娟妹=Quyên muội
娴儿=Nhàn nhi
婉姨=Uyển di
媚姐=Mị tỷ
嬴家=Doanh gia/doanh gia
孔伯=Khổng bá
孔儿=Khổng nhi
孔先生=Khổng tiên sinh
孔叔=Khổng thúc
孔哥=Khổng ca
孔城主=Khổng thành chủ
孔妹=Khổng muội
孔姐=Khổng tỷ
孔姨=Khổng di
孔嫂=Khổng tẩu
孔家=Khổng gia
孔家庄=Khổng gia trang
孔少主=Khổng thiếu chủ
孔师叔=Khổng sư thúc
孔师祖=Khổng sư tổ
孔弟=Khổng đệ
孔母=Khổng mẫu
孔爷=Khổng gia
孔老七=Khổng lão thất
孔老二=Khổng lão nhị
孔老六=Khổng lão lục
孔老怪=Khổng lão quái
孔老鬼=Khổng lão quỷ
孙三弟=Tôn tam đệ
孙伯=Tôn bá
孙儿=tôn nhi/Tôn nhi
孙先生=Tôn tiên sinh
孙千总=Tôn Thiên tổng/Tôn thiên tổng
孙叔=Tôn thúc
孙哥=Tôn ca
孙城主=Tôn thành chủ
孙大人=Tôn đại nhân
孙大哥=Tôn đại ca
孙妹=Tôn muội
孙姐=Tôn tỷ
孙姨=Tôn di
孙嫂=Tôn tẩu
孙家=Tôn gia
孙家庄=Tôn gia trang
孙少主=Tôn thiếu chủ
孙师祖=Tôn sư tổ
孙弟=Tôn đệ
孙总=Tôn tổng
孙总兵=Tôn tổng binh
孙某=Tôn mỗ
孙母=Tôn mẫu
孙爷=Tôn gia
孙老=Tôn lão
孙老七=Tôn lão thất
孙老三=Tôn lão tam
孙老九=Tôn lão cửu
孙老八=Tôn lão bát
孙老六=Tôn lão lục
孙老怪=Tôn lão quái
孙老爷=Tôn lão gia
孙老鬼=Tôn lão quỷ
孙长老=Tôn trưởng lão
孙门主=Tôn môn chủ
孟伯=Mạnh bá
孟儿=Mạnh nhi
孟先生=Mạnh tiên sinh
孟千总=Mạnh Thiên tổng/Mạnh thiên tổng
孟叔=Mạnh thúc
孟城主=Mạnh thành chủ
孟大爷=Mạnh đại gia
孟姐=Mạnh tỷ
孟姨=Mạnh di
孟嫂=Mạnh tẩu
孟家庄=Mạnh gia trang
孟少主=Mạnh thiếu chủ
孟师叔=Mạnh sư thúc
孟师祖=Mạnh sư tổ
孟弟=Mạnh đệ
孟母=Mạnh mẫu
孟爷=Mạnh gia
孟老=Mạnh lão
孟老七=Mạnh lão thất
孟老六=Mạnh lão lục
孟老怪=Mạnh lão quái
孟老爷子=Mạnh lão gia tử
孟老鬼=Mạnh lão quỷ
孟门主=Mạnh môn chủ
季姐=Quý tỷ
季家=Quý gia
季某=Quý mỗ
季长老=Quý trưởng lão
孤云野鹤=tự do tự tại/Mây đơn hạc nội. Tỉ dụ người ở ẩn/nhàn dật tự tại/không cầu danh lợi. ◇Trần Nhữ Nguyên 陳汝元: Ngã tự tố cô vân dã hạc vô câu hệ/hàn biều phá nạp kham di thế 我自做孤雲野鶴無拘係/寒瓢破衲堪遺世
宁伯=Trữ bá/Ninh bá
宁副门主=Ninh phó môn chủ
宁哥=Ninh ca
宁妈=Ninh mẫu
宁姐=Ninh tỷ
宁姨=Trữ di
宁嫂=Trữ tẩu
宁少主=Ninh thiếu chủ
宁弟=Trữ đệ
宁某=Ninh mỗ/Trữ mỗ
宁爷=Trữ gia/Ninh gia
宁老=Ninh lão
宁老八=Ninh lão bát
宁老鬼=Ninh lão quỷ
宁门主=Ninh môn chủ
宇家=Vũ gia
宇文家=Vũ Văn gia
安副门主=An phó môn chủ
安千总=An Thiên tổng/An thiên tổng
安叔=An thúc
安哥=An ca
安大哥=An đại ca
安妹=An muội
安姐=An tỷ
安姨=An di
安嫂=An tẩu
安家=an gia/An gia/an cư/thu xếp gia đình/xếp đặt chuyện nhà/ổn định cuộc sống/lập gia đình/xây dựng gia đình/kết hôn
安家立业=an cư lập nghiệp/an gia lập nghiệp/An cư lập nghiệp
安寨主=An trại chủ
安少主=An thiếu chủ
安弟=An đệ
安某=An mỗ
安母=An mẫu
安洞主=An động chủ
安爷=An gia
安王爷=An vương gia
安老=An Lão/An lão
安老七=An lão thất
安老六=An lão lục
安老鬼=An lão quỷ
安门主=An môn chủ
宋伯=Tống bá
宋儿=Tống nhi
宋兄弟=Tống huynh đệ
宋副门主=Tống phó môn chủ
宋千总=Tống Thiên tổng/Tống thiên tổng
宋哥=Tống ca
宋哥哥=Tống ca ca
宋城主=Tống thành chủ
宋大人=Tống đại nhân
宋大叔=Tống đại thúc
宋大哥=Tống đại ca
宋大爷=Tống đại gia
宋妹=Tống muội
宋姐=Tống tỷ
宋姨=Tống di
宋家庄=Tống gia trang
宋家村=Tống gia thôn
宋家的人=người của Tống gia
宋寨主=Tống trại chủ
宋少主=Tống thiếu chủ
宋少爷=Tống thiếu gia
宋师爷=Tống sư gia
宋师祖=Tống sư tổ
宋弟=Tống đệ
宋总=Tống tổng
宋母=Tống mẫu
宋氏家族=Tống thị gia tộc/gia tộc họ Tống
宋爷=Tống gia
宋老七=Tống lão thất
宋老儿=Tống lão nhi
宋老八=Tống lão bát
宋老六=Tống lão lục
宋老怪=Tống lão quái
宋老鬼=Tống lão quỷ
宋长老=Tống trưởng lão
宋门主=Tống môn chủ
完璧归赵=của về chủ cũ/Châu về hợp Phố/Châu về hợp Phố (*của về chủ cũ)
宏哥=Hoành ca
宗家=Tông gia
官老=Quan lão
宜家=Nghi gia
宝二爷=Bảo nhị gia
宝儿=Bảo nhi
宝叔=Bảo thúc
宝姐姐=Bảo tỷ tỷ
宝爷=Bảo gia
客家=người Hẹ/khách gia
宣家=Tuyên gia
宫主=cung chủ/Cung Chủ
宫家=Cung gia
宵哥=Tiêu ca
家庭主妇=bà chủ gia đình/bà nội trợ/Nội trợ
家林=Lâm gia
容儿=Dung nhi
容师叔=Dung sư thúc
宽叔=Khoan thúc
寂儿=Tịch nhi
富哥=Phú ca
寒城主=Hàn thành chủ
对撞机=đối chàng cơ/máy gia tốc (máy va chạm (Collider))
对林家=đối với Lâm gia
寻老=Tầm lão
寿老=Thọ lão
封伯=Phong bá
封儿=Phong nhi
封副门主=Phong phó môn chủ
封千总=Phong Thiên tổng/Phong thiên tổng
封叔=Phong thúc
封哥=Phong ca
封城主=Phong thành chủ
封妹=Phong muội
封姐=Phong tỷ
封姨=Phong di
封嫂=Phong tẩu
封家=Phong gia
封少主=Phong thiếu chủ
封师叔=Phong sư thúc
封弟=Phong đệ
封某=Phong mỗ
封母=Phong mẫu
封爷=Phong gia
封老=Phong lão
封老七=Phong lão thất
封老鬼=Phong lão quỷ
将爷=Tướng gia
尉迟家=Uất Trì gia
尊城主=Tôn thành chủ
尊大人=Tôn đại nhân
尊家=Tôn gia
尊少主=Tôn thiếu chủ
尊老=tôn lão/Tôn lão
尊门主=Tôn môn chủ
小三哥=Tiểu Tam ca
小九儿=tiểu Cửu nhi
小二哥=Tiểu nhị ca/tiểu nhị ca
小兰姐=Tiểu Lan tỷ
小妍儿=tiểu Nghiên nhi
小师叔=Tiểu sư thúc/tiểu sư thúc
小杨姐姐=tiểu Dương tỷ tỷ
小欣姐=tiểu Hân tỷ
小王爷=Tiểu vương gia/tiểu vương gia
小碧儿=Tiểu Bích nhi
小莉儿=tiểu Lỵ nhi
少主=Thiếu chủ/thiếu chủ
尘家=Trần gia
尚哥=Thượng ca
尤爷=Vưu gia
尧儿=Nghiêu nhi
尧叔=Nghiêu thúc
尧哥=Nghiêu ca
尧姐=Nghiêu tỷ
尧弟=Nghiêu đệ
尧母=Nghiêu mẫu
尹家=Doãn gia
尹师弟=Doãn sư đệ
屏儿=Bình nhi
屏妹=Bình muội
屏姐=Bình tỷ
展伯=Triển bá
展儿=Triển nhi
展千总=Triển Thiên tổng/Triển thiên tổng
展叔=Triển thúc
展哥=Triển ca
展城主=Triển thành chủ
展家=Triển gia
展少主=Triển thiếu chủ
展师叔=Triển sư thúc
展弟=Triển đệ
展某=Triển mỗ
展母=Triển mẫu
展爷=Triển gia
展老=Triển lão
展老狗=Triển lão cẩu
山儿=Sơn nhi
山哥=Sơn ca
山老怪=Sơn lão quái
岑大人=Sầm đại nhân
岑姐=Sầm tỷ
岑家=Sầm gia
岚妹=Lam muội
岩弟=Nham đệ
岳会主=Nhạc hội chủ
岳先生=Nhạc tiên sinh
岳副门主=Nhạc phó môn chủ
岳家=Nhạc gia/nhạc gia/nhà bố mẹ vợ/nhạc gia
岳小姐=Nhạc tiểu thư
岳少主=Nhạc thiếu chủ
岳师叔=Nhạc sư thúc
岳师祖=Nhạc sư tổ
岳老=Nhạc lão
岳老二=Nhạc lão nhị
岳老儿=Nhạc lão nhi
岳老大=Nhạc lão đại
岳老怪=Nhạc lão quái
岳老鬼=Nhạc lão quỷ
岳门主=Nhạc môn chủ
峰儿=Phong nhi
峰哥=Phong ca
峰弟=Phong đệ
崔伯=Thôi bá
崔儿=Thôi nhi
崔先生=Thôi tiên sinh
崔叔=Thôi thúc
崔哥=Thôi ca
崔城主=Thôi thành chủ
崔大哥=Thôi đại ca
崔妹=Thôi muội
崔姐=Thôi tỷ
崔姨=Thôi di
崔家=Thôi gia
崔家庄=Thôi gia trang
崔少主=Thôi thiếu chủ
崔师叔=Thôi sư thúc
崔弟=Thôi đệ
崔某=Thôi mỗ
崔母=Thôi mẫu
崔爷=Thôi gia
崔老七=Thôi lão thất
崔老八=Thôi lão bát
崔老六=Thôi lão lục
崔老怪=Thôi lão quái
崔老鬼=Thôi lão quỷ
崔门主=Thôi môn chủ
川哥=Xuyên ca
川妹子=Xuyên muội tử
川贝=xuyên bối/bối mẫu Tứ Xuyên
左伯=Tả bá
左儿=Tả nhi
左副门主=Tả phó môn chủ
左叔=Tả thúc
左哥=Tả ca
左城主=Tả thành chủ
左头=Tả đại ca
左姐=Tả tỷ
左姨=Tả di
左家=Tả gia
左家庄=Tả gia trang
左少主=Tả thiếu chủ
左师叔=Tả sư thúc
左母=Tả mẫu
左爷=Tả gia
左老=Tả lão
左老怪=Tả lão quái
左老鬼=Tả lão quỷ
左门主=Tả môn chủ
巨头=cự đầu/đầu sỏ/trùm/Cự Đầu/Đầu Sỏ/bá chủ
巫某=Vu mỗ
巫门主=Vu môn chủ
巴某=Ba mỗ
帆儿=Phàm nhi
帆哥=Phàm ca
师城主=Sư thành chủ
希家=Hi gia
希老怪=Hi lão quái
希门主=Hi môn chủ
席家=Tịch gia
席某=Tịch mỗ
常伯=Thường bá
常儿=Thường nhi
常副门主=Thường phó môn chủ
常千总=Thường Thiên tổng/Thường thiên tổng
常叔=Thường thúc
常哥=Thường ca
常城主=Thường thành chủ
常大哥=Thường đại ca
常妹=Thường muội
常姐=Thường tỷ
常姨=Thường di
常嫂=Thường tẩu
常家=Thường gia
常少主=Thường thiếu chủ
常师叔=Thường sư thúc
常弟=Thường đệ
常某=Thường mỗ
常母=Thường mẫu
常爷=Thường gia
常老=Thường lão
常老七=Thường lão thất
常老怪=Thường lão quái
常老鬼=Thường lão quỷ
常门主=Thường môn chủ
幕儿=Mạc nhi
平伯=Bình bá
平叔=Bình thúc
平大哥=Bình đại ca
平妹=Bình muội
平姐=Bình tỷ
平姐姐=Bình tỷ tỷ
平姨=Bình di
平嫂=Bình tẩu
平家=Bình gia
平少主=Bình thiếu chủ
平师叔=Bình sư thúc
平弟=Bình đệ
平某=Bình mỗ
平母=Bình mẫu
平爷=Bình gia
平老=Bình lão
平老怪=Bình lão quái
年哥=Niên ca
幸如姐=Hạnh Như tỷ
幻哥=Huyễn ca
广哥=Quảng ca/Nghiễm ca
庄伯=Trang bá
庄儿=Trang nhi
庄先生=Trang tiên sinh
庄公子=Trang công tử
庄叔=Trang thúc
庄哥=Trang ca
庄哥哥=Trang ca ca
庄城主=Trang thành chủ
庄大哥=Trang đại ca
庄妹=Trang muội
庄姐=Trang tỷ
庄姨=Trang di
庄嫂=Trang tẩu
庄家=nhà cái/nhà chủ/cái/Trang gia : nhà cái/Trang gia
庄少主=Trang thiếu chủ
庄师叔=Trang sư thúc
庄帮主=Trang bang chủ
庄庄主=Trang trang chủ
庄弟=Trang đệ
庄某=Trang mỗ
庄母=Trang mẫu
庄爷=Trang gia
庄老=Trang Lão/Trang lão
庄老怪=Trang lão quái
庄老鬼=Trang lão quỷ
庆儿=Khánh nhi
庆家=Khánh gia
府主=Phủ chủ/phủ chủ
庞伯=Bàng bá
庞儿=Bàng nhi
庞千总=Bàng Thiên tổng/Bàng thiên tổng
庞哥=Bàng ca
庞城主=Bàng thành chủ
庞妹=Bàng muội
庞姐=Bàng tỷ
庞姨=Bàng di
庞少主=Bàng thiếu chủ
庞师叔=Bàng sư thúc
庞弟=Bàng đệ
庞某=Bàng mỗ
庞母=Bàng mẫu
庞爷=Bàng gia
庞老=Bàng lão
庞老怪=Bàng lão quái
庞老鬼=Bàng lão quỷ
庞门主=Bàng môn chủ
康儿=khang nhi/Khang nhi
康总=Khang tổng
康某=Khang mỗ
康老=Khang lão
庸儿=Dung nhi
庸家=Dung gia
廉家=Liêm gia
廖先生=Liêu tiên sinh
廖副门主=Liêu phó môn chủ
廖城主=Liêu thành chủ
廖家=Liêu gia
廖师叔=Liêu sư thúc
廖师弟=Liêu sư đệ
廖师祖=Liêu sư tổ
廖老鬼=Liêu lão quỷ
廖门主=Liêu môn chủ
建儿=Kiến nhi
弈儿=Dịch nhi
弘哥=Hoằng ca
张伯=Trương bá
张儿=Trương nhi
张副门主=Trương phó môn chủ
张千总=Trương Thiên tổng/Trương thiên tổng
张城主=Trương thành chủ
张妹=Trương muội
张姐=Trương tỷ
张姨=Trương di
张嫂=Trương tẩu
张家=Trương gia
张家口=Trương gia khẩu
张家村=Trương gia thôn
张家的人=Trương gia người/người của Trương gia
张寨主=Trương trại chủ
张少主=Trương thiếu chủ
张师叔=Trương sư thúc
张师祖=Trương sư tổ
张弟=Trương đệ
张总管=Trương tổng quản
张果老=Trương quả lão
张母=Trương mẫu
张氏家族=Trương thị gia tộc
张爷=Trương gia
张管家=Trương quản gia
张老=Trương lão
张老七=Trương lão thất
张老八=Trương lão bát
张老六=Trương lão lục
张老怪=Trương lão quái
张老鬼=Trương lão quỷ
张观主=Trương quan chủ
张门主=Trương môn chủ
强哥=Cường ca
归伯=Quy bá
归儿=Quy nhi
归叔=Quy thúc
归哥=Quy ca
归城主=Quy thành chủ
归妹=Quy muội
归姐=Quy tỷ
归家=trở về nhà/Quy gia
归少主=Quy thiếu chủ
归师叔=Quy sư thúc
归师祖=Quy sư tổ
归弟=Quy đệ
归母=Quy mẫu
归爷=Quy gia
归老六=Quy lão lục
归赵=quy Triệu/vật trở về chủ cũ/châu về hợp phố
归门主=Quy môn chủ
当萧老=khi Tiêu lão
彝族=Di tộc/dân tộc Di/di tộc
彩儿=Thải nhi
彪儿=Bưu nhi
彪哥=Bưu ca
彪爷=Bưu gia
彬儿=Bân nhi
彬哥=Bân ca
彭伯=Bành bá
彭儿=Bành nhi
彭兄弟=Bành huynh đệ
彭先生=Bành tiên sinh
彭哥=Bành ca
彭城主=Bành thành chủ
彭大哥=Bành đại ca
彭姐=Bành tỷ
彭姨=Bành di
彭家=Bành gia
彭寨主=Bành trại chủ
彭小姐=Bành tiểu thư
彭少主=Bành thiếu chủ
彭师叔=Bành sư thúc
彭师祖=Bành sư tổ
彭某=Bành mỗ
彭母=Bành mẫu
彭爷=Bành gia
彭老七=Bành lão thất
彭老怪=Bành lão quái
彭老鬼=Bành lão quỷ
彭门主=Bành môn chủ
彻儿=Triệt nhi
徐二公子=Từ nhị công tử
徐伯=Từ bá
徐儿=Từ nhi
徐兄弟=Từ huynh đệ
徐副门主=Từ phó môn chủ
徐千总=Từ Thiên tổng/Từ thiên tổng
徐叔=Từ thúc
徐哥=Từ ca
徐城主=Từ thành chủ
徐大叔=Từ đại thúc
徐大哥=Từ đại ca
徐夷=Từ di
徐妹=Từ muội
徐姐=Từ tỷ
徐姨=Từ di
徐嫂=Từ tẩu
徐家=Từ gia
徐家汇=Từ gia hối
徐家的人=người của Từ gia
徐少主=Từ thiếu chủ
徐师爷=Từ sư gia
徐师祖=Từ sư tổ
徐弟=Từ đệ
徐总=Từ tổng
徐母=Từ mẫu
徐爷=Từ gia
徐管家=Từ quản gia
徐老儿=Từ lão nhi
徐老六=Từ lão lục
徐老板=Từ lão bản
徐老爷=Từ lão gia
徐老爷子=Từ lão gia tử
徐老鬼=Từ lão quỷ
徐门主=Từ môn chủ
御主=ngự chủ/Master
御家=Ngự gia
微微姐=Vi Vi tỷ
德哥=Đức ca/Đức Ca
心儿=trái tim/Tâm nhi
忠儿=Trung nhi
忠叔=Trung thúc
忠哥=Trung ca
念儿=Niệm nhi
念家=Niệm gia
怒家=Nộ gia
思哥=Tư ca
思雅姐=Tư Nhã tỷ
怡妹=Di muội
怡姐=Di tỷ
性哥=Lý ca
性妹=Lý muội
性姐=Lý tỷ
性家=Lý gia
性弟=Lý đệ
性爷=Lý gia
性老=Lý lão
总书记=tổng bí thư/Tổng thư ký/tổng thư ký
总兵=tổng binh/thống lĩnh quân đội/thống soái/nguyên soái/Tổng binh
总参谋长=tổng tham mưu trưởng/Tổng tham mưu trưởng
总司令=Tổng tư lệnh/tổng tư lệnh
总堂=Tổng đường/tổng đường
总旗=tổng kỳ/Tổng Kỳ
总理=thủ tướng/tổng lý/giám đốc/người phụ trách/quản lý chung/quản lý toàn bộ/Thủ tướng
总监=tổng thanh tra/tổng giám/Tổng giám
总督=Tổng đốc/quan tổng đốc/toàn quyền/thống đốc
总督府=phủ tổng đốc/Tổng đốc phủ
总经理=giám đốc/tổng giám đốc/Tổng kinh lý
总统=tổng thống/Tổng thống
总统府=Phủ tổng thống/phủ Tổng thống
总舵主=Tổng đà chủ
恒哥=Hằng ca
悲剧片=phim bi kịch/Bi kịch, phim kết thúc không có hậu
惜儿=Tích nhi
愁儿=Sầu nhi
慈母=Từ mẫu
慕云家=Mộ Vân gia
慕伯=Mộ bá
慕儿=Mộ nhi
慕叔=Mộ thúc
慕哥=Mộ ca
慕城主=Mộ thành chủ
慕妹=Mộ muội
慕姐=Mộ tỷ
慕姨=Mộ di
慕嫂=Mộ tẩu
慕容伯=Mộ Dung bá
慕容先生=Mộ Dung tiên sinh
慕容公子=Mộ Dung công tử
慕容哥=Mộ Dung ca
慕容妹=Mộ Dung muội
慕容姐=Mộ Dung tỷ
慕容家=Mộ Dung gia
慕容老=Mộ Dung lão/Mộ Dung Lão
慕容老爷=Mộ Dung lão gia
慕少主=Mộ thiếu chủ
慕师叔=Mộ sư thúc
慕弟=Mộ đệ
慕总=Mộ tổng
慕某=Mộ mỗ
慕母=Mộ mẫu
慕老=Mộ lão
慕老怪=Mộ lão quái
慕老鬼=Mộ lão quỷ
慕门主=Mộ môn chủ
慧姐=Tuệ tỷ
憨哥=Hàm ca
戈家=Qua gia
戈某=Qua mỗ
戈门主=Qua môn chủ
成伯=Thành bá
成儿=Thành nhi
成副门主=Thành phó môn chủ
成叔=Thành thúc
成哥=Thành ca
成城主=Thành thành chủ
成妹=Thành muội
成姨=Thành di
成姨太=Thành di thái
成嫂=Thành tẩu
成家=thành gia/lập gia đình/thành gia thất/cưới vợ/thành trùm/trở thành chuyên gia/thành người lão luyện/thành danh/Thành gia
成少主=Thành thiếu chủ
成师叔=Thành sư thúc
成师祖=Thành sư tổ
成弟=Thành đệ
成某=thành nào đó/Thành mỗ
成母=Thành mẫu
成爷=Thành gia
成老怪=Thành lão quái
成老鬼=Thành lão quỷ
成门主=Thành môn chủ
我三哥=Tam ca của ta
我们林家=Lâm gia chúng ta
我们梅家=Mai gia chúng ta
我们白家=Bạch gia chúng ta
我们程家=Trình gia chúng ta
我们萧家=Tiêu gia chúng ta
我们谢家=Tạ gia chúng ta
我少主=Thiếu chủ của ta
我萧家=Tiêu gia ta
战列舰=chiến hạm/tàu chiến đấu/chiến đấu hạm/tàu chủ lực/Thiết giáp hạm
战家=Chiến gia
戚伯=Thích bá
戚儿=Thích nhi
戚叔=Thích thúc
戚哥=Thích ca
戚城主=Thích thành chủ
戚妹=Thích muội
戚姐=Thích tỷ
戚姨=Thích di
戚家=Thích gia
戚家军=Thích gia quân
戚家庄=Thích gia trang
戚小姐=Thích tiểu thư
戚师叔=Thích sư thúc
戚师弟=Thích sư đệ/Thích  sư đệ
戚师祖=Thích sư tổ
戚某=Thích mỗ
戚母=Thích mẫu
戚爷=Thích gia
戚老=Thích lão
戚老怪=Thích lão quái
戚老鬼=Thích lão quỷ
房某=Phòng mỗ
打马家=đánh Mã gia
执法长老=Chấp pháp trưởng lão
扬哥=Dương ca
扬家=Dương gia
扬老=Dương lão
找加=Hoa gia
折城主=Chiết thành chủ
折家军=Chiết gia quân
拓跋家=Thác Bạt gia
按问=thẩm vấn/Xét hỏi/khảo tra. ◇Khang Biền 康駢: Nhân tỉ di ngục phủ trung án vấn 因俾移獄府中按問
推介=quảng bá/giới thiệu/Giới thiệu
敏姐=Mẫn tỷ
救世主=chúa cứu thế/cứu thế chủ/Chúa cứu thế
敖爷=Ngao gia
敬家=Kính gia
文伯=Văn bá
文儿=Văn nhi
文叔=Văn thúc
文哥=Văn ca
文城主=Văn thành chủ
文妹=Văn muội
文姐=Văn tỷ
文姨=Văn di
文嫂=Văn tẩu
文少主=Văn thiếu chủ
文师叔=Văn sư thúc
文弟=Văn đệ
文某=Văn mỗ
文母=Văn mẫu
文爷=Văn gia
文老=Văn lão
文老七=Văn lão thất
文老怪=Văn lão quái
文老鬼=Văn lão quỷ
文门主=Văn môn chủ
斐家=Phỉ gia
斑老=Ban lão
斯家=Tư gia
斯师叔=Tư sư thúc
方伯=Phương bá
方侯爷=Phương hầu gia
方儿=Phương nhi
方千总=Phương Thiên tổng/Phương thiên tổng
方叔=Phương thúc
方大人=Phương đại nhân
方妹=Phương muội
方姐=Phương tỷ
方姨=Phương di
方嫂=Phương tẩu
方家=Phương gia/bậc thầy/chuyên gia có cỡ/người chuyên sâu/người thành thạo
方家的人=người của Phương gia
方少主=Phương thiếu chủ
方师叔=Phương sư thúc
方师祖=Phương sư tổ
方弟=Phương đệ
方总=Phương tổng
方某=Phương mỗ
方母=Phương mẫu
方爷=Phương gia
方老=Phương lão
方老七=Phương lão thất
方老六=Phương lão lục
方老怪=Phương lão quái
方老爷=Phương lão gia
方老鬼=Phương lão quỷ
方舵主=Phương Đà chủ
方长垩老=Phương trưởng lão
方门主=Phương môn chủ
施副门主=Thi phó môn chủ
施城主=Thi thành chủ
施家=Thi gia
施少主=Thi thiếu chủ
施师叔=Thi sư thúc
施母=Thi mẫu
施门主=Thi môn chủ
族弟=tộc đệ/Em họ.
无所不至=bằng mọi cách/CHÍ/không trừ một nơi nào/bằng mọi cách/không từ bất cứ việc gì
早班=đi làm sớm/ca sáng/Ca sớm
旬家=Tuần gia
旭儿=Húc nhi
旺哥=Vượng ca
昆哥=Côn ca
昊儿=Hạo nhi
昊叔=Hạo thúc
昌哥=Xương ca
明儿=đến mai/Minh Nhi/ngày mai/mai đây/mai sau/tương lai/Minh nhi
明哥=Minh ca
明大哥=Minh đại ca
明家=Minh gia
明某=Minh mỗ
易哥=Dịch ca
易城主=Dịch thành chủ
易堂主=Dịch đường chủ
易妹=Dịch muội
易姐=Dịch tỷ
易姨=Dịch di
易少主=Dịch thiếu chủ
易师伯=Dịch sư bá
易师叔=Dịch sư thúc
易师爷=Dịch sư gia
易师祖=Dịch sư tổ
易弟=Dịch đệ
易某=Dịch mỗ
易母=Dịch mẫu
易爷=Dịch gia
易老=Dịch lão/dễ già
易老怪=Dịch lão quái
易老鬼=Dịch lão quỷ
易门主=Dịch môn chủ
昕姐=Hân tỷ
星主=Tinh chủ
星儿=Tinh nhi
星哥=Tinh ca
星弟=Tinh đệ
星爷=Tinh gia
春儿=Xuân nhi
春姐=Xuân tỷ
春姨=Xuân di
是连家=là Liên gia
晁伯=Triều bá
晁儿=Triều nhi
晁叔=Triều thúc
晁哥=Triều ca
晁家=Triều gia
晁家庄=Triều gia trang
晁某=Triều mỗ
晁爷=Triều gia
晁老=Triều lão
晁老怪=Triều lão quái
晁老鬼=Triều lão quỷ
晁门主=Triều môn chủ
晋儿=Tấn nhi
晏儿=Yến nhi
晏叔=Yến thúc
晏哥=Yến ca
晏城主=Yến thành chủ
晏姐=Yến tỷ
晏姨=Yến di
晏家=Yến gia
晏师叔=Yến sư thúc
晏师祖=Yến sư tổ
晏某=Yến mỗ
晏母=Yến mẫu
晏爷=Yến gia
晏老=Yến lão
晏老七=Yến lão thất
晏门主=Yến môn chủ
晨哥=Thần ca
晨家=Thần gia
景儿=Cảnh nhi
景家=Cảnh gia
晴儿=Tình nhi/Tinh nhi
晴姐=Tình tỷ
智老=Trí lão
暴哥=Bạo ca
暴总=Bạo tổng
暴死=nổ chết/chết bạo/Chết thình lình/bị bệnh chết đột ngột.. ◇Sơ khắc phách án kinh kì 初刻拍案驚奇: Kì gia đãn tri vi bạo tử/bất tri kì cố 其家但知為暴死/不知其故
曦儿=Hi nhi
曲总=Khúc tổng
曲长老=Khúc trưởng lão
曹哥=Tào ca
曹城主=Tào thành chủ
曹大哥=Tào đại ca
曹家=Tào gia
曹少主=Tào thiếu chủ
曹总=Tào tổng
曹某=Tào mỗ
曹老大=Tào lão đại
曹老怪=Tào lão quái
曹老鬼=Tào lão quỷ
曹门主=Tào môn chủ
曾姐=Tăng tỷ
曾家=Tăng gia
曾母暗沙=bãi cạn James/Tằng mẫu ám sa
曾老=Tăng lão
月姐=Nguyệt tỷ
月姨=Nguyệt di
月嫂=điều dưỡng/bà mẫu/hộ lý/chị Nguyệt/người phụ nữ được thuê để chăm sóc một đứa trẻ mới sinh và mẹ của nó trong tháng sau khi sinh con
月家=Nguyệt gia
月老=Nguyệt lão/nguyệt lão/ông tơ
月门主=Nguyệt môn chủ
有云姨=có Vân di
有水哥=có Thủy ca
朋儿=Bằng nhi
服部家=nhà Hattori/phục vụ gia đình
朗姆酒=rượu Rum/lãng mỗ tửu
木伯=Mộc bá
木儿=Mộc nhi/Mộc Nhi
木兄弟=Mộc huynh đệ
木叔=Mộc thúc
木哥=Mộc ca
木城主=Mộc thành chủ
木妹=Mộc muội
木姊姊=Mộc tỷ tỷ
木姐=Mộc tỷ
木姨=Mộc di
木嫂=Mộc tẩu
木家=Mộc gia
木少主=Mộc thiếu chủ
木岛主=Mộc đảo chủ
木师叔=Mộc sư thúc
木师祖=Mộc sư tổ
木弟=Mộc đệ
木某=Mộc mỗ
木母=Mộc mẫu
木爷=Mộc gia
木老=Mộc lão
木老怪=Mộc lão quái
木老鬼=Mộc lão quỷ
未来主义=chủ nghĩa vị lai/chủ nghĩa tương lai/Chủ nghĩa vị lai
本令主=bổn lệnh chủ/bản lệnh chủ/Bổn lệnh chủ
本家=bản gia/bổn gia/người trong tộc/người họ nội/Bổn gia
本少主=Bổn thiếu chủ/bản thiểu chủ/Bổn thiểu chủ
本生=bản sinh/Cha mẹ sinh ra mình.Chỉ đích thân 嫡親/tức là dòng chính trong gia tộc. ◇Trần Khang Kì 陳康祺: Diễn Thánh Công chi bổn sanh bào tỉ khả phối công chi tử/ngô vi môi 衍聖公之本生胞姊可配公之子/吾為媒
本门主=Bổn môn chủ/bản môn chủ
朱五叔=Chu ngũ thúc
朱伯=Chu bá
朱儿=Chu nhi
朱先生=Chu tiên sinh
朱副门主=Chu phó môn chủ
朱千总=Chu Thiên tổng/Chu thiên tổng
朱叔=Chu thúc
朱哥=Chu ca
朱城主=Chu thành chủ
朱大人=Chu đại nhân
朱大叔=Chu đại thúc
朱妹=Chu muội
朱姐=Chu tỷ
朱姨=Chu di/Chu Di
朱姨娘=Chu di nương
朱嫂=Chu tẩu
朱家=Chu gia
朱家庄=Chu gia trang
朱家村=Chu gia thôn
朱家的人=người của Chu gia
朱少主=Chu thiếu chủ
朱师伯=Chu sư bá
朱师弟=Chu sư đệ
朱师祖=Chu sư tổ
朱弟=Chu đệ
朱总=Chu tổng
朱母=Chu mẫu
朱爷=Chu gia
朱老=Chu lão
朱老七=Chu lão thất
朱老八=Chu lão bát
朱老六=Chu lão lục
朱老四=Chu lão tứ
朱老怪=Chu lão quái
朱老板=Chu lão bản
朱老鬼=Chu lão quỷ
朴家=Phác gia
杂家=tạp gia/học phái Tạp Gia/người có kiến thức rộng
权伯=Quyền bá
权儿=Quyền nhi
权千总=Quyền Thiên tổng/Quyền thiên tổng
权哥=Quyền ca
权姐=Quyền tỷ
权姨=Quyền di
权家=Quyền gia
权少主=Quyền thiếu chủ
权师叔=Quyền sư thúc
权弟=Quyền đệ
权某=Quyền mỗ
权母=Quyền mẫu
权爷=Quyền gia
权老=Quyền lão
杉姐=Sam tỷ
李伯=Lý bá
李儿=Lý nhi
李兄弟=Lý huynh đệ
李副门主=Lý phó môn chủ
李千总=Lý Thiên tổng/Lý thiên tổng
李哥=Lý ca/Lí ca
李城主=Lý thành chủ
李堂主=Lý đường chủ
李大公子=Lý đại công tử
李妹=Lý muội
李姐=Lý tỷ
李姨=Lý di
李嫂=Lý tẩu
李家=Lý gia
李家庄=Lý gia trang
李家村=Lý gia thôn
李少主=Lý thiếu chủ
李师伯=Lý sư bá
李师祖=Lý sư tổ
李弟=Lý đệ
李总管=Lý tổng quản
李母=Lý mẫu
李相爷=Lý tướng gia
李管家=Lý quản gia
李老七=Lý lão thất
李老九=Lý lão cửu
李老儿=Lý lão nhi
李老八=Lý lão bát
李老六=Lý lão lục
李老怪=Lý lão quái
李老鬼=Lý lão quỷ
李香主=Lý hương chủ
杜千总=Đỗ Thiên tổng/Đỗ thiên tổng
杨主事=Dương chủ sự
杨伯=Dương bá
杨儿=Dương nhi
杨副门主=Dương phó môn chủ
杨千总=Dương Thiên tổng/Dương thiên tổng
杨城主=Dương thành chủ
杨大爷=Dương đại gia
杨妹=Dương muội
杨姐=Dương tỷ
杨姐姐=Dương tỷ tỷ
杨姨=Dương di
杨嫂=Dương tẩu
杨家=Dương gia
杨家庄=Dương gia trang
杨家村=Dương gia thôn
杨家枪=Dương gia thương
杨家的人=Dương gia người/người của Dương gia
杨少主=Dương thiếu chủ
杨师叔=Dương sư thúc
杨师弟=Dương sư đệ
杨师祖=Dương sư tổ
杨帮主=Dương bang chủ
杨弟=Dương đệ
杨总=Dương tổng
杨总有=Dương tổng có
杨总管=Dương tổng quản
杨某=Dương mỗ
杨母=Dương mẫu
杨爷=Dương gia
杨老=Dương lão
杨老七=Dương lão thất
杨老儿=Dương lão nhi
杨老八=Dương lão bát
杨老六=Dương lão lục
杨老怪=Dương lão quái
杨老爷=Dương lão gia
杨老鬼=Dương lão quỷ
杨门主=Dương môn chủ
杰儿=Kiệt nhi
松儿=Tùng nhi
松哥=Tùng ca
松老=Tùng lão
极儿=Cực nhi
林世妹=Lâm thế muội
林兄弟=Lâm huynh đệ
林先生=Lâm tiên sinh
林副门主=Lâm phó môn chủ
林千总=Lâm Thiên tổng/Lâm thiên tổng
林叔=Lâm thúc
林哥=Lâm ca
林城主=Lâm thành chủ
林妹=Lâm muội
林妹妹=Lâm muội muội
林姐=Lâm tỷ
林姐姐=Lâm tỷ tỷ
林嫂=Lâm tẩu
林家的人=người của Lâm gia
林峒主=Lâm động chủ
林师伯=Lâm sư bá
林师叔=Lâm sư thúc
林师祖=Lâm sư tổ
林弟=Lâm đệ
林总=Lâm tổng
林某=Lâm mỗ
林母=Lâm mẫu
林爷=Lâm gia
林老=Lâm lão
林老七=Lâm lão thất
林老六=Lâm lão lục
林老怪=Lâm lão quái
林老鬼=Lâm lão quỷ
林门主=Lâm môn chủ
果儿=Quả nhi/trứng gà
枫儿=Phong nhi
枫家=Phong gia
枫少主=Phong thiếu chủ
枭家=Kiêu gia
柏家=Bách gia
柏少主=Bách thiếu chủ
柏师叔=Bách sư thúc
柔姐=Nhu tỷ
查家=Tra gia
查某=Tra mỗ
柯伯=Kha bá
柯儿=Kha nhi
柯副门主=Kha phó môn chủ
柯千总=Kha Thiên tổng/Kha thiên tổng
柯叔=Kha thúc
柯哥=Kha ca
柯城主=Kha thành chủ
柯大哥=Kha đại ca
柯大爷=Kha đại gia
柯姐=Kha tỷ
柯姨=Kha di
柯家=Kha gia
柯少主=Kha thiếu chủ
柯师叔=Kha sư thúc
柯师弟=Kha sư đệ
柯师祖=Kha sư tổ
柯弟=Kha đệ
柯某=Kha mỗ
柯母=Kha mẫu
柯爷=Kha gia
柯老=Kha lão
柯老七=Kha lão thất
柯老怪=Kha lão quái
柯老爷子=Kha lão gia tử
柯门主=Kha môn chủ
柱子哥=Trụ Tử ca
柳伯=Liễu bá
柳先生=Liễu tiên sinh
柳副门主=Liễu phó môn chủ
柳千总=Liễu Thiên tổng/Liễu thiên tổng
柳妹=Liễu muội
柳姐=Liễu tỷ
柳姨=Liễu di
柳子=cây khởi liễu/làn điệu chủ yếu trong Liễu kịch
柳家=Liễu gia
柳家的人=người của Liễu gia
柳少主=Liễu thiếu chủ
柳师祖=Liễu sư tổ
柳弟=Liễu đệ
柳爷=Liễu gia
柳生家=Yagyū gia tộc
柳老=Liễu lão
柳老七=Liễu lão thất
柳老八=Liễu lão bát
柳老六=Liễu lão lục
柳老怪=Liễu lão quái
柳老爷子=Liễu lão gia tử
柳老鬼=Liễu lão quỷ
柳门主=Liễu môn chủ
柴城主=Sài thành chủ
柴少主=Sài thiếu chủ
柴师叔=Sài sư thúc
柴老怪=Sài lão quái
柴老鬼=Sài lão quỷ
标哥=Tiêu ca
根叔=Căn thúc
格家=Cách gia
格老=Cách lão
格老子=Cách lão tử
栾主簿=Loan chủ bộ
栾叔=Loan thúc
栾家=Loan gia
栾某=Loan mỗ
桂兄弟=Quế huynh đệ
桂大哥=Quế đại ca
桂家=Quế gia
桂老鬼=Quế lão quỷ
桑儿=Tang nhi
桑某=Tang mỗ
桓儿=Hoàn nhi
梁伯=Lương bá
梁儿=Lương nhi
梁先生=Lương tiên sinh
梁叔=Lương thúc
梁哥=Lương ca
梁姐=Lương tỷ
梁姨=Lương di
梁嫂=Lương tẩu
梁小姐=Lương tiểu thư
梁少主=Lương thiếu chủ
梁师叔=Lương sư thúc
梁师弟=Lương sư đệ
梁师爷=Lương sư gia
梁弟=Lương đệ
梁总=Lương tổng
梁某=Lương mỗ
梁母=Lương mẫu
梁爷=Lương gia
梁老=Lương lão
梁老六=Lương lão lục
梁老怪=Lương lão quái
梁老板=Lương lão bản
梁老鬼=Lương lão quỷ
梅伯=Mai bá
梅副门主=Mai phó môn chủ
梅哥=Mai ca
梅城主=Mai thành chủ
梅大哥=Mai đại ca
梅妹=Mai muội
梅姐=Mai tỷ
梅嫂=Mai tẩu
梅少主=Mai thiếu chủ
梅师叔=Mai sư thúc
梅帮主=Mai bang chủ
梅弟=Mai đệ
梅总=Mai tổng
梅某=Mai mỗ
梅母=Mai mẫu
梅爷=Mai gia
梅老=Mai lão/lão Mai
梅老七=Mai lão thất
梅老八=Mai lão bát
梅老怪=Mai lão quái
梅老鬼=Mai lão quỷ
梅门主=Mai môn chủ
梦城主=Mộng thành chủ
梦姐=Mộng tỷ
梦家=Mộng gia
梦少主=Mộng thiếu chủ
梦师叔=Mộng sư thúc
梦总=Mộng tổng
梦门主=Mộng môn chủ
棉姐=Miên tỷ
森老=Sâm lão
楚伯=Sở bá
楚儿=Sở nhi
楚千总=Sở Thiên tổng/Sở thiên tổng
楚叔=Sở thúc
楚哥=Sở ca
楚妹=Sở muội
楚姐=Sở tỷ
楚姨=Sở di
楚婶儿=Sở thẩm nhi
楚嫂=Sở tẩu
楚少主=Sở thiếu chủ
楚师叔=Sở sư thúc
楚师祖=Sở sư tổ
楚弟=Sở đệ
楚总=Sở tổng
楚某=Sở mỗ
楚母=Sở mẫu
楚爷=Sở gia
楚老=Sở lão
楚老八=Sở lão bát
楚老怪=Sở lão quái
楚老鬼=Sở lão quỷ
楚门主=Sở môn chủ
楚霸王=Sở bá vương
楠哥=Nam ca
楷体=chữ Khải/mẫu chữ in
榆木脑袋=đầu gỗ/đầu du mộc/Cây du chuyên dùng để bó củi/chế tạo gia cụ/cực kỳ dẻo dai cứng cỏi/để nói người ngoan cố/không chịu thông suốt.
樊大哥=Phiền đại ca
樊姐=Phàn tỷ
樊少主=Phiền thiếu chủ
樊师叔=Phiền sư thúc
樊老=Phàn lão
樊老怪=Phiền lão quái
樊老鬼=Phiền lão quỷ
樊门主=Phiền môn chủ
樱儿=Anh nhi
欢儿=Hoan nhi
欢哥=Hoan Ca/Hoan ca
欣姐=Hân tỷ
欧阳伯=Âu Dương bá
欧阳先生=Âu Dương tiên sinh
欧阳公子=Âu Dương công tử
欧阳叔=Âu Dương thúc
欧阳哥=Âu Dương ca
欧阳大哥=Âu Dương đại ca
欧阳姐=Âu Dương tỷ
正儿=Chính nhi/chính nhi
正气歌=chính khí ca/Chính Khí ca
步城主=Bộ thành chủ
步家=Bộ gia
步老鬼=Bộ lão quỷ
步门主=Bộ môn chủ
武伯=Vũ bá
武儿=Vũ nhi
武兄弟=Vũ huynh đệ
武公子=Vũ công tử
武副门主=Vũ phó môn chủ
武叔=Vũ thúc
武哥=Vũ ca
武哥哥=Vũ ca ca
武妹=Vũ muội
武姐=Vũ tỷ
武姨=Vũ di
武家=Vũ gia
武少主=Vũ thiếu chủ
武少爷=Vũ thiếu gia
武庄主=Vũ trang chủ
武弟=Vũ đệ
武某=Vũ mỗ
武母=Vũ mẫu
武氏兄弟=Vũ thị huynh đệ
武爷=Vũ gia
武老=Võ lão/Vũ lão
武老二=Vũ lão nhị
武老八=Vũ lão bát
武老大=Vũ lão đại
武老怪=Vũ lão quái
武老鬼=Vũ lão quỷ
武警总部=Vũ Cảnh tổng bộ/tổng bộ cảnh sát vũ trang
武门主=Vũ môn chủ
段千总=Đoàn Thiên tổng/Đoàn thiên tổng
殷六侠=Ân lục hiệp
殷千总=Ân Thiên tổng/Ân thiên tổng
毅儿=Nghị nhi
毅叔=Nghị thúc
比箭家=so Tiễn gia
毕伯=Tất bá
毕儿=Tất nhi
毕叔=Tất thúc
毕哥=Tất ca
毕城主=Tất thành chủ
毕大爷=Tất đại gia
毕妹=Tất muội
毕姐=Tất tỷ
毕家=Tất gia
毕少主=Tất thiếu chủ
毕师祖=Tất sư tổ
毕某=Tất mỗ
毕母=Tất mẫu
毕爷=Tất gia
毕老=Tất lão
毕老八=Tất lão bát
毕老六=Tất lão lục
毕老怪=Tất lão quái
毕老鬼=Tất lão quỷ
毛伯=Mao bá
毛儿=Mao nhi
毛叔=Mao thúc
毛哥=Mao ca
毛城主=Mao thành chủ
毛妹=Mao muội
毛妹妹=Mao muội muội
毛姐=Mao tỷ
毛姨=Mao di
毛嫂=Mao tẩu
毛家=Mao gia
毛小妹=Mao tiểu muội
毛少主=Mao thiếu chủ
毛师叔=Mao sư thúc
毛弟=Mao đệ
毛母=Mao mẫu
毛爷=Mao gia
毛老=Mao lão
毛老六=Mao lão lục
毛老怪=Mao lão quái
毛门主=Mao môn chủ
民族主义=dân tộc chủ nghĩa/chủ nghĩa dân tộc/một bộ phận của chủ nghĩa Tam dân
水伯=Thủy bá
水儿=Thủy nhi
水哥=Thủy ca
水姨=Thủy di
水家=Thủy gia
水爷=Thủy gia gia
水老=Thủy lão
水老鬼=Thủy lão quỷ
求名=cầu danh/Truy cầu tiếng tốt. ◇Nhan thị gia huấn 顏氏家訓: Vong danh giả/thể đạo hợp đức/hưởng quỷ thần chi phúc hựu/phi sở dĩ cầu danh dã 忘名者/體道合德/享鬼神之福祐/非所以求名也
汉主=Hán chủ/vua nhà Hán
汉家=Hán gia/nhà Hán
江主播=Giang chủ bá
江伯=Giang bá
江儿=Giang nhi
江副门主=Giang phó môn chủ
江千总=Giang Thiên tổng/Giang thiên tổng
江叔=Giang thúc
江哥=Giang ca
江妹=Giang muội
江姐=Giang tỷ
江姨=Giang di
江嫂=Giang tẩu
江少主=Giang thiếu chủ
江师叔=Giang sư thúc
江弟=Giang đệ
江总=chủ tịch Giang/Giang tổng
江母=Giang mẫu
江爷=Giang gia
江老六=Giang lão lục
江老怪=Giang lão quái
江老鬼=Giang lão quỷ
池世妹=Trì thế muội
池妹=Trì muội
池姐=Trì tỷ
池家=Trì gia
池总=chủ tịch Trì/tổng hồ bơi
池某=Trì mỗ
池皇主=Trì hoàng chủ
汤老爷=Thang lão gia
汪伯=Uông bá
汪儿=Uông nhi
汪先生=Uông tiên sinh
汪副门主=Uông phó môn chủ
汪千总=Uông Thiên tổng/Uông thiên tổng
汪叔=Uông thúc
汪哥=Uông ca
汪城主=Uông thành chủ
汪大人=Uông đại nhân
汪大哥=Uông đại ca
汪妹=Uông muội
汪姐=Uông tỷ
汪嫂=Uông tẩu
汪家=Uông gia
汪小姐=Uông tiểu thư
汪少主=Uông thiếu chủ
汪师叔=Uông sư thúc
汪师祖=Uông sư tổ
汪母=Uông mẫu
汪爷=Uông gia
汪老=Uông lão
汪老怪=Uông lão quái
汪老板=Uông lão bản
汪老鬼=Uông lão quỷ
汪门主=Uông môn chủ
沈三叔=Thẩm tam thúc
沈伯=Thẩm bá
沈儿=Thẩm nhi
沈副门主=Thẩm phó môn chủ
沈千总=Thẩm thiên tổng
沈叔=Thẩm thúc/Thẩm thúc
沈哥=Thẩm ca/Thẩm ca
沈大人=Thẩm đại nhân
沈妹=Thẩm muội/Thẩm muội
沈姨=Thẩm di/Thẩm di
沈嫂=Thẩm tẩu/Thẩm tẩu
沈家的人=người của Thẩm gia
沈少主=Thẩm thiếu chủ
沈师叔=Thẩm sư thúc
沈师祖=Thẩm sư tổ
沈弟=Thẩm đệ/Thẩm đệ
沈总=Thẩm tổng
沈母=Thẩm mẫu
沈老=Thẩm lão
沈老七=Thẩm lão thất
沈老六=Thẩm lão lục
沈老师=Thẩm lão sư
沈老怪=Thẩm lão quái
沈老鬼=Thẩm lão quỷ
沈门主=Thẩm môn chủ
沐家=Mộc gia
沙家=Sa gia
沙寨主=Sa trại chủ
没出息=không có tiền đồ/Không tiến lên/chẳng nên thân/vô hi vọng/không ra gì. ◇Hồng Lâu Mộng 紅樓夢: Giá khả hựu thị hồ thuyết/tựu toán nhĩ thị cá một xuất tức đích/chung lão tại giá lí/nan đạo tha tỉ muội môn đô bất xuất môn đích 這可又是胡說/就算你是個沒出息的/終老在這裡/難道他姊妹們都不出門的
没毛儿=không Mao nhi
没疯哥=không Phong ca
没花姐=không Hoa tỷ
沫儿=Mạt nhi
泉儿=Tuyền nhi
法西斯=phát xít/chủ nghĩa phát xít/Phát xít
波儿=Ba nhi
波霸=sóng bá/Boba/Ba Bá/quả bóng khoai mì, trong 波霸 奶茶 [bo1 ba4 nai3 cha2]
洁儿=Khiết nhi
洛伯=Lạc bá
洛儿=Lạc nhi
洛千总=Lạc Thiên tổng/Lạc thiên tổng
洛叔=Lạc thúc
洛哥=Lạc ca
洛妹=Lạc muội
洛姐=Lạc tỷ
洛姨=Lạc di
洛嫂=Lạc tẩu
洛少主=Lạc thiếu chủ
洛师叔=Lạc sư thúc
洛师祖=Lạc sư tổ
洛弟=Lạc đệ
洛某=Lạc mỗ
洛母=Lạc mẫu
洛爷=Lạc gia
洛老=Lạc lão
洛老怪=Lạc lão quái
洛老鬼=Lạc lão quỷ
洛门主=Lạc môn chủ
洪世伯=Hồng thế bá
洪伯=Hồng bá
洪儿=Hồng nhi
洪千总=Hồng Thiên tổng/Hồng thiên tổng
洪叔=Hồng thúc
洪哥=Hồng ca
洪城主=Hồng thành chủ
洪妹=Hồng muội
洪姐=Hồng tỷ
洪姨=Hồng di
洪嫂=Hồng tẩu
洪少主=Hồng thiếu chủ
洪师叔=Hồng sư thúc
洪帮主=Hồng bang chủ
洪弟=Hồng đệ
洪总=Hồng tổng
洪某=Hồng mỗ
洪母=Hồng mẫu
洪爷=Hồng gia
洪老=Hồng lão
洪老七=Hồng lão thất
洪老儿=Hồng lão nhi
洪老六=Hồng lão lục
洪老怪=Hồng lão quái
洪老爷=Hồng lão gia
洪老鬼=Hồng lão quỷ
流儿=Lưu nhi
浅家=Thiển gia
浪爷=Lãng gia
浮丘伯=Phù Khưu bá
海伯=Hải bá
海关总署=tổng cục hải quan/Tổng cục Hải quan/Tổng cục hải quan
海叔=Hải thúc
海嫂=Hải tẩu
海家=Hải gia
海少主=Hải thiếu chủ
海师伯=Hải sư bá
海师叔=Hải sư thúc
海总=Hải tổng
海某=Hải mỗ
海老公=Hải lão công
海老怪=Hải lão quái
海老鬼=Hải lão quỷ
淑儿=Thục nhi
清哥=Thanh ca
清姐=Thanh tỷ
清家=Thanh gia
渊儿=Uyên nhi
港商=thương nhân Hồng Kông/cảng thương/thương gia Hồng Kông
湄儿=Mi nhi
湛家=Trạm gia
源哥=Nguyên ca
漆家=Tất gia
漱儿=Thấu nhi
潘伯=Phan bá
潘儿=Phan nhi
潘先生=Phan tiên sinh
潘千总=Phan Thiên tổng/Phan thiên tổng
潘叔=Phan thúc
潘哥=Phan ca
潘大人=Phan đại nhân
潘姐=Phan tỷ
潘姨=Phan di
潘嫂=Phan tẩu
潘师叔=Phan sư thúc
潘某=Phan mỗ
潘母=Phan mẫu
潘爷=Phan gia
潘老=Phan lão
潘老六=Phan lão lục
潘老怪=Phan lão quái
潘老鬼=Phan lão quỷ
潘门主=Phan môn chủ
澄儿=Trừng nhi
澜儿=Lan nhi
澜妹=Lan muội
澜姐=Lan tỷ
濮姐=Bộc tỷ
濮家=Bộc gia
灞桥=bá cầu/Cầu Thước/Baqiao District of Xi’an 西安市 [Xi1 an1 Shi4], Thiểm Tây
火云家=Hỏa Vân gia
火老=Hỏa lão
灭家=Diệt gia
灵妹=Linh muội
灵姐=Linh tỷ
灿哥=Xán ca
炮哥=Pháo ca
烈儿=Liệt nhi
烈哥=Liệt ca
烟儿=Yên nhi
烟妹=Yên muội
烟姐=Yên tỷ
焉儿=Yên nhi
焉姐=Yên tỷ
焉家=Yên gia
焚家=Phần gia
焦先生=Tiêu tiên sinh
焦城主=Tiêu thành chủ
焦姐=Tiêu tỷ
焦姨=Tiêu di
焦家=Tiêu gia
焦师叔=Tiêu sư thúc
焦帮主=Tiêu bang chủ
焦爷=Tiêu gia
焦老=Tiêu lão
焦老儿=Tiêu lão nhi
焦老怪=Tiêu lão quái
焦老鬼=Tiêu lão quỷ
然儿=Nhiên nhi
然姐=Nhiên tỷ
煊弟=Huyên đệ
熊副门主=Hùng phó môn chủ
熊千总=Hùng Thiên tổng/Hùng thiên tổng
熊城主=Hùng thành chủ
熊大人=Hùng đại nhân
熊姐=Hùng tỷ
熊少主=Hùng thiếu chủ
熊师叔=Hùng sư thúc
熊总=Hùng tổng
熊老八=Hùng lão bát
熊老六=Hùng lão lục
熊老怪=Hùng lão quái
熊老爷=Hùng lão gia
熊门主=Hùng môn chủ
熙儿=Hi nhi
燕世家=Yến thế gia
燕公子=Yến công tử
燕城主=Yến thành chủ
燕妹=Yến muội
燕姐=Yến tỷ
燕家的人=người của Yến gia
燕少主=Yến thiếu chủ
燕师叔=Yến sư thúc
燕师弟=Yến sư đệ
燕师祖=Yến sư tổ
燕老怪=Yến lão quái
燕老鬼=Yến lão quỷ
燕门主=Yến môn chủ
片尾曲=bài hát kết phim/khúc đuôi phim/Bài hát kết thúc của phim
牛伯=Ngưu bá
牛叔=Ngưu thúc
牛哥=Ngưu ca
牛家=Ngưu gia
牛家村=Ngưu gia thôn
牛某=Ngưu mỗ
牡丹=mẫu đơn/cây mẫu đơn/hoa mẫu đơn/Mẫu Đơn
牧儿=Mục nhi
物姐=Vật tỷ
狐哥=Hồ ca
狗蛋儿=cẩu đản nhi/Cẩu Đản Nhi
狮家=Sư gia
狸爷=Ly gia
狼哥=Lang ca
狼弟=Lang đệ
猛儿=Mãnh nhi
猛哥=Mãnh ca
猪哥=Trư ca/trư ca/Trư ca (bát giới)
猫儿=mèo con/Miêu nhi
猫叔=Miêu thúc
猫哥=Miêu ca
猫妹=Miêu muội
猫姐=Miêu tỷ
猫家=Miêu gia
猫弟=Miêu đệ
猫母=Miêu mẫu
猫爷=Miêu gia
猫老=Miêu lão
猴叔=Hầu thúc
猴哥=Hầu ca
玄某=Huyền mỗ
玉城主=Ngọc thành chủ
玉姊=Ngọc tỷ
玉姐=Ngọc tỷ
玉姨=Ngọc di
玉少主=Ngọc thiếu chủ
玉师叔=Ngọc sư thúc
玉师祖=Ngọc sư tổ
玉老怪=Ngọc lão quái
玉老鬼=Ngọc lão quỷ
王主簿=Vương chủ bộ
王伯=Vương bá
王儿=Vương nhi
王先生=Vương tiên sinh
王副门主=Vương phó môn chủ
王千总=Vương Thiên tổng/Vương thiên tổng
王叔=Vương thúc
王哥=Vương ca
王城主=Vương thành chủ
王大人=Vương đại nhân
王大叔=Vương đại thúc
王妹=Vương muội
王姐=Vương tỷ
王婶儿=Vương thẩm nhi
王嫂=Vương tẩu
王家=Vương gia
王家的人=người của Vương gia
王小姐=Vương tiểu thư
王少主=Vương thiếu chủ
王师叔=Vương sư thúc
王师祖=Vương sư tổ
王弟=Vương đệ
王总兵=Vương tổng binh
王总管=Vương tổng quản
王总说=Vương tổng nói
王爷=vương gia/Vương gia/đức vua
王爷府=phủ Vương gia
王狗儿=Vương cẩu nhi
王老=Vương lão
王老七=Vương lão thất
王老九=Vương lão cửu
王老五=Vương lão ngũ
王老儿=Vương lão nhi
王老六=Vương lão lục
王老太=Vương lão thái
王老师=Vương lão sư
王老怪=Vương lão quái
王老汉=Vương lão hán
王老爷=Vương lão gia
王老爷子=Vương lão gia tử
王老鬼=Vương lão quỷ
王舵主=Vương Đà chủ
王门主=Vương môn chủ
环儿=Hoàn nhi
现在的萧家=Tiêu gia bây giờ
玲妹=Linh muội
玲姐=Linh tỷ
珂儿=Kha nhi
珑姐=Lung tỷ
珠儿=Châu nhi
珠姐=Châu tỷ
班组=tổ/tổ ca/nhóm lớp/Tổ ca
珺儿=Quân nhi
琛哥=Sâm ca
琪儿=Kỳ nhi
琪妹=Kỳ muội
琳姐=Lâm tỷ
琴妈=Cầm mẫu
琴姐=Cầm tỷ
琴家=Cầm gia
琼儿=Quỳnh nhi
瑛姐=Anh tỷ
瑜姐=Du tỷ
瑞儿=Thụy nhi
瑶姐=Dao tỷ
璇妹=Tuyền muội
璇姐=Tuyền tỷ
瓦儿=Ngõa nhi
瓦总=chủ tịch Val
瓶儿=Bình nhi
甄伯=Chân bá
甄儿=Chân nhi
甄叔=Chân thúc
甄哥=Chân ca
甄城主=Chân thành chủ
甄妹=Chân muội
甄姐=Chân tỷ
甄姨=Chân di
甄少主=Chân thiếu chủ
甄少爷=Chân thiếu gia
甄师叔=Chân sư thúc
甄师弟=Chân sư đệ
甄师祖=Chân sư tổ
甄弟=Chân đệ
甄总=Chân tổng
甄某=Chân mỗ
甄母=Chân mẫu
甄爷=Chân gia
甄老=Chân lão
甄老爷=Chân lão gia
甄门主=Chân môn chủ
甘家=Cam gia
甘峰主=Cam phong chủ
甘老=Cam lão
生叔=Sinh thúc
申大人=Thân đại nhân
申家=Thân gia
界主=Giới Chủ/giới chủ
疯伯=Phong bá
疯儿=Phong nhi
疯叔=Phong thúc
疯哥=Phong ca
疯师叔=Phong sư thúc
疯某=Phong mỗ
疯母=Phong mẫu
疯爷=Phong gia
疯老=Phong lão
疯老鬼=Phong lão quỷ
痕家=Ngân gia
白主簿=Bạch chủ bộ
白伯=Bạch bá
白儿=Bạch nhi
白副门主=Bạch phó môn chủ
白千总=Bạch Thiên tổng/Bạch thiên tổng
白哥=Bạch ca
白妹=Bạch muội
白姐=Bạch tỷ
白姐姐=Bạch tỷ tỷ
白姨=Bạch di
白嫂=Bạch tẩu
白家庄=Bạch gia trang
白家的人=người của Bạch gia
白少主=Bạch thiếu chủ
白左=bạch tả/trắng trái/những người theo chủ nghĩa tự do phương Tây ngây thơ, tự cho mình là đúng
白师叔=Bạch sư thúc
白师祖=Bạch sư tổ
白弟=Bạch đệ
白总=Bạch tổng
白手成家=tay trắng làm nên/Tay trắng tự lực làm nên gia nghiệp. ☆Tương tự: bạch thủ khởi gia 白手起家.
白某=Bạch mỗ
白母=Bạch mẫu
白爷=Bạch gia
白种=người da trắng/người Cáp-ca/mặt tái
白种人=người da trắng/người Cáp-ca/mặt tái
白老=Bạch lão
白老七=Bạch lão thất
白老儿=Bạch lão nhi
白老八=Bạch lão bát
白老六=Bạch lão lục
白老怪=Bạch lão quái
白老爷子=Bạch lão gia tử
白老鬼=Bạch lão quỷ
白长老=Bạch trưởng lão
白门主=Bạch môn chủ
百家姓=bách gia tính/trăm họ Trung quốc
百年偕老=bách niên giai lão/Chúc tụng vợ chồng hòa mục trăm năm cùng già. ◇Nho lâm ngoại sử 儒林外史: Chỉ nguyện nhĩ môn phu thê bách niên giai lão/đa tử đa tôn 只願你們夫妻百年偕老/多子多孫
百总=Bách tổng
百户=Bách hộ/bách hộ/bách gia
百某=Bách mỗ
百灵=bách linh/chim sơn ca/Bách Linh
百里家=Bách Lý gia
皇族=Hoàng tộc/hoàng tộc/hoàng thất/hoàng gia
皇甫家=Hoàng Phủ gia
皮副千总=Bì phó thiên tổng
皮千总=Bì thiên tổng
皮哥=Bì ca
皮家=Bì gia
皮某=Bì mỗ
盏儿=Trản nhi
盖家=Cái gia
盛家=Thịnh gia
盛总=Thịnh tổng
盼儿=Phán nhi
盼妹=Phán muội
省长=tỉnh trưởng/chủ tịch tỉnh/Tỉnh trưởng
眉儿=Mi nhi
看天哥=xem Thiên ca
真儿=Chân nhi
真叔=Chân thúc/chân thúc
真哥=Chân ca
真姐=Chân tỷ
瞿老=Cù lão
石伯=Thạch bá
石儿=Thạch nhi
石副门主=Thạch phó môn chủ
石千总=Thạch Thiên tổng/Thạch thiên tổng
石叔=Thạch thúc
石哥=Thạch ca
石大哥=Thạch đại ca
石头哥=Thạch đầu ca
石妹=Thạch muội
石姐=Thạch tỷ
石姨=Thạch di
石嫂=Thạch tẩu
石家=Thạch gia
石家庄=Thạch gia trang
石家的人=người của Thạch gia
石少主=Thạch thiếu chủ
石师伯=Thạch sư bá
石师叔=Thạch sư thúc
石师弟=Thạch sư đệ
石师祖=Thạch sư tổ
石帮主=Thạch bang chủ
石庄主=Thạch trang chủ
石弟=Thạch đệ
石斑鱼=cá mú/cá mú/Cá mú, cá song
石某=Thạch mỗ
石母=Thạch mẫu
石爷=Thạch gia
石老=Thạch lão
石老六=Thạch lão lục
石老怪=Thạch lão quái
石老鬼=Thạch lão quỷ
碎涅老怪=Toái Niết lão quái
碟仙=điệp tiên/Điệp Tiên/hình thức bói toán tương tự như bảng Ouija, trong đó những người tham gia sử dụng ngón tay trước của họ để đẩy một chiếc đĩa nhỏ trên một tờ giấy có ghi nhiều ký tự Trung Quốc
碧师叔=Bích sư thúc
社会党=đảng xã hội/Đảng Xã hội/Đảng xã hội chủ nghĩa
祁叔=Kỳ thúc
祁家=Kỳ gia
祈老六=Kỳ lão lục
祝三哥=Chúc tam ca
祝伯=Chúc bá
祝儿=Chúc nhi
祝千总=Chúc thiên tổng
祝叔=Chúc thúc
祝哥=Chúc ca
祝城主=Chúc thành chủ
祝妹=Chúc muội
祝姐=Chúc tỷ
祝姨=Chúc di
祝嫂=Chúc tẩu
祝家=Chúc gia
祝家庄=Chúc gia trang
祝少主=Chúc thiếu chủ
祝师叔=Chúc sư thúc
祝师祖=Chúc sư tổ
祝弟=Chúc đệ
祝总=Chúc tổng
祝某=Chúc mỗ
祝母=Chúc mẫu
祝爷=Chúc gia
祝老=Chúc lão
祝老七=Chúc lão thất
祝老八=Chúc lão bát
祝老鬼=Chúc lão quỷ
神主=Thần Chủ/linh vị/bài vị/thần chủ
祥哥=Tường ca
禅儿=Thiền nhi
福哥=Phúc ca
福家=Phúc gia
禾家=Hòa gia
秀姨=dì Tú/tú di
秋伯=Thu bá
秋儿=Thu nhi
秋叔=Thu thúc
秋哥=Thu ca
秋城主=Thu thành chủ
秋姐=Thu tỷ
秋姨=Thu di
秋嫂=Thu tẩu
秋少主=Thu thiếu chủ
秋师叔=Thu sư thúc
秋师祖=Thu sư tổ
秋弟=Thu đệ
秋总=Thu tổng
秋母=Thu mẫu
秋爷=Thu gia
秋老=Thu lão
秋老七=Thu lão thất
秋老鬼=Thu lão quỷ
秋门主=Thu môn chủ
科学共产主义=chủ nghĩa Cộng Sản khoa học
科班=chính quy/đào tạo chính quy/đào tạo chuyên nghiệp/tổ chức triệu tập nhi đồng để đào tạo thành diễn viên Hí khúc/khoa ban
秦伯=Tần bá
秦儿=Tần nhi
秦副门主=Tần phó môn chủ
秦千总=Tần Thiên tổng/Tần thiên tổng
秦卿家=Tần khanh gia
秦叔=Tần thúc
秦哥=Tần ca
秦大哥=Tần đại ca
秦妹=Tần muội
秦姐=Tần tỷ
秦姨=Tần di
秦嫂=Tần tẩu
秦家庄=Tần gia trang
秦少主=Tần thiếu chủ
秦师叔=Tần sư thúc
秦师祖=Tần sư tổ
秦弟=Tần đệ
秦总=Tần tổng
秦母=Tần mẫu
秦爷=Tần gia
秦老七=Tần lão thất
秦老五=Tần lão ngũ
秦老八=Tần lão bát
秦老六=Tần lão lục
秦老怪=Tần lão quái
秦老鬼=Tần lão quỷ
秦长老=Tần trưởng lão
秦阿姨=Tần a di
程伯=Trình bá
程儿=Trình nhi
程先生=Trình tiên sinh
程千总=Trình Thiên tổng/Trình thiên tổng
程叔=Trình thúc
程哥=Trình ca
程城主=Trình thành chủ
程大哥=Trình đại ca
程妹=Trình muội
程姐=Trình tỷ
程姨=Trình di
程嫂=Trình tẩu
程少主=Trình thiếu chủ
程师叔=Trình sư thúc
程师祖=Trình sư tổ
程帮主=Trình bang chủ
程弟=Trình đệ
程母=Trình mẫu
程爷=Trình gia
程老=Trình lão
程老爷子=Trình lão gia tử
程门主=Trình môn chủ
穆城主=Mục thành chủ
穆家=Mục gia
穆少主=Mục thiếu chủ
穆师叔=Mục sư thúc
穆师祖=Mục sư tổ
穆老=Mục lão
穆老怪=Mục lão quái
穆老鬼=Mục lão quỷ
穆门主=Mục môn chủ
穷老怪=Nghèo lão quái
空哥=Không ca
窑姐=Diêu tỷ/Diêu tỷ (kỹ viện)
章叔=Chương thúc
章城主=Chương thành chủ
章少主=Chương thiếu chủ
章师叔=Chương sư thúc
章师祖=Chương sư tổ
章某=Chương mỗ
章老三=Chương lão tam
章门主=Chương môn chủ
童千总=Đồng Thiên tổng/Đồng thiên tổng
竹儿=Trúc nhi
竺儿=Trúc nhi
竺家=Trúc gia
笑爷=Tiếu gia
符家=Phù gia
符老=Phù lão
策儿=Sách nhi
筠儿=Quân nhi
筠姐=Quân tỷ
简家=Giản gia
管姨=Quản di
管家的人=người của Quản gia
箫家=Tiêu gia
箫师叔=Tiêu sư thúc
箫门主=Tiêu môn chủ
箭家=Tiễn gia
米儿=Mễ nhi
米叔=Mễ thúc
米哥=Mễ ca
米妹=Mễ muội
米姐=Mễ tỷ
米姨=Mễ di
米嫂=Mễ tẩu
米家=Mễ gia
米母=Mễ mẫu
米爷=Mễ gia
米老=Mễ lão
粟哥=Túc ca
糜家=Mi gia
系主任=chủ nhiệm khoa/trưởng khoa/Chủ nhiệm khoa
素姐=Tố tỷ
素姨=Tố di
索哥=Tác ca
紧哥=Khẩn ca
紫家=Tử gia
紫老鬼=Tử lão quỷ
結束=kết thúc/Yuitsuka
红儿=Hồng nhi/hồng nhi
红夷炮=hồng di pháo/Hồng Di Pháo
红姐=Hồng tỷ
红姨=Hồng di
纤儿=Tiêm nhi
纪伯=Kỷ bá
纪儿=Kỷ nhi
纪叔=Kỷ thúc
纪哥=Kỷ ca
纪城主=Kỷ thành chủ
纪姐=Kỷ tỷ
纪姨=Kỷ di
纪嫂=Kỷ tẩu
纪家=Kỷ gia
纪少主=Kỷ thiếu chủ
纪师叔=Kỷ sư thúc
纪某=Kỷ mỗ
纪母=Kỷ mẫu
纪爷=Kỷ gia
纪老=Kỷ lão
纪老八=Kỷ lão bát
纪门主=Kỷ môn chủ
纬哥=Vĩ ca
纯儿=Thuần nhi
纳家=Nạp gia
纵哥=Túng ca
练家=Luyện gia
绒儿=Nhung nhi
结束语=lời kết/kết thúc/Kết luận
绝霸=tuyệt bá/Tuyệt Bá
统帅=thống soái/thống suất/chỉ huy/tổng chỉ huy/điều khiển/Thống soái
绫儿=Lăng nhi
续约=gia hạn hợp đồng/Gia hạn khế ước
维哥=Duy ca
绿家=Lục gia
缙家=Tấn gia
缪家=Mâu gia
罗儿=La nhi
罗副门主=La phó môn chủ
罗千总=La Thiên tổng/La thiên tổng
罗叔=La thúc
罗哥=La ca
罗大哥=La đại ca
罗妹=La muội
罗姐=La tỷ
罗姨=La di
罗嫂=La tẩu
罗家=La gia
罗家庄=La gia trang
罗家的人=người của La gia
罗小弟=La tiểu đệ
罗少主=La thiếu chủ
罗师祖=La sư tổ
罗弟=La đệ
罗母=La mẫu
罗爷=La gia
罗王爷=La vương gia
罗老=La lão
罗老七=La lão thất
罗老六=La lão lục
罗老怪=La lão quái
罗老鬼=La lão quỷ
罗长老=La trưởng lão
罗非鱼=cá rô phi/cá rô phi/Cá rô phi
羊儿=Dương nhi
羊哥=Dương ca
羊门主=Dương môn chủ
羽儿=Vũ nhi
羽家=Vũ gia
羽某=Vũ mỗ
翎儿=Linh nhi
翔儿=Tường nhi
翔哥=Tường ca
翦家=Tiễn gia
翼儿=Dực nhi
翼哥=Dực ca
耀哥=Diệu ca
老七=lão Thất/Lão Thất
老万=lão Vạn
老三=lão tam/lão Tam
老严=lão Nghiêm
老久=lão Cửu/hồi lâu
老乔=lão Kiều
老九=lão Cửu
老乾=lão Càn
老二=lão nhị/lão Nhị
老于=lão Vu
老云=lão Vân
老五=lão Ngũ/lão ngũ
老任=lão Nhậm
老佐=lão Tá
老何=lão Hà
老余=lão Dư
老侯=lão Hầu
老侯爷=lão hầu gia/lão Hầu gia
老俞=lão Du
老候=lão Hậu
老先=lão Tiên
老八=lão Bát
老六=lão Lục/lão lục
老关=lão Quan
老兵=lão binh/lính già/lão Binh/lính cũ
老冯=lão Phùng
老冰=lão Băng
老冷=lão Lãnh
老凡=lão Phàm
老凤=lão Phượng
老刘=lão Lưu
老劫=lão Kiếp
老包=lão Bao
老华=lão Hoa
老卓=lão Trác
老卢=lão Lô
老卫=lão Vệ
老厉=lão Lệ
老古=lão Cổ
老史=lão Sử
老叶=lão Diệp
老司姬=tài xế già-chan/lão Tư Cơ
老吕=lão Lữ
老吴=lão Ngô
老吴头=lão Ngô đầu
老呆=lão Ngốc
老周=lão Chu
老咯=lão Lạc
老四=lão tứ/lão Tứ
老圆=lão Viên
老坑=lão Khanh/hố cũ
老夏=lão Hạ
老天=lão thiên/lão Thiên/ông trời
老太爷=lão thái gia/Lão thái gia/ông/quý ông/ông bên nhà/ông nhà
老妖=lão yêu/lão Yêu
老姚=lão Diêu
老姜=củ gừng/lão Khương
老姬=lão Cơ
老威=lão Uy
老娄=lão Lâu
老孔=lão Khổng
老孙=lão Tôn
老孟=lão Mạnh
老宁=lão Ninh/lão Trữ
老安=lão An
老宋=lão Tống
老封=lão Phong
老尚=lão Thượng
老尤=lão Vưu
老展=lão Triển
老岳=lão Nhạc
老崔=lão Thôi
老左=lão Tả
老席=lão Tịch
老常=lão Thường
老平=lão Bình
老庄=lão Trang
老庞=lão Bàng
老康=lão Khang
老廖=lão Liêu
老张=lão Trương
老张头=Trương lão đầu/lão Trương đầu
老归=lão Quy
老彭=lão Bành
老徐=lão Từ
老徐头=lão Từ
老慕=lão Mộ
老戚=lão Thích
老扒=lão Bái
老扬=lão Dương
老政=lão Chính
老文=lão Văn
老方=lão Phương
老时=lão Thì
老易=lão Dịch
老晏=lão Yến
老景=lão Cảnh/cảnh già/tuổi già
老曹=lão Tào
老曾=Lão Tăng/lão Tằng
老木=lão Mộc
老朱=lão Chu
老李=lão Lý
老杨=lão Dương
老查=lão Tra
老柯=lão Kha
老柳=lão Liễu
老格=lão Cách
老桑=lão Tang
老梁=lão Lương
老梅=lão Mai
老楚=lão Sở
老楼=lão Lâu
老毕=lão Tất
老毛=lão Mao
老气横秋=ông cụ non/làm ra vẻ/THU/lên mặt cụ non/già cỗi/không sôi nổi/lão khí hoành thu/lão khí hoành thu (như ông cụ non)
老汉推车=lão Hán đẩy xe
老江=lão Giang
老池=lão Trì
老汤=lão Thang/nước luộc/nước dưa cũ
老汤姆=lão Thang mỗ
老汪=lão Uông
老沈=lão Thẩm
老沙=lão Sa
老河=lão Hà
老泉=lão Tuyền
老泪=lão lệ/lão Lệ
老洛=lão Lạc
老洪=lão Hồng
老济=lão Tể
老海=lão Hải
老潘=lão Phan
老烟=lão Thuốc/lão yên
老焉=lão Yên
老熊=lão Hùng
老熊人=lão người Gấu
老燕=lão Yến
老牛=lão ngưu/bò già/trâu già/lão Ngưu
老猛=lão Mãnh
老猫=mèo già/lão Miêu
老猴=lão Khỉ
老玄=lão Huyền
老王=lão Vương
老王头=Vương lão đầu/lão Vương đầu
老王的脸=mặt của lão Vương
老甄=lão Chân
老白=lão Bạch
老皮=vỏ khô/lão Bì
老皿=lão Mãnh
老石=lão Thạch
老祝=lão Chúc
老神王=lão Thần Vương
老福=lão Phúc
老秋=lão Thu
老秦=lão Tần
老程=lão Trình
老穆=lão Mục
老穷=lão Cùng
老粟=lão Túc
老紫=lão Tử
老纪=lão Kỷ
老罗=lão La
老羊=lão Dương
老美=lão Mỹ
老耶=lão Da
老聂=lão Nhiếp
老肖=lão Tiêu/lão Tiếu
老胡=lão Hồ
老舍=lão Xá
老舒=lão Thư
老艾=lão Ngải
老花=lão Hoa
老苏=lão Tô
老苟=lão Cẩu
老若=lão Nhược
老范=lão Phạm
老药=lão Dược
老莫=lão Mạc
老萧=lão Tiêu
老落=lão Lạc
老蒋=lão Tưởng
老蔡=lão Thái
老薛=lão Tiết
老行=lão Hành
老街=phố cũ/lão nhai/Lào Cai/tỉnh Lào Cai
老袁=lão Viên
老裴=lão Bùi
老计=lão Kế
老许=lão Hứa
老谢=lão Tạ
老谷=lão Cốc
老豹=lão Báo
老费=lão Phí
老贺=lão Hạ
老贾=lão Giả
老赵=lão Triệu
老跋=lão Bạt
老路=đường xưa/lối cũ/con đường cũ/kiểu cũ/lão Lộ
老边=lão Biên
老逼登=lão Bai Đần
老邢=lão Hình
老邪=lão Tà
老邱=lão Khâu
老邵=lão Thiệu
老郑=lão Trịnh
老郝=lão Hách
老郭=lão Quách
老金=lão Kim
老钟=lão Chung
老钱=lão Tiền
老铁=lão Thiết/lão thiết
老镇=lão Trấn
老陆=lão Lục
老陈=lão Trần
老陈家=lão Trần gia
老雨=lão Vũ
老雪=lão Tuyết
老雷=lão Lôi
老霍=lão Hoắc
老韦=lão Vi
老韩=lão Hàn
老项=lão Hạng
老顾=lão Cố
老风=lão Phong
老马=lão Mã
老鬼=lão quỷ/lão Quỷ/lão Ma/lão Quỷ
老魏=lão Ngụy
老鲁=lão Lỗ
老鲍=lão Bảo
老鸟=lão điểu/dân chuyên nghiệp/dân Pro
老鹏=lão Bằng
老麟=lão Lân
老麻=lão Ma
老黄=lão Hoàng
老黄牛=lão Hoàng Ngưu/con bò già
老黎=lão Lê
老黑=lão Hắc/lão hắc
老齐=lão Tề
老龄化=già hóa/lão hóa/Già hóa dân số
老龙=lão Long
老龚=lão Cung
老龟=lão quy/lão Quy
耶律家=Gia Luật gia
聂伯=Nhiếp bá
聂儿=Nhiếp nhi
聂叔=Nhiếp thúc
聂哥=Nhiếp ca/Nhiếp ca
聂城主=Nhiếp thành chủ
聂大哥=Nhiếp đại ca
聂妹=Nhiếp muội
聂姐=Nhiếp tỷ
聂姨=Nhiếp di
聂师叔=Nhiếp sư thúc
聂弟=Nhiếp đệ
聂某=Nhiếp mỗ
聂母=Nhiếp mẫu/Nhiếp mẫu
聂爷=Nhiếp gia
聂老=Nhiếp lão
聂老鬼=Nhiếp lão quỷ
聂门主=Nhiếp môn chủ
聪儿=Thông nhi
肋眼=nạc lưng/Rib eye là phần nạc lưng của bò/hay còn gọi là scotch fillet/là phần thịt nạc lưng được xẻ từ xương sườn của con bò nhưng không bao gồm xương. Sở dĩ gọi là rib eye vì nó bao gồm phía trên của phần sườn. Cái tên này bắt nguồn từ việc sau khi cắt ngang một miếng nạc lưng bò sẽ thấy một dải mỡ chạy giữa miếng thịt/nhìn khá giống hình con mắt. Phần mỡ này sẽ giúp miếng thịt bò mềm thơm/béo ngậy khi áp chảo hoặc bỏ lò ở nhiệt độ cao.
肖伯=Tiếu bá
肖儿=Tiếu nhi
肖副门主=Tiếu phó môn chủ
肖叔=Tiếu thúc
肖哥=Tiếu ca
肖城主=Tiếu thành chủ
肖大叔=Tiếu đại thúc
肖姐=Tiếu tỷ
肖姨=Tiếu di
肖家=Tiếu gia
肖少主=Tiếu thiếu chủ
肖师叔=Tiếu sư thúc
肖弟=Tiếu đệ
肖总=Tiếu tổng
肖某=Tiếu mỗ
肖母=Tiếu mẫu
肖爷=Tiếu gia
肖老=Tiếu lão
肖老八=Tiếu lão bát
肖老怪=Tiếu lão quái
肖老鬼=Tiếu lão quỷ
肖门主=Tiếu môn chủ
肖阿姨=Tiếu a di
胖哥=Bàn ca/anh Mập
胖爷=Bàn gia
胖爷我=Bàn gia ta
胜哥=Thắng ca
胡伯=Hồ bá/Hồ Bá
胡儿=Hồ nhi
胡先生=Hồ tiên sinh
胡公子=Hồ công tử
胡千总=Hồ thiên tổng
胡叔=Hồ thúc
胡城主=Hồ thành chủ
胡大人=Hồ đại nhân
胡大爷=Hồ đại gia
胡妹=Hồ muội
胡姐=Hồ tỷ
胡姨=Hồ di
胡嫂=Hồ tẩu
胡小姐=Hồ tiểu thư
胡少主=Hồ thiếu chủ
胡师叔=Hồ sư thúc
胡师祖=Hồ sư tổ
胡弟=Hồ đệ
胡总=Hồ tổng
胡母=Hồ mẫu
胡老七=Hồ lão thất
胡老八=Hồ lão bát
胡老六=Hồ lão lục
胡老大=Hồ lão đại
胡老怪=Hồ lão quái
胡老爷=Hồ lão gia
胡老鬼=Hồ lão quỷ
胡门主=Hồ môn chủ
胥老=Tư lão
臧某=Tang mỗ
自民党=đảng Tự Dân/LDP/Đảng Dân chủ Tự do
舅爷=Cữu gia/cữu gia
舒伯=Thư bá
舒叔=Thư thúc
舒哥=Thư ca
舒大哥=Thư đại ca
舒妹=Thư muội
舒姐=Thư tỷ
舒姨=Thư di
舒师叔=Thư sư thúc
舒总=Thư tổng
舒某=Thư mỗ
舒母=Thư mẫu
舒爷=Thư gia
舒老=Thư lão
舞城主=Vũ thành chủ
舞家=Vũ gia
舞师叔=Vũ sư thúc
舞门主=Vũ môn chủ
航空母舰=hàng không mẫu hạm/tàu sân bay/tàu chở máy bay/Hàng không mẫu hạm
色家=Sắc gia
艳姐=Diễm tỷ
艺术总监=tổng thanh tra nghệ thuật/Giám đốc Nghệ thuật/CAO Art
艾儿=Ngải nhi
艾某=Ngải mỗ
节儿=Tiết nhi
芙姐=Phù tỷ
芦城主=Lô thành chủ
芮儿=Nhuế nhi
芮家=Nhuế gia
芯儿=Tâm nhi
花伯=Hoa bá
花儿=bông hoa/Hoa nhi
花叔=Hoa thúc
花哥=Hoa ca
花大姐=Hoa đại tỷ/bọ rùa/Hoa đại tỷ
花姐=Hoa tỷ
花姨=Hoa di
花嫂=Hoa tẩu
花家=Hoa gia
花少主=Hoa thiếu chủ
花师叔=Hoa sư thúc
花弟=Hoa đệ
花母=Hoa mẫu
花爷=Hoa gia
花老=Hoa lão
花老七=Hoa lão thất
花老六=Hoa lão lục
花老怪=Hoa lão quái
花老鬼=Hoa lão quỷ
花门主=Hoa môn chủ
芳姐=Phương tỷ
芳姨=Phương di
芷儿=Chỉ nhi
芸姐=Vân tỷ
苍叔=Thương thúc
苍姐=Thương tỷ
苍某=Thương mỗ
苏儿=Tô nhi
苏叔=Tô thúc
苏哥=Tô ca
苏城主=Tô thành chủ
苏妹=Tô muội
苏姐=Tô tỷ
苏姨=Tô di
苏嫂=Tô tẩu
苏家=Tô gia
苏家庄=Tô gia trang
苏家的人=người của Tô gia
苏少主=Tô thiếu chủ
苏师伯=Tô sư bá
苏师叔=Tô sư thúc
苏师弟=Tô sư đệ
苏师祖=Tô sư tổ
苏弟=Tô đệ
苏总=Tô tổng
苏某=Tô mỗ
苏母=Tô mẫu
苏爷=Tô gia
苏皇主=Tô hoàng chủ
苏老七=Tô lão thất
苏老怪=Tô lão quái
苏老狗=Tô lão cẩu
苏老鬼=Tô lão quỷ
苗哥=Miêu ca
苗城主=Miêu thành chủ
苗大哥=Miêu đại ca
苗师叔=Miêu sư thúc
苗师祖=Miêu sư tổ
苗某=Miêu mỗ
苗老鬼=Miêu lão quỷ
苗门主=Miêu môn chủ
苟家=Cẩu gia
苟某=Cẩu mỗ
若儿=Nhược nhi/nhược nhi
若叶姐=Nhược Diệp tỷ
若妹=Nhược muội
若家=Nhược gia
苦妹=Khổ muội
苦老怪=Khổ lão quái
英亩=mẫu Anh
英叔=Anh thúc
英哥=Anh ca
英姐=Anh tỷ
英语老师=Anh ngữ lão sư
苹妹=Bình muội
茂哥=Mậu ca
范兄弟=Phạm huynh đệ
范城主=Phạm thành chủ
范大人=Phạm đại nhân
范大哥=Phạm đại ca
范姐=Phạm tỷ
范家=Phạm gia
范家庄=Phạm gia trang
范小爷=Phạm tiểu gia
范少主=Phạm thiếu chủ
范师叔=Phạm sư thúc
范师祖=Phạm sư tổ
范帮主=Phạm bang chủ
范总=Phạm tổng
范某=Phạm mỗ
范母=Phạm mẫu
范老怪=Phạm lão quái
范老鬼=Phạm lão quỷ
范门主=Phạm môn chủ
茅大哥=Mao đại ca
茜姐=Thiến tỷ
茹姐=Như tỷ
荀家=Tuân gia
荃姐=Thuyên tỷ
荆家=Kinh gia
荆某=Kinh mỗ
荣儿=Vinh nhi
荣哥=Vinh ca
荣大人=Vinh đại nhân
荣家=Vinh gia
药家=Dược gia
荷儿=Hà nhi
荷姐=Hà tỷ
莉儿=Lỵ nhi
莫儿=Mạc nhi
莫叔=Mạc thúc
莫哥=Mạc ca
莫城主=Mạc thành chủ
莫家=Mạc gia
莫少主=Mạc thiếu chủ
莫师叔=Mạc sư thúc
莫师祖=Mạc sư tổ
莫总=Mạc tổng
莫某=Mạc mỗ
莫老=Mạc lão
莫老怪=Mạc lão quái
莫老鬼=Mạc lão quỷ
莫门主=Mạc môn chủ
莲姐=Liên tỷ
莲姨=Liên di
莲弟=Liên đệ
莹姐=Oánh tỷ
菁姐=Tinh tỷ
菊姐=Cúc tỷ
菲儿=Phi nhi/Phỉ Nhi
萌姐=Manh tỷ
萍姐=Bình tỷ
萝儿=La nhi
营养师=bác sĩ dinh dưỡng/chuyên gia dinh dưỡng/Bác sĩ dinh dưỡng
萧主簿=Tiêu chủ bộ
萧伯=Tiêu bá
萧儿=Tiêu nhi
萧叔=Tiêu thúc
萧城主=Tiêu thành chủ
萧妹=Tiêu muội
萧姐=Tiêu tỷ
萧姨=Tiêu di
萧家的人=người của Tiêu gia
萧少主=Tiêu thiếu chủ
萧师叔=Tiêu sư thúc
萧师祖=Tiêu sư tổ
萧弟=Tiêu đệ
萧母=Tiêu mẫu
萧筱姐=Tiêu tiểu thư
萧老=Tiêu lão
萧老七=Tiêu lão thất
萧老八=Tiêu lão bát
萧老六=Tiêu lão lục
萧老怪=Tiêu lão quái
萧老鬼=Tiêu lão quỷ
萧门主=Tiêu môn chủ
萱姐=Huyên tỷ
落家=Lạc gia
葛先生=Cát tiên sinh
葛城主=Cát thành chủ
葛姐=Cát tỷ
葛家=Cát gia
葛家庄=Cát gia trang
葛师叔=Cát sư thúc
葛老=Cát lão
葛老怪=Cát lão quái
葛老鬼=Cát lão quỷ
葛门主=Cát môn chủ
葫芦兄弟=Hồ Lô huynh đệ
蒋先生=Tương tiên sinh/Tưởng tiên sinh
蒋副门主=Tưởng phó môn chủ
蒋城主=Tưởng thành chủ
蒋大哥=Tưởng đại ca
蒋家庄=Tưởng gia trang
蒋少主=Tưởng thiếu chủ
蒋师叔=Tưởng sư thúc
蒋某=Tưởng mỗ
蒋老鬼=Tưởng lão quỷ
蒋门主=Tưởng môn chủ
蒙主宠召=được Chúa gọi về/mông chủ sủng triệu
蒙伯=Mông bá
蒙儿=Mông nhi
蒙千总=Mông Thiên tổng/Mông thiên tổng
蒙叔=Mông thúc
蒙哥=Mông ca
蒙妹=Mông muội
蒙姐=Mông tỷ
蒙姨=Mông di
蒙家=Mông gia
蒙少主=Mông thiếu chủ
蒙弟=Mông đệ
蒙某=Mông mỗ
蒙母=Mông mẫu
蒙爷=Mông gia
蒙王爷=được vương gia/Mông vương gia
蒙老=Mông lão
蒙老六=Mông lão lục
蒙老怪=Mông lão quái
蒙老爷=Mông lão gia
蒙老鬼=Mông lão quỷ
蒙谷主=Mông cốc chủ
蒙门主=Mông môn chủ
蓉姊=Dung tỷ
蓉姐=Dung tỷ
蓝叔=Lam thúc
蓝城主=Lam thành chủ
蓝姨=Lam di
蓝少主=Lam thiếu chủ
蓝师叔=Lam sư thúc
蓝师祖=Lam sư tổ
蓝老怪=Lam lão quái
蓝老鬼=Lam lão quỷ
蓝门主=Lam môn chủ
蔓妹=Mạn muội
蔡伯=Thái bá
蔡儿=Thái nhi
蔡千总=Thái Thiên tổng/Thái thiên tổng
蔡叔=Thái thúc
蔡哥=Thái ca
蔡城主=Thái thành chủ
蔡大姐=Thái đại tỷ
蔡大爷=Thái đại gia
蔡妹=Thái muội
蔡姐=Thái tỷ
蔡姨=Thái di
蔡嫂=Thái tẩu
蔡少主=Thái thiếu chủ
蔡师叔=Thái sư thúc
蔡师祖=Thái sư tổ
蔡总=Thái tổng
蔡某=Thái mỗ
蔡母=Thái mẫu
蔡爷=Thái gia
蔡老=Thái lão
蔡老七=Thái lão thất
蔡老六=Thái lão lục
蔡老鬼=Thái lão quỷ
蔡门主=Thái môn chủ
蔷姐=Sắc tỷ
蕉哥=Tiêu ca
蕊姐=Nhị tỷ
蕾儿=Lôi nhi
薇妹=Vi muội
薇姐=Vi tỷ
薛伯=Tiết bá
薛儿=Tiết nhi
薛先生=Tiết tiên sinh
薛公子=Tiết công tử
薛叔=Tiết thúc
薛哥=Tiết ca
薛大叔=Tiết đại thúc
薛大哥=Tiết đại ca
薛大爷=Tiết đại gia
薛妹=Tiết muội
薛妹妹=Tiết muội muội
薛姐=Tiết tỷ
薛姨=Tiết di
薛姨娘=Tiết di nương
薛嫂=Tiết tẩu
薛家=Tiết gia
薛小妹=Tiết tiểu muội
薛少主=Tiết thiếu chủ
薛师叔=Tiết sư thúc
薛师祖=Tiết sư tổ
薛弟=Tiết đệ
薛总=Tiết tổng
薛母=Tiết mẫu
薛爷=Tiết gia
薛老=Tiết lão
薛老七=Tiết lão thất
薛老五=Tiết lão ngũ
薛老六=Tiết lão lục
薛老怪=Tiết lão quái
薛老爷子=Tiết lão gia tử
薛老鬼=Tiết lão quỷ
薛门主=Tiết môn chủ
藏城主=Tàng thành chủ
藏家=Tàng gia/tàng gia
虎城主=Hổ thành chủ
虎少主=Hổ thiếu chủ
虎师叔=Hổ sư thúc
虎弟=Hổ đệ
虚城主=Hư thành chủ
虚家=Hư gia
虚师叔=Hư sư thúc
虚老怪=Hư lão quái
虚老鬼=Hư lão quỷ
虞儿=Ngu nhi
虹儿=Hồng nhi
虹姐=Hồng tỷ
蛇老=Xà lão
蛮儿=Man nhi
蛮妹=Man muội
蜂家=Phong gia
蝉儿=Thuyền nhi/thiền nhi/con ve
蝎老=Hạt lão
行儿=Hành nhi
行叔=Hành thúc
行哥=Hành ca
行城主=Hành thành chủ
行妹=Hành muội
行姐=Hành tỷ
行嫂=Hành tẩu
行家=người trong nghề/hành gia/tay tổ/người lành nghề/người thạo nghề/giỏi nghề/thạo nghề/lành nghề/chuyên gia/Hành gia
行尸走肉=cái xác không hồn/giá áo túi cơm/hành thi tẩu nhục/thịt chạy thây đi/cái xác biết đi/Walking Dead/xác chết di động
行师叔=Hành sư thúc
行弟=Hành đệ
行某=Hành mỗ
行母=Hành mẫu
行爷=Hành gia
行老=Hành lão
行门主=Hành môn chủ
衣冠冢=mộ quần áo/Y Quan trủng/mộ chôn quần áo và di vật
袁先生=Viên tiên sinh
袁副门主=Viên phó môn chủ
袁城主=Viên thành chủ
袁大叔=Viên đại thúc
袁家=Viên gia
袁少主=Viên thiếu chủ
袁少爷=Viên thiếu gia
袁师叔=Viên sư thúc
袁师弟=Viên sư đệ
袁师祖=Viên sư tổ
袁总镖头=Viên tổng tiêu đầu
袁某=Viên mỗ/viên mỗ
袁老太=Viên lão thái
袁老怪=Viên lão quái
袁老鬼=Viên lão quỷ
袁门主=Viên môn chủ
袭家=Tập gia
裘伯=Cừu bá
裘儿=Cừu nhi
裘叔=Cầu thúc/Cừu thúc
裘哥=Cừu ca
裘姐=Cừu tỷ
裘姨=Cừu di
裘家=Cầu gia/Cừu gia
裘少主=Cừu thiếu chủ
裘师叔=Cừu sư thúc
裘师祖=Cừu sư tổ
裘帮主=Cừu bang chủ
裘某=Cầu mỗ/Cừu mỗ
裘母=Cầu mẫu/Cừu mẫu
裘爷=Cừu gia
裘老=Cừu lão
裘老儿=Cừu lão nhi
裘老怪=Cừu lão quái
裘门主=Cừu môn chủ
裴伯=Bùi bá
裴儿=Bùi nhi
裴叔=Bùi thúc
裴哥=Bùi ca
裴城主=Bùi thành chủ
裴姐=Bùi tỷ
裴姨=Bùi di
裴家=Bùi gia
裴家庄=Bùi gia trang
裴少主=Bùi thiếu chủ
裴师叔=Bùi sư thúc
裴弟=Bùi đệ
裴母=Bùi mẫu
裴爷=Bùi gia
裴老=Bùi lão
裴老六=Bùi lão lục
裴老鬼=Bùi lão quỷ
裴门主=Bùi môn chủ
褚兄弟=Chử huynh đệ
褚家=Chử gia
褥草=phụ gia thức ăn chăn nuôi/Phụ Gia Thức Ăn Chăn Nuôi
西儿=Tây nhi
西域三十六国=ba mươi sáu nước Tây Vực/Tây Vực ba mươi sáu quốc gia
西某=Tây mỗ
西蒙家=Tây Mông gia
西门老=Tây Môn lão
解家=Giải gia
解某=Giải mỗ
言儿=Ngôn nhi
言城主=Ngôn thành chủ
言姐=Ngôn tỷ
言家=Ngôn gia
言少主=Ngôn thiếu chủ
言师叔=Ngôn sư thúc
言师祖=Ngôn sư tổ
言总=Ngôn tổng
言老=Ngôn lão
言老爷=Ngôn lão gia
言门主=Ngôn môn chủ
誉儿=Dự nhi
议长=nghị trưởng/chủ tịch quốc hội/Chủ tịch quốc hội
许儿=Hứa nhi
许先生=Hứa tiên sinh
许千总=Hứa Thiên tổng/Hứa thiên tổng
许叔=Hứa thúc
许哥=Hứa ca
许嘉=Hứa gia
许城主=Hứa thành chủ
许妹=Hứa muội
许姐=Hứa tỷ
许姨=Hứa di
许嫂=Hứa tẩu
许家=Hứa gia
许少主=Hứa thiếu chủ
许师叔=Hứa sư thúc
许师祖=Hứa sư tổ
许弟=Hứa đệ
许总=Hứa tổng
许某=Hứa mỗ
许母=Hứa mẫu
许爷=Hứa gia
许老=Hứa lão
许老六=Hứa lão lục
许老怪=Hứa lão quái
许老鬼=Hứa lão quỷ
许门主=Hứa môn chủ
诚哥=Makoto ca
语儿=Ngữ nhi
语锋=ngữ phong/Ngữ Phong/chủ đề thảo luận
诸公子=Chư công tử
诸子百家=bách gia chư tử/chư tử bách gia/Trăm trường phái tư tưởng, các trường phái tư tưởng khác nhau và các cơ sở của chúng trong thời Xuân Thu và Chiến Quốc
读经=đọc kinh/đọc kinh điển Nho gia
谢伯=Tạ bá
谢儿=Tạ nhi
谢兄弟=Tạ huynh đệ
谢先生=Tạ tiên sinh
谢千总=Tạ Thiên tổng/Tạ thiên tổng
谢叔=Tạ thúc
谢哥=Tạ ca
谢城主=Tạ thành chủ
谢大人=Tạ đại nhân
谢妹=Tạ muội
谢姐=Tạ tỷ
谢姨=Tạ di
谢嫂=Tạ tẩu
谢家了=Tạ gia
谢家的人=người của Tạ gia
谢小姐=Tạ tiểu thư
谢少主=Tạ thiếu chủ
谢师叔=Tạ sư thúc
谢师祖=Tạ sư tổ
谢弟=Tạ đệ
谢总=Tạ tổng
谢某=Tạ mỗ
谢母=Tạ mẫu
谢爷=Tạ gia
谢王爷=Tạ vương gia
谢老=Tạ lão
谢老七=Tạ lão thất
谢老六=Tạ lão lục
谢老怪=Tạ lão quái
谢老爷=Tạ lão gia
谢老爷子=Tạ lão gia tử
谢老鬼=Tạ lão quỷ
谢门主=Tạ môn chủ
谦儿=Khiêm Nhi/Khiêm nhi
谭千总=Đàm Thiên tổng/Đàm thiên tổng
谷伯=Cốc bá
谷儿=Cốc nhi
谷叔=Cốc thúc
谷哥=Cốc ca/Google
谷姐=Cốc tỷ
谷姨=Cốc di
谷家=Cốc gia
谷少主=Cốc thiếu chủ
谷师叔=Cốc sư thúc
谷弟=Cốc đệ
谷某=Cốc mỗ
谷母=Cốc mẫu
谷爷=Cốc gia
谷老=Cốc lão
谷老怪=Cốc lão quái
谷门主=Cốc môn chủ
象哥=Tượng ca
豪儿=Hào nhi
豪哥=Hào ca/hào ca
贝儿=Bối nhi
贝姐=Bối tỷ
贝家=Bối gia
贝总=Bối tổng
贝爷=Bear gia
贞儿=Trinh nhi
贤妹=hiền muội/em Hiền/Tiếng gọi em gái mình, với ý tôn xưng.
费哥=Phí ca
费姐=Phí tỷ
费家=Phí gia
费师叔=Phí sư thúc
费师弟=Phí sư đệ
费某=Phí mỗ
费老=Phí lão
费老鬼=Phí lão quỷ
费门主=Phí môn chủ
贺伯=Hạ bá
贺儿=Hạ nhi
贺叔=Hạ thúc
贺哥=Hạ ca
贺城主=Hạ thành chủ
贺妹=Hạ muội
贺姐=Hạ tỷ
贺姨=Hạ di
贺嫂=Hạ tẩu
贺寨主=Hạ trại chủ
贺少主=Hạ thiếu chủ
贺师叔=Hạ sư thúc
贺弟=Hạ đệ
贺某=Hạ mỗ
贺爷=Hạ gia
贺老三=Hạ lão tam
贺老大=Hạ lão đại
贺老鬼=Hạ lão quỷ
贺门主=Hạ môn chủ
贾伯=Giả bá
贾儿=Giả nhi
贾叔=Giả thúc
贾哥=Giả ca
贾城主=Giả thành chủ
贾大人=Giả đại nhân
贾妹=Giả muội
贾姐=Giả tỷ
贾姨=Giả di
贾家=Giả gia
贾家庄=Giả gia trang
贾少主=Giả thiếu chủ
贾师叔=Giả sư thúc
贾师弟=Giả sư đệ
贾弟=Giả đệ
贾母=Giả mẫu
贾爷=Giả gia
贾老=Giả lão
贾老六=Giả lão lục
贾老师=Giả lão sư
贾老板=Giả lão bản
贾老鬼=Giả lão quỷ
贾长老=Giả trưởng lão
贾门主=Giả môn chủ
赖城主=Lại thành chủ
赖家=Lại gia
赖师叔=Lại sư thúc
赖某=Lại mỗ
赖门主=Lại môn chủ
赛儿=Tái nhi
赢家=bên thắng/người thắng/Doanh gia
赢师叔=Doanh sư thúc
赢门主=Doanh môn chủ
赤家=Xích gia
赤某=Xích mỗ
赤老=Xích lão
赫家=Hách gia
赫少主=Hách thiếu chủ
赫师叔=Hách sư thúc
赫老鬼=Hách lão quỷ
赫连家=Hách Liên gia
赵主=Triệu chủ
赵伯=Triệu bá
赵儿=Triệu nhi
赵副主=Triệu phó chủ
赵副门主=Triệu phó môn chủ
赵千总=Triệu thiên tổng
赵城主=Triệu thành chủ
赵大姐=Triệu đại tỷ
赵妹=Triệu muội
赵姐=Triệu tỷ
赵姨=Triệu di
赵姨娘=Triệu di nương
赵嫂=Triệu tẩu
赵家堡=Triệu gia bảo
赵家庄=Triệu gia trang
赵家村=Triệu gia thôn
赵少主=Triệu thiếu chủ
赵师弟=Triệu sư đệ
赵师祖=Triệu sư tổ
赵弟=Triệu đệ
赵总=Triệu tổng
赵母=Triệu mẫu
赵爷=Triệu gia
赵王爷=Triệu vương gia
赵老七=Triệu lão thất
赵老三=Triệu lão tam
赵老八=Triệu lão bát
赵老六=Triệu lão lục
赵老师=Triệu lão sư
赵老爷=Triệu lão gia
赵老鬼=Triệu lão quỷ
赵门主=Triệu môn chủ
超叔=Siêu thúc
越儿=Việt nhi
越城主=Việt thành chủ
越家=Việt gia
越少主=Việt thiếu chủ
越师叔=Việt sư thúc
越母=Việt mẫu
越老怪=Việt lão quái
越老鬼=Việt lão quỷ
越门主=Việt môn chủ
跃儿=Dược nhi
跃家=Dược gia
路伯=Lộ bá
路儿=Lộ nhi
路千总=Lộ Thiên tổng/Lộ thiên tổng
路叔=Lộ thúc
路哥=Lộ ca
路城主=Lộ thành chủ
路妹=Lộ muội
路姐=Lộ tỷ
路姨=Lộ di
路家=Lộ gia
路师叔=Lộ sư thúc
路弟=Lộ đệ
路总管=Lộ tổng quản
路某=Lộ mỗ
路母=Lộ mẫu
路爷=Lộ gia
路老=Lộ lão
路长老=Lộ trưởng lão
路门主=Lộ môn chủ
车家=Xa gia
车某=Xa mỗ
车灯=đèn xe/một hình thức ca vũ dân gian ở vùng Tây Nam
车老=Xa lão
轩主=Hiên chủ
轩儿你=Hiên nhi ngươi
辉儿=Huy nhi
辉哥=Huy ca
辙儿=Triệt nhi
辛儿=Tân nhi
辛家=Tân gia
辛某=Tân mỗ
辣妹=lạt muội/cô em/Sexy Girl (Lạt muội)
辰家=Thần gia
辰老=Thần lão
边伯=Biên bá
边儿=bên cạnh/Biên nhi
边叔=Biên thúc
边哥=Biên ca
边妹=Biên muội
边姐=Biên tỷ
边姨=Biên di
边嫂=Biên tẩu
边家=Biên gia
边弟=Biên đệ
边某=Biên mỗ
边母=Biên mẫu
边爷=Biên gia
边牧=border collie/vừa chăn thả gia súc/Border collie
边老=Biên lão
达卡=Đa-ca/Dacca/Đaca
达达主义=chủ nghĩa Dada
迅哥=Tấn ca
过儿=Quá nhi/lần
过某=Qua mỗ
迎儿=Nghênh nhi
这老卫=người lão Vệ này
这老孙=lão Tôn này
这路家=Lộ gia này
进儿=Tiến nhi
远儿=Viễn nhi
远哥=Viễn ca
连姐=Liên tỷ
连师伯=Liên sư bá
逍哥=Tiêu ca
造物主=tạo vật chủ/tạo hóa/Tạo hóa/Chúa sáng thế/chúa sáng thế
逸儿=Dật nhi
逸哥=Dật ca
逸家=Dật gia
逸门主=Dật môn chủ
遗泽=di trạch/Di Trạch
邓千总=Đặng Thiên tổng/Đặng thiên tổng
邢家=Hình gia
那儿=chỗ ấy/chỗ/nơi nào/lúc ấy/chỗ ấy/nơi ấy/bấy giờ/Na nhi
那管家=Quản gia kia/quản gia kia
邮政总局=tổng cục bưu chính/bưu điện/tổng cục bưu điện/Tổng cục bưu chính
邱伯=Khâu bá
邱先生=Khâu tiên sinh
邱千总=Khâu Thiên tổng/Khâu thiên tổng
邱叔=Khâu thúc
邱哥=Khâu ca
邱城主=Khâu thành chủ
邱姐=Khâu tỷ
邱姨=Khâu di
邱嫂=Khâu tẩu
邱家=Khâu gia
邱少主=Khâu thiếu chủ
邱师叔=Khâu sư thúc
邱弟=Khâu đệ
邱母=Khâu mẫu
邱爷=Khâu gia
邱老八=Khâu lão bát
邱老六=Khâu lão lục
邱老怪=Khâu lão quái
邱老鬼=Khâu lão quỷ
邱门主=Khâu môn chủ
邵家=Thiệu gia
邹先生=Trâu tiên sinh
邹家=Trâu gia
郎家=Lang gia
郑二公子=Trịnh nhị công tử
郑伯=Trịnh bá
郑儿=Trịnh nhi
郑先生=Trịnh tiên sinh
郑公子=Trịnh công tử
郑千总=Trịnh Thiên tổng/Trịnh thiên tổng
郑哥=Trịnh ca
郑城主=Trịnh thành chủ
郑大人=Trịnh đại nhân
郑妹=Trịnh muội
郑姐=Trịnh tỷ
郑姨=Trịnh di
郑嫂=Trịnh tẩu
郑小姐=Trịnh tiểu thư
郑少主=Trịnh thiếu chủ
郑师叔=Trịnh sư thúc
郑师祖=Trịnh sư tổ
郑某=Trịnh mỗ
郑母=Trịnh mẫu
郑爷=Trịnh gia
郑王爷=Trịnh vương gia
郑老=Trịnh lão
郑老七=Trịnh lão thất
郑老六=Trịnh lão lục
郑老怪=Trịnh lão quái
郑老鬼=Trịnh lão quỷ
郑门主=Trịnh môn chủ
郝伯=Hách bá
郝儿=Hách nhi
郝副门主=Hách phó môn chủ
郝叔=Hách thúc
郝哥=Hách ca
郝城主=Hách thành chủ
郝大哥=Hách đại ca
郝妹=Hách muội
郝姐=Hách tỷ
郝姨=Hách di
郝嫂=Hách tẩu
郝家=Hách gia
郝家庄=Hách gia trang
郝师叔=Hách sư thúc
郝师弟=Hách sư đệ
郝某=Hách mỗ
郝爷=Hách gia
郝老=Hách lão
郝老板=Hách lão bản
郝老爷=Hách lão gia
郝老鬼=Hách lão quỷ
郝连家=Hách Liên gia
郝门主=Hách môn chủ
部某=Bộ mỗ ta
郭儿=Quách nhi
郭兄弟=Quách huynh đệ
郭先生=Quách tiên sinh
郭叔=Quách thúc
郭哥=Quách ca
郭大哥=Quách đại ca
郭大爷=Quách đại gia
郭妹=Quách muội
郭姐=Quách tỷ
郭姐姐=Quách tỷ tỷ
郭嫂=Quách tẩu
郭少主=Quách thiếu chủ
郭师祖=Quách sư tổ
郭弟=Quách đệ
郭母=Quách mẫu
郭爷=Quách gia
郭老七=Quách lão thất
郭老八=Quách lão bát
郭老六=Quách lão lục
郭老怪=Quách lão quái
郭老鬼=Quách lão quỷ
郭门主=Quách môn chủ
酒师叔=Tửu sư thúc
释伯=Thích bá
释老=thích lão/Phật giáo và đạo giáo
野儿=Dã nhi
金三姐=Kim tam tỷ
金伯=Kim bá
金儿=Kim nhi
金副门主=Kim phó môn chủ
金叔=Kim thúc
金哥=Kim ca
金大人=Kim đại nhân
金妹=Kim muội
金姐=Kim tỷ
金姨=Kim di
金嫂=Kim tẩu
金家=Kim gia
金家庄=Kim gia trang
金少主=Kim thiếu chủ
金师叔=Kim sư thúc
金师祖=Kim sư tổ
金弟=Kim đệ
金总=Kim tổng
金母=Kim mẫu
金爷=Kim gia
金老=Kim lão
金老七=Kim lão thất
金老八=Kim lão bát
金老六=Kim lão lục
金老鬼=Kim lão quỷ
钟伯=Chung bá
钟儿=Chung nhi
钟叔=Chung thúc
钟城主=Chung thành chủ
钟妹=Chung muội
钟姐=Chung tỷ
钟姨=Chung di
钟嫂=Chung tẩu
钟家=Chung gia
钟少主=Chung thiếu chủ
钟师叔=Chung sư thúc
钟师祖=Chung sư tổ
钟弟=Chung đệ
钟总=Chung tổng
钟某=Chung mỗ
钟母=Chung mẫu
钟爷=Chung gia
钟老=Chung lão
钟老六=Chung lão lục
钟老怪=Chung lão quái
钟老鬼=Chung lão quỷ
钟谷主=Chung cốc chủ
钟门主=Chung môn chủ
钢哥=Cương ca
钱伯=Tiền bá
钱儿=Tiền nhi
钱千总=Tiền Thiên tổng/Tiền thiên tổng
钱叔=Tiền thúc
钱哥=Tiền ca
钱城主=Tiền thành chủ
钱妹=Tiền muội
钱姐=Tiền tỷ
钱姨=Tiền di
钱嫂=Tiền tẩu
钱家=Tiền gia
钱少主=Tiền thiếu chủ
钱师叔=Tiền sư thúc
钱师祖=Tiền sư tổ
钱弟=Tiền đệ
钱总=Tiền tổng
钱某=Tiền mỗ
钱母=Tiền mẫu/mẹ Tiền
钱爷=Tiền gia
钱老=Tiền lão
钱老儿=Tiền lão nhi
钱老本=Tiền lão bản
钱老爷=Tiền lão gia
钱门主=Tiền môn chủ
铁叔=Thiết thúc
铁哥=Thiết ca
铁城主=Thiết thành chủ
铁家的人=người của Thiết gia
铁少主=Thiết thiếu chủ
铁师叔=Thiết sư thúc
铁老大=Thiết lão đại
铁老怪=Thiết lão quái
铁老鬼=Thiết lão quỷ
铃儿=Linh nhi
银某=Ngân mỗ
银老=Ngân lão
锋儿=Phong nhi
锋叔=Phong thúc
锋哥=Phong ca
锋爷=Phong gia
镇叔=Trấn thúc
镇家=Trấn gia
长恨歌=Trường hận ca
闪家=Thiểm gia
问哥=Vấn ca
闲儿=Nhàn nhi
闲哥=Nhàn ca
闵儿=Mẫn nhi
闻先生=Văn tiên sinh
闻家=Văn gia
闻师叔=Văn sư thúc
闻总=chủ tịch Văn
闻门主=Văn môn chủ
阁主=Các chủ
阁老=Các lão
阎副门主=Diêm phó môn chủ
阎哥=Diêm ca
阎城主=Diêm thành chủ
阎家=Diêm gia
阎家庄=Diêm gia trang
阎少主=Diêm thiếu chủ
阎师叔=Diêm sư thúc
阎某=Diêm mỗ
阎王爷=Diêm Vương gia
阎老怪=Diêm lão quái
阎老鬼=Diêm lão quỷ
阎门主=Diêm môn chủ
阑儿=Lan nhi
阙叔=Khuyết thúc
阙家=Khuyết gia
阮家=Nguyễn gia
阳儿=Dương nhi
阳家=Dương gia
阳少主=Dương thiếu chủ
阳师叔=Dương sư thúc
阳爷=Dương gia
阳老=Dương lão
阳老怪=Dương lão quái
阳老鬼=Dương lão quỷ
阳门主=Dương môn chủ
阿叔=A thúc
阿姊=A tỷ
阿难=A Nan/Thái tử Ananda, em họ của Đức Phật và là đệ tử thân cận nhất của Ngài
陆伯=Lục bá
陆儿=Lục nhi
陆先生=Lục tiên sinh
陆副门主=Lục phó môn chủ
陆叔=Lục thúc
陆哥=Lục ca
陆城主=Lục thành chủ
陆大人=Lục đại nhân
陆妹=Lục muội
陆姐=Lục tỷ
陆姨=Lục di
陆嫂=Lục tẩu
陆家=Lục gia
陆家庄=Lục gia trang
陆家的人=người của Lục gia
陆少主=Lục thiếu chủ
陆师叔=Lục sư thúc
陆师祖=Lục sư tổ
陆庄主=Lục trang chủ
陆弟=Lục đệ
陆总=Lục tổng
陆某=Lục mỗ
陆母=Lục mẫu
陆爷=Lục gia
陆老=Lục lão
陆老八=Lục lão bát
陆老六=Lục lão lục
陆老怪=Lục lão quái
陆老鬼=Lục lão quỷ
陆门主=Lục môn chủ
陇家=Lũng gia
陇某=Lũng mỗ
陈主=Trần chủ
陈伯=Trần bá
陈儿=Trần nhi
陈兄弟=Trần huynh đệ
陈副门主=Trần phó môn chủ
陈千总=Trần Thiên tổng/Trần thiên tổng
陈哥=Trần ca
陈城主=Trần thành chủ
陈妹=Trần muội
陈姐=Trần tỷ
陈嫂=Trần tẩu
陈家庄=Trần gia trang
陈家村=Trần gia thôn
陈小姐=Trần tiểu thư
陈少主=Trần thiếu chủ
陈师叔=Trần sư thúc
陈弟=Trần đệ
陈母=Trần mẫu
陈爷=Trần gia
陈老七=Trần lão thất
陈老先生=Trần lão tiên sinh
陈老八=Trần lão bát
陈老六=Trần lão lục
陈老大=Trần lão đại
陈老师=Trần lão sư
陈老怪=Trần lão quái
陈老板=Trần lão bản
陈老爷=Trần lão gia
陈老爷子=Trần lão gia tử
陈老鬼=Trần lão quỷ
陈舵主=Trần Đà chủ
陈长老=Trần trưởng lão
陈门主=Trần môn chủ
陌家=Mạch gia
隆家=Long gia
隋家=Tùy gia
隶家=Cầu gia
雀姐=Tước tỷ
雁儿=Nhạn nhi
雁姐=Nhạn tỷ
雄哥=Hùng ca
雄弟=Hùng đệ
雄老=Hùng lão
雅姐=Nhã tỷ
雍家=Ung gia
雍门主=Ung môn chủ
雨伯=Vũ bá
雨儿=Vũ nhi
雨叔=Vũ thúc
雨哥=Vũ ca
雨姐=Vũ tỷ
雨姨=Vũ di
雨家=Vũ gia
雨弟=Vũ đệ
雨母=Vũ mẫu
雨爷=Vũ gia
雨老=Vũ lão
雨门主=Vũ môn chủ
雪伯=Tuyết bá
雪儿你=Tuyết nhi ngươi
雪叔=Tuyết thúc
雪哥=Tuyết ca
雪姐=Tuyết tỷ
雪姨=Tuyết di
雪嫂=Tuyết tẩu
雪家=Tuyết gia
雪少主=Tuyết thiếu chủ
雪师叔=Tuyết sư thúc
雪师祖=Tuyết sư tổ
雪弟=Tuyết đệ
雪母=Tuyết mẫu
雪爷=Tuyết gia
雪老=Tuyết lão
雪老怪=Tuyết lão quái
雪老鬼=Tuyết lão quỷ
雪走=tuyết tẩu/Yubashiri
雪门主=Tuyết môn chủ
零姐=Linh tỷ
雷伯=Lôi bá
雷先生=Lôi tiên sinh
雷千总=Lôi Thiên tổng/Lôi thiên tổng
雷城主=Lôi thành chủ
雷妹=Lôi muội
雷姐=Lôi tỷ
雷姨=Lôi di
雷嫂=Lôi tẩu
雷家庄=Lôi gia trang
雷家的人=người của Lôi gia
雷少主=Lôi thiếu chủ
雷弟=Lôi đệ
雷总=Lôi tổng
雷母=Lôi mẫu
雷爷=Lôi gia
雷老=Lôi lão
雷老七=Lôi lão thất
雷老六=Lôi lão lục
雷老怪=Lôi lão quái
雷老爷=Lôi lão gia
雷老鬼=Lôi lão quỷ
雷门主=Lôi môn chủ
霄哥=Tiêu ca
震儿=Chấn nhi
震少主=Chấn thiếu chủ
霍伯=Hoắc bá
霍儿=Hoắc nhi
霍先生=Hoắc tiên sinh
霍副门主=Hoắc phó môn chủ
霍叔=Hoắc thúc
霍哥=Hoắc ca
霍妹=Hoắc muội
霍姐=Hoắc tỷ
霍姨=Hoắc di
霍嫂=Hoắc tẩu
霍少主=Hoắc thiếu chủ
霍师叔=Hoắc sư thúc
霍师祖=Hoắc sư tổ
霍弟=Hoắc đệ
霍母=Hoắc mẫu
霍洞主=Hoắc động chủ
霍爷=Hoắc gia
霍老=Hoắc lão
霍老六=Hoắc lão lục
霍老怪=Hoắc lão quái
霍老鬼=Hoắc lão quỷ
霍门主=Hoắc môn chủ
霜姐=Sương tỷ
霜姨=Sương di
霞儿=Hà nhi
霞妹=Hà muội
霞姐=Hà tỷ
霞家=Hà gia
霞师叔=Hà sư thúc
霞门主=Hà môn chủ
露儿=Lộ nhi
霸儿=Bá nhi
霸某=Bá mỗ
霸榜=bá bảng/Bá Bảng
霸王=bá vương/Bá Vương/kẻ cực kỳ thô bạo/kẻ ngang ngược
霸道=bá đạo/độc tài/chuyên chế/quân phiệt/dùng sức mạnh để trị/ngang ngược/hỗn xược/Bá Đạo
霸霸=bá bá/Bá Bá
青哥=Thanh ca
青姐=Thanh tỷ
青家=Thanh gia
青师叔=Thanh sư thúc
青弟=Thanh đệ
青老怪=Thanh lão quái
青老鬼=Thanh lão quỷ
青门主=Thanh môn chủ
靖儿=Tĩnh nhi
静儿=Tĩnh nhi
静姐=Tĩnh tỷ
非哥=Phi ca
韦伯=Vi bá
韦儿=Vi nhi
韦兄弟=Vi huynh đệ
韦公子=Vi công tử
韦千总=Vi Thiên tổng/Vi thiên tổng
韦叔=Vi thúc
韦哥=Vi ca
韦城主=Vi thành chủ
韦姐=Vi tỷ
韦姨=Vi di
韦少主=Vi thiếu chủ
韦少爷=Vi thiếu gia
韦师叔=Vi sư thúc
韦弟=Vi đệ
韦总=Vi tổng
韦某=Vi mỗ
韦母=Vi mẫu
韦爵爷=Vi tước gia
韦爷=Vi gia
韦老=Vi lão
韦老七=Vi lão thất
韦老六=Vi lão lục
韦老鬼=Vi lão quỷ
韦门主=Vi môn chủ
韩伯=Hàn bá
韩儿=Hàn nhi
韩千总=Hàn Thiên tổng/Hàn thiên tổng
韩哥=Hàn ca
韩妹=Hàn muội
韩姐=Hàn tỷ
韩姨=Hàn di
韩嫂=Hàn tẩu
韩家的人=người của Hàn gia
韩少主=Hàn thiếu chủ
韩师叔=Hàn sư thúc
韩师祖=Hàn sư tổ
韩总=Hàn tổng
韩母=Hàn mẫu
韩爷=Hàn gia
韩老=Hàn lão
韩老七=Hàn lão thất
韩老八=Hàn lão bát
韩老六=Hàn lão lục
韩老师=Hàn lão sư
韩老怪=Hàn lão quái
韩老鬼=Hàn lão quỷ
韩门主=Hàn môn chủ
音乐片=phim ca nhạc/Phim ca nhạc
项伯=Hạng bá
项儿=Hạng nhi
项叔=Hạng thúc
项哥=Hạng ca
项姨=Hạng di
项师叔=Hạng sư thúc
项师祖=Hạng sư tổ
项总=chủ tịch Hạng/hạng tổng
项母=Hạng mẫu
项老=Hạng lão
项老六=Hạng lão lục
项老鬼=Hạng lão quỷ
项长老=Hạng trưởng lão
项门主=Hạng môn chủ
顾二哥=Cố nhị ca
顾伯=Cố bá
顾儿=Cố nhi
顾公子=Cố công tử
顾叔=Cố thúc
顾哥=Cố ca
顾城主=Cố thành chủ
顾妹=Cố muội
顾姐=Cố tỷ
顾姨=Cố di
顾嫂=Cố tẩu
顾家=lo việc nhà/Cố gia/lo cho gia đình/lo chuyện nhà/
顾少主=Cố thiếu chủ
顾师叔=Cố sư thúc
顾师祖=Cố sư tổ
顾弟=Cố đệ
顾母=Cố mẫu
顾氏=Cố thị/Cố gia
顾爷=Cố gia
顾老=Cố lão
顾老七=Cố lão thất
顾老六=Cố lão lục
顾老怪=Cố lão quái
顾老鬼=Cố lão quỷ
顾门主=Cố môn chủ
颜兄弟=Nhan huynh đệ
颜叔=Nhan thúc
颜城主=Nhan thành chủ
颜姐=Nhan tỷ
颜家=Nhan gia
颜少主=Nhan thiếu chủ
颜师叔=Nhan sư thúc
颜师祖=Nhan sư tổ
颜老怪=Nhan lão quái
颜老鬼=Nhan lão quỷ
颜门主=Nhan môn chủ
颜颜姐=Nhan Nhan tỷ
风儿=cơn gió/Phong nhi
风叔=Phong thúc
风哥=Phong ca
风城主=Phong thành chủ
风妹=Phong muội
风姐=Phong tỷ
风嫂=Phong tẩu
风家=Phong gia
风少主=Phong thiếu chủ
风师叔=Phong sư thúc
风师祖=Phong sư tổ
风弟=Phong đệ
风母=Phong mẫu
风爷=Phong gia
风老=Phong lão
风老七=Phong lão thất
风老八=Phong lão bát
风老六=Phong lão lục
风老怪=Phong lão quái
风老鬼=Phong lão quỷ
飞儿=Phi nhi
飞姐=Phi tỷ
飞弟=Phi đệ
香主=hương chủ/Hương chủ
馨儿=Hinh Nhi/Hinh nhi
馨姐=Hinh tỷ
马伯=Mã bá
马兄弟=Mã huynh đệ
马先生=Mã tiên sinh
马克思主义=chủ nghĩa Mác
马公子=Mã công tử
马列主义=chủ nghĩa Mác-Lê Nin
马刺=mã thích/Spurs/thúc đẩy
马副门主=Mã phó môn chủ
马千总=Mã Thiên tổng/Mã thiên tổng
马叔=Mã thúc
马哥=Mã ca
马城主=Mã thành chủ
马大人=Mã đại nhân
马大哥=Mã đại ca
马大爷=Mã đại gia
马妹=Mã muội
马姐=Mã tỷ
马姨=Mã di
马嫂=Mã tẩu
马家=Mã gia
马家庄=Mã gia trang
马家镇=Mã gia trấn
马寨主=Mã trại chủ
马少主=Mã thiếu chủ
马少爷=Mã thiếu gia
马师叔=Mã sư thúc
马师祖=Mã sư tổ
马弟=Mã đệ
马母=Mã mẫu
马爷=Mã gia
马王爷=Mã vương gia
马老=Mã lão
马老七=Mã lão thất
马老八=Mã lão bát
马老六=Mã lão lục
马老爷=Mã lão gia
马老鬼=Mã lão quỷ
马门主=Mã môn chủ
骆城主=Lạc thành chủ
骆少主=Lạc thiếu chủ
骆师叔=Lạc sư thúc
骆老怪=Lạc lão quái
骆老鬼=Lạc lão quỷ
骆门主=Lạc môn chủ
高伯=Cao bá
高儿=Cao nhi
高千总=Cao Thiên tổng/Cao thiên tổng
高哥=Cao ca
高城主=Cao thành chủ
高妹=Cao muội
高姐=Cao tỷ
高姨=Cao di
高嫂=Cao tẩu
高家庄=Cao gia trang
高家村=Cao gia thôn
高少主=Cao thiếu chủ
高师叔=Cao sư thúc
高师弟=Cao sư đệ/Cao  sư đệ
高师祖=Cao sư tổ
高总=Cao tổng
高母=Cao mẫu
高爷=Cao gia
高管家=Cao quản gia
高老=Cao lão
高老七=Cao lão thất
高老六=Cao lão lục
高老头=Cao lão đầu
高老鬼=Cao lão quỷ
高门主=Cao môn chủ
鬼叔=Quỷ thúc
魁哥=Khôi ca
魅姐=Mị tỷ
魏伯=Ngụy bá
魏儿=Ngụy nhi
魏先生=Ngụy tiên sinh
魏副门主=Ngụy phó môn chủ
魏千总=Ngụy Thiên tổng/Ngụy thiên tổng
魏叔=Ngụy thúc
魏哥=Ngụy ca
魏城主=Ngụy thành chủ
魏大人=Ngụy đại nhân
魏妹=Ngụy muội
魏姐=Ngụy tỷ
魏姨=Ngụy di
魏嫂=Ngụy tẩu
魏家=Ngụy gia
魏家庄=Ngụy gia trang
魏少主=Ngụy thiếu chủ
魏师叔=Ngụy sư thúc tổ/Ngụy sư thúc
魏师祖=Ngụy sư tổ
魏弟=Ngụy đệ
魏总=Ngụy tổng
魏某=Ngụy mỗ
魏母=Ngụy mẫu
魏爷=Ngụy gia
魏老=Ngụy lão
魏老七=Ngụy lão thất
魏老八=Ngụy lão bát
魏老六=Ngụy lão lục
魏老大=Ngụy lão đại
魏老怪=Ngụy lão quái
魏老鬼=Ngụy lão quỷ
魏门主=Ngụy môn chủ
鱼姐=Ngư tỷ
鱼家=Ngư gia
鱼师叔=Ngư sư thúc
鱼爷=Ngư gia
鱼老怪=Ngư lão quái
鱼门主=Ngư môn chủ
鲁世家=Lỗ thế gia
鲁儿=Lỗ nhi
鲁副门主=Lỗ phó môn chủ
鲁叔=Lỗ thúc
鲁哥=Lỗ ca
鲁城主=Lỗ thành chủ
鲁大哥=Lỗ đại ca
鲁妹=Lỗ muội
鲁姐=Lỗ tỷ
鲁姨=Lỗ di
鲁家=Lỗ gia
鲁师叔=Lỗ sư thúc
鲁帮主=Lỗ bang chủ
鲁弟=Lỗ đệ
鲁某=Lỗ mỗ
鲁爷=Lỗ gia
鲁王爷=Lỗ vương gia
鲁老爷=Lỗ lão gia
鲁老鬼=Lỗ lão quỷ
鲁长老=Lỗ trưởng lão
鲁门主=Lỗ môn chủ
鲍儿=Bảo nhi
鲍叔=Bảo thúc
鲍哥=Bảo ca
鲍妹=Bảo muội
鲍姐=Bảo tỷ
鲍嫂=Bảo tẩu
鲍家=Bảo gia
鲍师叔=Bảo sư thúc
鲍某=Bảo mỗ
鲍母=Bảo mẫu
鲍爷=Bảo gia
鲍老=Bảo lão
鲍老板=Bảo lão bản
鲍老鬼=Bảo lão quỷ
鲍长老=Bảo trưởng lão
鲜家=Tiên gia
鲜某=Tiên mỗ
鳌家=Ngao gia
鳕鱼=cá tuyết/cá thu /Cá tuyết
鸟毛哥=Điểu Mao ca
鸡哥=Gà đại ca
鸢儿=Diên nhi
鸿儿=Hồng nhi
鸿哥=Hồng ca
鹏儿=Bằng nhi
鹤哥=Hạc ca
鹤家=Hạc gia
鹤师叔=Hạc sư thúc
鹤师祖=Hạc sư tổ
鹤门主=Hạc môn chủ
鹿伯=Lộc bá
鹿儿=Lộc nhi
鹿叔=Lộc thúc
鹿哥=Lộc ca
鹿姐=Lộc tỷ
鹿家=Lộc gia
鹿师叔=Lộc sư thúc
鹿弟=Lộc đệ
鹿某=Lộc mỗ
鹿爷=Lộc gia
鹿老=Lộc lão
鹿老七=Lộc lão thất
鹿老儿=Lộc lão nhi
鹿门主=Lộc môn chủ
麋家=Mi gia
麒儿=Kỳ nhi
麟哥=Lân ca
麟姐=Lân tỷ
麟老=Lân lão
麦家=Mạch gia
麦少主=Mạch thiếu chủ
麦爷=Mạch gia
麦霸=mic bá/Mai Bá/mạch phách/mic hog
麻儿=Ma nhi
麻千总=Ma Thiên tổng/Ma thiên tổng
麻叔=Ma thúc
麻哥=Ma ca
麻大哥=Ma đại ca
麻姐=Ma tỷ
麻弟=Ma đệ
麻某=Ma mỗ
麻母=Ma mẫu
麻爷=Ma gia
麻老=Ma lão
麻老七=Ma lão thất
麻老六=Ma lão lục
麻老四=Ma lão tứ
麻老怪=Ma lão quái
麻门主=Ma môn chủ
黄伯=Hoàng bá
黄儿=Hoàng nhi
黄副门主=Hoàng phó môn chủ
黄千总=Hoàng Thiên tổng
黄叔=Hoàng thúc
黄城主=Hoàng thành chủ
黄妹=Hoàng muội
黄姐=Hoàng tỷ
黄姨=Hoàng di
黄嫂=Hoàng tẩu
黄少主=Hoàng thiếu chủ
黄师叔=Hoàng sư thúc
黄师祖=Hoàng sư tổ
黄弟=Hoàng đệ
黄母=Hoàng mẫu
黄爷=Hoàng gia
黄老七=Hoàng lão thất
黄老五=Hoàng lão ngũ
黄老八=Hoàng lão bát
黄老六=Hoàng lão lục
黄老怪=Hoàng lão quái
黄老爷=Hoàng lão gia
黄老鬼=Hoàng lão quỷ
黄须儿=Hoàng Tu nhi
黎副门主=Lê phó môn chủ
黎叔=Lê thúc
黎姐=Lê tỷ
黎少主=Lê thiếu chủ
黎师叔=Lê sư thúc
黎师祖=Lê sư tổ
黎总=Lê tổng
黎某=Lê mỗ
黎老鬼=Lê lão quỷ
黎门主=Lê môn chủ
黑儿=Hắc nhi
黑哥=Hắc ca
默儿=Mặc nhi
默弟=Mặc đệ
齐伯=Tề bá
齐副门主=Tề phó môn chủ
齐哥=Tề ca
齐城主=Tề thành chủ
齐堂主=Tề đường chủ
齐姐=Tề tỷ
齐师叔=Tề sư thúc
齐总=Tề tổng
齐母=Tề mẫu
齐老=Tề lão
齐老怪=Tề lão quái
齐老鬼=Tề lão quỷ
齐门主=Tề môn chủ
龙伯=Long bá
龙卿家=Long khanh gia
龙哥=Long ca
龙大哥=Long đại ca
龙妹=Long muội
龙姐=Long tỷ
龙姨=Long di
龙嫂=Long tẩu
龙家=Long gia
龙家的人=người của Long gia
龙少主=Long thiếu chủ
龙少爷=Long thiếu gia
龙岛主=Long đảo chủ
龙师叔=Long sư thúc
龙师祖=Long sư tổ
龙弟=Long đệ
龙母=Long mẫu
龙爷=Long gia
龙老六=Long lão lục
龙老怪=Long lão quái
龙老鬼=Long lão quỷ
龚家=Cung gia
龚老=Cung lão
龟伯=Quy bá
龟儿=Quy nhi
龟叔=Quy thúc
龟哥=Quy ca
龟城主=Quy thành chủ
龟妹=Quy muội
龟姨=Quy di
龟嫂=Quy tẩu
龟家=Quy gia
龟师祖=Quy sư tổ
龟弟=Quy đệ
龟母=Quy mẫu
龟爷=Quy gia
龟老=Quy lão
吕卿=Lữ khanh
吕大兄=Lữ đại huynh
吕大帅=Lữ đại soái
吕大郎=Lữ đại lang
吕小兄=Lữ tiểu huynh
吕少侠=Lữ thiếu hiệp
吕府=Lữ phủ
吕望=Lã Vọng/xem Jiang Ziya 姜子牙 [Jiang1 Zi3 ya2]
吕温侯=Lữ ôn hầu
吕王=Lữ vương
吕娘=Lữ nương
吕国=nước Lữ
吕姓=họ Lữ
吕兄=Lữ huynh
吕字=chữ lữ
宋氏=Tống thị
宋梅=Tống mai
宋惟=tống duy
宋王=Tống vương
宋离=tống ly
宋系=Tống hệ
宋蕾=tống lôi
宋薇=tống vi
宋词=từ Tống/Tống Từ
宋辉=tống huy
宋都=Tống đô
宋侄=Tống điệt
宋兄=Tống huynh
宋先=Tống tiên sinh
宋军=quân Tống
宋卿=Tống khanh
宋史=Tống sử
宋大侠=Tống đại hiệp
宋大少=Tống đại thiếu
宋大郎=Tống đại lang
宋太宗=Tống thái tông
宋夫人=Tống phu nhân
宋姓=họ Tống
宋嬷嬷=Tống ma ma
宋小兄=Tống tiểu huynh
宋少=Tống thiếu
宋少侠=Tống thiếu hiệp
宋府=Tống phủ
宋时=thời Tống
宋朝=Tống triều
宋朝人=người thời Tống
宋美人=Tống mỹ nhân
宋人=người Tống
安氏=An thị