//câu ít gặp
看的极重=cực kỳ xem trọng
性格还行=tính cách vẫn tốt
片刻功夫=một khắc nỗ lực
吻她脖子时=hôn cổ nàng thời điểm
应不会=chắc chắn sẽ không
她想听的话=lời nàng muốn nghe
的的很奇妙=đích xác rất kì diệu
家里那几分地=mấy mẫu đất trong nhà
两线作战=tác chiến hai tuyến
劳资=lao tư(chủ thợ)
有加成=có bổ trợ/có gia thành
那个老板=lão bản kia/người ông chủ kia
这个小娃娃=tiểu oa nhi này/đứa bé này
摸出手机=lấy ra điện thoại di động ra
这老家伙=lão gia hỏa này
赏光参加=vinh hạnh được đón tiếp
其他弟子=những đệ tử khác
你们的血肉=huyết nhục của các ngươi/máu thịt của các ngươi
为首的老者=lão giả dẫn đầu
这鬼天气=cái thời tiết mắc toi này/quỷ thiên khí này
第一滴血=giọt máu đầu tiên/đệ nhất tích huyết
离开家庭=rời khỏi gia đình
第十二重=tầng thứ mười hai
修者们=đám tu giả
这老者=lão giả này
他们的哥哥=ca ca của bọn hắn/ca ca của bọn họ
大处落墨=giải quyết việc quan trọng trước/nắm mấu chốt/tập trung công sức vào khâu chủ yếu
您的手机=điện thoại của ngài
我的好妹妹=hảo muội muội của ta/em gái ngoan của ta
这个老头=lão đầu này/ông lão này
在家族里=trong gia tộc
海军总部=tổng bộ hải quân/Trụ sở Hải quân
本盟主=bản minh chủ
老姑娘=lão cô nương/gái lỡ thì/bà cô/con gái út
老子的人=người của lão tử